de	de
a	a
en	en
y	ye
que	kE
o	o
ye	yE
se	se
os	os
con	kon
un	un
una	una
la	la
por	por
A	a
as	as
lo	lo
como	komo
suya	suya
u	u
En	en
O	o
no	no
son	son
ta	ta
ha	a
suyo	suyo
d	de
mas	mas
tamién	tamyen
Os	os
población	pobla8yon
l	Ele
los	los
habitants	abitanth~s
las	las
dos	dos
Ye	yE
entre	entre
pa	pa
fa	fa
La	la
As	as
bi	bi
más	mas
pero	pero
Se	se
yera	yEra
estió	estyo
nombre	nombre
dende	dende
estar	estar
gran	xran
forma	forma
encara	enkara
i	i
dica	dika
parte	parte
suyos	suyos
Tamién	tamyen
puet	pwEth~
sobre	sobre
per	per
suyas	suyas
dimpués	dimpwes
ciudat	8yu8ath~
fan	fan
quan	kwan
pueden	pwE8en
on	on
ya	ya
tien	tyEn
troba	troba
diferents	diferenth~s
termin	termin
atros	atros
mesmo	mesmo
més	mes
parti	parti
tot	toth~
luenga	lwEnga
servir	serbir
han	an
fer	fer
atras	atras
fue	fwE
tienen	tyEnen
aragonés	araxones
ista	ista
anyos	a5os
Bi	bi
mientres	myEntres
e	e
lugar	luxar
Manimenos	manimenos
baixo	baSo
bells	bels
luengas	lwEngas
tres	tres
latín	latin
Por	por
del	del
puesto	pwEsto
si	si
mes	mes
totz	to8
Lo	lo
iste	iste
enta	enta
muitos	muitos
primera	primera
municipal	muni8ipal
primer	primer
muit	muith~
sieglo	syExlo
yeran	yEran
nomás	nomas
sin	sin
río	rio
feito	feto
lugars	luxas
mayor	mayor
Sant	santh~
país	pais
Un	un
Una	una
francés	fran8es
Dimpués	dimpwes
diz	di8
heba	eba
muito	muito
Zaragoza	8araxo8a
numero	numero
mundo	mundo
asinas	asinas
Los	los
puede	pwE8e
grans	xrans
metros	metros
norte	norte
cada	ka8a
grupo	xrupo
estato	estato
Aragón	araxon
formas	formas
estau	esta
sobén	soben
caso	kaso
el	el
eixemplo	eSemplo
traza	tra8a
zona	8ona
cheneral	Ceneral
tiempo	tyEmpo
qui	ki
capital	kapital
traviés	trabyes
vida	bi8a
bien	byEn
important	importanth~
sud	su
muitas	muitas
part	parth~
estando	estando
regular	rexular
contra	kontra
sistema	sistema
Dende	dende
ixo	iSo
Ista	ista
menos	menos
Con	kon
bellas	beLas
seguntes	sexuntes
le	le
verbos	berbos
parola	parola
El	el
I	i
superficie	superfi8yE
m	Eme
rechión	reCyon
mayoría	mayoria
tanto	tanto
No	no
ilesia	ilesya
alto	alto
prou	prow
Iste	iste
fació	fa8yo
territorio	teritoryo
millons	miLons
tener	tener
casa	kasa
historia	istorya
teneba	teneba
periodo	peryo8o
casos	kasos
castellán	kasteLan
mesma	mesma
poder	po8er
dito	dito
Como	komo
centro	8entro
Encara	enkara
meyo	meyo
países	paises
gosa	xosa
guerra	gEra
quantos	kwantos
veiga	bexa
segunda	sexunda
tiene	tyEne
verbo	berbo
chunto	Cunto
obra	obra
troban	troban
tipo	tipo
Ta	ta
bell	bel
Actualment	aktwalmenth~
rei	re
quasi	kwasi
zonas	8onas
Entre	entre
cinta	8inta
parolas	parolas
arredol	are8ol
conchunto	konCunto
personas	personas
punto	punto
color	kolor
especies	espe8yEs
este	este
ixe	iSe
puestos	pwEstos
dita	dita
día	dia
estioron	estyoron
vegadas	bexa8as
común	komun
partir	partir
Estió	estyo
Quan	kwan
toponimo	toponimo
Las	las
Santa	santa
primers	primes
val	bal
conoixito	konoSito
grupos	xrupos
man	man
uns	uns
carrera	karera
tiempos	tyEmpos
municipio	muni8ipyo
Son	son
Tien	tyEn
ni	ni
textos	tekstos
Asinas	asinas
proceso	pro8eso
quantas	kwantas
esta	esta
garra	xara
palabras	palabras
prencipal	pren8ipal
familia	familya
gosan	xosan
segundo	sexundo
significa	signifika
ciudatz	8yu8a8
principal	prin8ipal
unas	unas
vegada	bexa8a
considera	konsi8era
hue	gwE
pp	pepe
De	de
debant	debanth~
importants	importanth~s
anyadas	a5a8as
isla	isla
siempre	syEmpre
fuoron	fworon
popular	popular
vegatas	bexatas
qualsiquier	kwalsikyEr
bella	beLa
li	li
presenta	presenta
trobar	trobar
porque	porkE
presencia	presen8ya
The	te
actual	aktwal
función	fun8yon
habió	abyo
prencipals	pren8ipals
posición	posi8yon
muerte	mwErte
nuevo	nwEbo
unidatz	uni8a8
catalán	katalan
causa	kasa
cuerpo	kwErpo
denominación	denomina8yon
especie	espe8yE
fendo	fendo
miembros	myEmbros
primeras	primeras
total	total
María	maria
chenero	Cenero
localidat	lokali8ath~
tierra	tyEra
muller	muLer
diferent	diferenth~
obras	obras
serie	seryE
altaria	altarya
amás	amas
anyo	a5o
cal	kal
gubierno	xubyErno
p	pe
propia	propya
va	ba
cintas	8intas
orichen	oriCen
poco	poko
quatre	kwatre
central	8entral
millor	miLor
movimiento	mobimyEnto
qual	kwal
alemán	aleman
istos	istos
materials	materyals
natural	natural
qualques	kwalkEs
treballo	trebaLo
antigo	antixo
chent	Centh~
cultura	kultura
pueblos	pwEblos
Republica	republika
todas	to8as
zaguers	8axEs
Francia	fran8ya
conoixita	konoSita
cuenta	kwEnta
epoca	epoka
sufixo	sufiSo
tradicional	tra8i8yonal
aragonesa	araxonesa
campo	kampo
medieval	me8yEbal
nuclio	nuklyo
seu	se
km	kaEme
Amás	amas
atra	atra
occidental	ok8i8ental
provincia	probin8ya
actualment	aktwalmenth~
animals	animals
relación	rela8yon
II	sexundo
destacar	destakar
fillo	fiLo
final	final
manimenos	manimenos
mar	mar
construcción	konstruk8yon
linia	linya
presonas	presonas
anque	ankE
casas	kasas
politica	politika
Mientres	myEntres
an	an
anglés	angles
fin	fin
oficial	ofi8yal
elementos	elementos
hai	a
material	materyal
palabra	palabra
teneban	teneban
atro	atro
naixito	naSito
reino	reno
Teruel	teruEl
referencia	referen8ya
veyer	beyEr
cantidat	kanti8ath~
da	da
luz	lu8
colla	koLa
les	les
oriental	oryEntal
Tierra	tyEra
cosa	kosa
ixas	iSas
libro	libro
local	lokal
posible	posible
present	presenth~
uno	uno
Seguntes	sexuntes
alavez	alabe8
of	of
orichinal	oriCinal
sierra	syEra
tenió	tenyo
resta	resta
zaguer	8axEr
Casa	kasa
castiello	kastyELo
dialecto	dyalekto
es	es
guaire	gware
nombres	nombres
territorios	teritoryos
Unius	unius
Yera	yEra
feba	feba
ixa	iSa
sola	sola
Pero	pero
Universidat	unibersi8ath~
decir	de8ir
tierras	tyEras
Si	si
días	dias
evolución	ebolu8yon
interior	interyor
medievals	me8yEbals
muga	muxa
plantas	plantas
president	presi8enth~
antigos	antixos
cinco	8inko
estructura	estruktura
redolada	re8ola8a
situación	sitwa8yon
solo	solo
Estaus	estas
capacidat	kapa8i8ath~
istas	istas
sieglos	syExlos
dialectos	dyalektos
importancia	importan8ya
lexico	leksiko
propio	propyo
Editorial	e8itoryal
Mapa	mapa
San	san
base	base
pueblo	pwEblo
nacional	na8yonal
producción	pro8uk8yon
rechions	reCyons
siga	sixa
significau	signifika
situato	sitwato
superior	superyor
planta	planta
ser	ser
costa	kosta
dicen	di8en
miembro	myEmbro
sino	sino
Europa	eropa
camín	kamin
chicota	Cikota
clima	klima
existe	eksiste
griego	xryExo
menor	menor
nueva	nwEba
pasau	pasa
dreito	8reto
edición	e8i8yon
pocos	pokos
charra	Cara
km²	kaEme 8os
Nacional	na8yonal
baixa	baSa
caracteristicas	karakteristikas
dezaga	de8axa
municipios	muni8ipyos
nunca	nunka
toponimos	toponimos
usos	usos
variedat	baryE8ath~
antiga	antixa
desembolique	desembolikE
social	so8yal
zaguera	8axEra
Este	este
Sindembargo	sindembarxo
Titán	titan
actuals	aktwals
adintro	a8intro
conoixiu	konoSiu
islas	islas
musica	musika
tipos	tipos
totas	totas
variant	baryanth~
forman	forman
meya	meya
podría	po8ria
villa	biLa
Consello	konseLo
amán	aman
antis	antis
construyíu	konstruyiu
dicir	di8ir
ell	el
equipe	ekipe
latina	latina
meses	meses
variants	baryanth~s
versión	bersyon
Antiparte	antiparte
José	xose
chicotz	Ciko8
feban	feban
formación	forma8yon
igual	ixwal
premios	premyos
presentan	presentan
recibe	re8ibe
romances	roman8es
alta	alta
canta	kanta
comarca	komarka
ells	els
parla	parla
termins	termins
tota	tota
tracta	trakta
trobamos	trobamos
cabo	kabo
deriva	deriba
dreita	8reta
espacio	espa8yo
influencia	imflwEn8ya
mayo	mayo
paso	paso
prencipió	pren8ipyo
realidat	reali8ath~
Ha	a
Imperio	imperyo
Nueva	nwEba
creyar	kreyar
mullers	muLes
Isto	isto
autor	ator
buena	bwEna
condato	kondato
formato	formato
idioma	i8yoma
televisión	telebisyon
van	ban
Barcelona	bar8elona
Fue	fwE
Reino	reno
autors	atos
batalla	bataLa
conoixida	konoSi8a
francesa	fran8esa
internacional	interna8yonal
libel	libel
nº	Eneor8inal maskulin
pas	pas
recibió	re8ibyo
representa	representa
temperatura	temperatura
tornó	torno
Bells	bels
conoix	konoS
desambigación	desambixa8yon
ella	eLa
temporada	tempora8a
facioron	fa8yoron
fuent	fwEnth~
italián	italyan
piedra	pyE8ra
prencipalment	pren8ipalmenth~
quatro	kwatro
cultural	kultural
heban	eban
planeta	planeta
plegar	plexar
Gubierno	xubyErno
Historia	istorya
auguas	axwas
chicot	Cikoth~
condicions	kondi8yons
fillos	fiLos
haber	aber
laco	lako
persona	persona
poblacions	pobla8yons
practica	praktika
relativament	relatibamenth~
siguient	sixyEnth~
tropas	tropas
Gran	xran
Val	bal
chicotas	Cikotas
clase	klase
consideran	konsi8eran
disco	disko
escrito	eskrito
sociedat	so8yE8ath~
sía	sia
vegata	bexata
Ilesia	ilesya
Per	per
aC	a 8e
diferencia	diferen8ya
dirección	direk8yon
escuela	eskwEla
especial	espe8yal
estilo	estilo
lista	lista
locals	lokals
naturals	naturals
plural	plural
sería	seria
tercera	ter8era
tradición	tra8i8yon
Guerra	gEra
arias	aryas
colors	kolos
comunidat	komuni8ath~
envueltas	embwEltas
fueras	fwEras
letra	letra
millors	miLos
nau	na
ríos	rios
teoría	teoria
toda	to8a
vico	biko
Alto	alto
Fa	fa
beluns	beluns
cantas	kantas
caracter	karakter
districto	distrikto
formar	formar
publico	publiko
quals	kwals
sistemas	sistemas
Chuan	Cwan
Espanya	espa5a
Navarra	nabara
especialment	espe8yalmenth~
hombres	ombres
mida	mi8a
pasa	pasa
relacions	rela8yons
sentiu	sentiu
solament	solamenth~
the	te
Aragonesa	araxonesa
Chuegos	CwExos
Istos	istos
alemans	alemans
anterior	anteryor
antes	antes
campos	kampos
canto	kanto
chulio	Culyo
creyó	kreyo
datos	datos
dreitos	8retos
fuents	fwEnth~s
fácil	fa8il
permite	permite
plaza	pla8a
presona	presona
servicios	serbi8yos
Fernando	fernando
Juan	xwan
Muitos	muitos
Pa	pa
Sobrarbe	sobrarbe
caracteristica	karakteristika
conoixe	konoSe
división	dibisyon
existencia	eksisten8ya
fútbol	futbol
lur	lur
muita	muita
musulmans	musulmans
tan	tan
Istas	istas
aragoneses	araxoneses
aria	arya
chinero	Cinero
disenyo	dise5o
feitos	fetos
mans	mans
nuevas	nwEbas
puntos	puntos
royo	royo
seis	ses
Esta	esta
Instituto	instituto
Roma	roma
augua	axwa
control	kontrol
cristians	kristyans
departamento	departamento
enerchía	enerCia
literatura	literatura
luengache	lwEngaCe
mai	ma
montanya	monta5a
ninos	ninos
organización	orxani8a8yon
papel	papel
politico	politiko
representación	representa8yon
torre	tore
XIX	de8inueno
chuga	Cuxa
club	klub
comuns	komuns
edificio	e8ifi8yo
existen	eksisten
largo	larxo
leis	les
quala	kwala
romana	romana
tién	tyen
tornar	tornar
trazas	tra8as
uso	uso
XX	binteno
apareixe	apareSe
dencima	den8ima
diversas	dibersas
elemento	elemento
huei	gwe
melitar	melitar
razón	ra8on
romans	romans
situau	sitwa
traducción	tra8uk8yon
Hue	gwE
III	tEr8Ero
blanca	blanka
comercial	komer8yal
cuenca	kwEnka
decada	deka8a
estatos	estatos
estudio	estu8yo
fuerza	fwEr8a
humans	umans
maxima	maksima
medio	me8yo
modelo	mo8elo
orden	or8en
prene	prene
propiedat	propyE8ath~
siet	syEth~
simbolo	simbolo
Cal	kal
Estudios	estu8yos
Norte	norte
anteriors	anteryos
antigas	antixas
categoría	katexoria
clasificación	klasifika8yon
dentro	dentro
ermita	ermita
espanyola	espa5ola
idiomas	i8yomas
indica	indika
isto	isto
numeros	numeros
parque	parkE
provién	probyen
radiz	ra8i8
sector	sektor
setiembre	setyEmbre
siguients	sixyEnth~s
simple	simple
situata	sitwata
su	su
unidat	uni8ath~
vista	bista
zagueras	8axEras
Carlos	karlos
Rusia	rusya
conchugación	konCuxa8yon
convirtió	kombirtyo
crovates	krobates
dreitament	8retamenth~
economía	ekonomia
espanyol	espa5ol
etc	etk
gracias	xra8yas
humana	umana
ideya	i8eya
lis	lis
mugas	muxas
partiu	partiu
produce	pro8u8e
provincias	probin8yas
queda	kE8a
tradicionals	tra8i8yonals
títol	titol
Libro	libro
Unión	unyon
actividat	aktibi8ath~
agora	axora
equipes	ekipes
estudios	estu8yos
exito	eksito
grau	xra
imachen	imaCen
inte	inte
libros	libros
metat	metath~
musical	musikal
naturaleza	naturale8a
obchecto	obCekto
ormino	ormino
pasó	paso
prochecto	proCekto
programa	proxrama
publica	publika
simplament	simplamenth~
tercer	ter8er
toponimia	toponimya
vía	bia
actividatz	aktibi8a8
contina	kontina
ditos	ditos
dominio	dominyo
fase	fase
filla	fiLa
fonetica	fonetika
occidentals	ok8i8entals
populars	populas
puerta	pwErta
puerto	pwErto
velocidat	belo8i8ath~
viven	biben
Alemanya	alema5a
Cruz	kru8
Internacional	interna8yonal
Y	ye
arabe	arabe
barranco	baranko
carreras	kareras
conserva	konserba
corrient	koryEnth~
creiximiento	kreSimyEnto
edificios	e8ifi8yos
emperador	empera8or
fuerte	fwErte
largaria	larxarya
lei	le
partito	partito
pasar	pasar
posteriors	posteryos
rechimen	reCimen
remató	remato
tenemos	tenemos
terreno	tereno
torna	torna
transporte	transporte
China	Cina
Institución	institu8yon
Polonia	polonya
Totz	to8
adverbios	adberbyos
codigo	ko8ixo
contacto	kontakto
emplego	emplexo
formau	forma
kilometros	kilometros
leva	leba
marzo	mar8o
mesmos	mesmos
obchectos	obCektos
partis	partis
piet	pyEth~
problemas	problemas
propios	propyos
suelo	swElo
Cada	ka8a
Mundial	mundyal
Uesca	gwEska
altros	altros
carretera	karetera
considerato	konsi8erato
creyación	kreya8yon
cucha	kuCa
ecetra	e8etra
estos	estos
febrero	febrero
fins	fins
fuellas	fwELas
neerlandés	neerlandes
prebas	prebas
prener	prener
principals	prin8ipals
situada	sitwa8a
socials	so8yals
tema	tema
Catalunya	katalu5a
concepto	kon8epto
diversos	dibersos
estas	estas
feita	feta
griegos	xryExos
independencia	independen8ya
localidatz	lokali8a8
mantener	mantener
monesterio	monesteryo
prencipio	pren8ipyo
presión	presyon
producto	pro8ukto
s	Ese
Miguel	mixEl
Muitas	muitas
Premio	premyo
al	al
cheneralment	Ceneralmenth~
creye	kreyE
et	eth~
haiga	axa
inferior	imferyor
información	imforma8yon
manera	manera
ocupa	okupa
peninsula	peninsula
podeban	po8eban
presents	presenth~s
probablement	probablementh~
productos	pro8uktos
propiedatz	propyE8a8
ruso	ruso
texto	teksto
Atros	atros
Dica	dika
IV	kwatreno
composición	komposi8yon
districtos	distriktos
exterior	eksteryor
ganó	xano
griega	xryExa
incluye	inkluyE
mont	month~
parabra	parabra
plega	plexa
plegó	plexo
relichión	reliCyon
servicio	serbi8yo
sí	si
talment	talmenth~
temas	temas
Ana	ana
amplo	amplo
culturals	kulturals
debaixo	debaSo
deciba	de8iba
ditas	ditas
independient	independyEnth~
marguin	marxin
masa	masa
metal	metal
movimientos	mobimyEntos
parlants	parlanth~s
plana	plana
poquet	pokEth~
reis	res
variedatz	baryE8a8
vecins	be8ins
Antonio	antonyo
Bosnia	bosnya
Católico	katoliko
Olimpicos	olimpikos
Sierra	syEra
cine	8ine
competición	kompeti8yon
comunidatz	komuni8a8
cosas	kosas
emplegar	emplexar
equivalent	ekibalenth~
estándar	estandar
fuerzas	fwEr8as
futuro	futuro
infinitivo	imfinitibo
inicial	ini8yal
interpresa	interpresa
libre	libre
nivel	nibel
occitán	ok8itan
oficialment	ofi8yalmenth~
pareix	pareS
participio	parti8ipyo
preba	preba
protección	protek8yon
pueda	pwE8a
resultau	resulta
rete	rete
sigue	sixE
subchecto	subCekto
treballos	trebaLos
unica	unika
verano	berano
Atras	atras
Madrit	ma8rith~
altas	altas
ampla	ampla
articlos	artiklos
banda	banda
carga	karxa
chunio	Cunyo
claro	klaro
cm	8eEme
cocina	ko8ina
contino	kontino
continó	kontino
distancia	distan8ya
estación	esta8yon
freqüent	frekwenth~
historica	istorika
honor	onor
mena	mena
montanyas	monta5as
mundial	mundyal
par	par
partes	partes
podemos	po8emos
representan	representan
reyal	reyal
scientificos	es8yEntifikos
selección	selek8yon
sentito	sentito
serbos	serbos
vechetación	beCeta8yon
Castiella	kastyELa
Parque	parkE
Virchen	birCen
accions	ak8yons
batería	bateria
cambra	kambra
capa	kapa
categorías	katexorias
charran	Caran
chelo	Celo
corresponde	koresponde
dan	dan
dar	dar
diez	dyE8
dinastía	dinastia
divide	dibi8e
ellas	eLas
grandaria	xrandarya
indican	indikan
mos	mos
politicas	politikas
prenió	prenyo
rematar	rematar
resistencia	resisten8ya
sonito	sonito
tal	tal
temperaturas	temperaturas
unatra	unatra
unión	unyon
veye	beyE
vicos	bikos
álbum	album
Baixo	baSo
Edat	e8ath~
Martín	martin
Revista	rebista
blanco	blanko
calendata	kalendata
cambeo	kambeo
clases	klases
comunicación	komunika8yon
consiguió	konsixyo
costau	kosta
distribución	distribu8yon
industrial	industryal
ixos	iSos
liga	lixa
marca	marka
mica	mika
noviembre	nobyEmbre
oficials	ofi8yals
pietz	pyE8
ran	ran
respecto	respekto
rusos	rusos
sobretot	sobretoth~
terminación	termina8yon
trobaba	trobaba
valle	baLe
versions	bersyons
vocal	bokal
vocals	bokals
Ciudat	8yu8ath~
París	paris
Santo	santo
Sud	su
XV	kin8eno
anyatas	a5atas
cambio	kambyo
chodigos	Co8ixos
chuego	CwExo
corona	korona
difuera	difwEra
fuera	fwEra
funcions	fun8yons
fusta	fusta
interpresas	interpresas
linias	linyas
només	nomes
parlas	parlas
parroquia	parokya
pico	piko
pocas	pokas
podeba	po8eba
preposición	preposi8yon
proviene	probyEne
remata	remata
salut	saluth~
voz	bo8
Francisco	fran8isko
Real	real
adchectivos	adCektibos
and	an
baverán	baberan
cabeza	kabe8a
cargo	karxo
consiste	konsiste
debito	debito
densidat	densi8ath~
dificil	difi8il
edat	e8ath~
estructuras	estrukturas
formata	formata
habitual	abitwal
horas	oras
interna	interna
levar	lebar
nuclios	nuklyos
personaches	personaCes
prencipia	pren8ipya
primero	primero
problema	problema
restas	restas
roca	roka
rocas	rokas
rural	rural
sección	sek8yon
será	sera
ueito	gweto
von	bon
Reyal	reyal
University	unibersiti
Valencia	balen8ya
acción	ak8yon
aintro	antro
amuestra	amwEstra
aspecto	aspekto
aus	as
ciudadans	8yu8a8ans
clamau	klama
comercials	komer8yals
conseqüencia	konsekwen8ya
considerau	konsi8era
cursa	kursa
derivau	deriba
destaca	destaka
enantes	enantes
escuelas	eskwElas
femenín	femenin
franceses	fran8eses
numerosos	numerosos
otomans	otomans
particular	partikular
procesos	pro8esos
produció	pro8u8yo
refiere	refyEre
reina	rena
sciencia	es8yEn8ya
series	seryEs
singular	singular
sol	sol
tecnica	teknika
unatro	unatro
vasco	basko
victoria	biktorya
Cortz	kor8
Existen	eksisten
John	xon
New	neb
Partito	partito
bandera	bandera
canal	kanal
car	kar
clamata	klamata
comarcas	komarkas
compuestos	kompwEstos
construccions	konstruk8yons
diametro	dyametro
director	direktor
economica	ekonomika
europeu	erope
fiestas	fyEstas
flors	flos
frent	frenth~
lingüistica	lingwistika
modelos	mo8elos
monedas	mone8as
nueu	nwe
orichinalment	oriCinalmenth~
orientals	oryEntals
pais	pas
palacio	pala8yo
posterior	posteryor
premio	premyo
presa	presa
pronombre	pronombre
román	roman
roya	roya
to	to
treballadors	trebaLa8os
vals	bals
Campo	kampo
Central	8entral
Cheneral	Ceneral
Diccionario	dik8yonaryo
Qualques	kwalkEs
XVIII	de8ixwiteno
activo	aktibo
aragonesas	araxonesas
cambios	kambyos
cara	kara
celulas	8elulas
conoixitos	konoSitos
denguna	denguna
dios	dyos
efecto	efekto
escape	eskape
estaus	estas
estausunidense	estasuni8ense
estrela	estrela
exercito	ekser8ito
extensión	ekstensyon
filmografía	filmoxrafia
gobierno	xobyErno
instalacions	instala8yons
libres	libres
mal	mal
meridional	meri8yonal
modo	mo8o
puent	pwEnth~
treballar	trebaLar
volumen	bolumen
Deriva	deriba
Les	les
Manuel	manwEl
Press	press
XVI	sE8eno
alemana	alemana
anyada	a5a8a
arabes	arabes
branca	branka
chefe	Cefe
civil	8ibil
clara	klara
colonias	kolonyas
denominacions	denomina8yons
documentos	dokumentos
eslavos	eslabos
familias	familyas
fundamental	fundamental
melitars	melitas
memoria	memorya
mm	EmeEme
negra	nexra
nuevos	nwEbos
pai	pa
paz	pa8
pende	pende
posibilidat	posibili8ath~
principio	prin8ipyo
puyar	puyar
qualas	kwalas
quedó	kE8o
real	real
recursos	rekursos
sale	sale
seguindo	sexindo
selvas	selbas
sudeste	su8este
territorial	teritoryal
tienga	tyEnga
tradicionalment	tra8i8yonalmenth~
unos	unos
Antimás	antimas
Congreso	kongreso
Corona	korona
Frusciante	frus8yante
García	xar8ia
Italia	italya
Mas	mas
Nomás	nomas
Oriental	oryEntal
Zelanda	8elanda
belunas	belunas
calor	kalor
choven	Coben
chugadors	Cuxa8os
clasico	klasiko
components	komponenth~s
comportamiento	komportamyEnto
conservación	konserba8yon
corresponden	koresponden
cuentas	kwEntas
dengún	dengun
escudo	esku8o
fenomeno	fenomeno
imperio	imperyo
mención	men8yon
menors	menos
moderna	mo8erna
moderno	mo8erno
momento	momento
peso	peso
politicos	politikos
poseye	poseyE
principalment	prin8ipalmenth~
pronunciación	pronun8ya8yon
propias	propyas
remonta	remonta
resultato	resultato
tardi	tar8i
templo	templo
valor	balor
Anque	ankE
Centro	8entro
Dos	dos
Federación	fe8era8yon
ISBN	isbn
Mundo	mundo
Museu	muse
X	Se
aconsiguió	akonsixyo
avions	abyons
buen	bwEn
calidat	kali8ath~
concentración	kon8entra8yon
conoixitas	konoSitas
considerata	konsi8erata
conta	konta
culto	kulto
decenio	de8enyo
dimensions	dimensyons
economico	ekonomiko
emplegato	emplexato
escribir	eskribir
escrita	eskrita
frase	frase
historico	istoriko
ilesias	ilesyas
incluyen	inkluyEn
institución	institu8yon
ir	ir
luent	lwEnth~
mesura	mesura
negro	nexro
nobles	nobles
nucleyar	nukleyar
periglo	perixlo
personache	personaCe
pieza	pyE8a
poca	poka
producen	pro8u8en
quiere	kyEre
sers	ses
subchuntivo	subCuntibo
transmisión	transmisyon
troles	troles
valura	balura
vin	bin
visto	bisto
vivir	bibir
Copa	kopa
España	espa5a
Le	le
Palacio	pala8yo
Portugal	portuxal
administrativa	administratiba
anyal	a5al
aviento	abyEnto
britanico	britaniko
campión	kampyon
cautivo	katibo
chirmán	Cirman
cofadría	kofa8ria
conoixer	konoSer
conquiesta	konkyEsta
dició	di8yo
diferencias	diferen8yas
esdevinió	es8ebinyo
fabrica	fabrika
famosa	famosa
fuella	fwELa
internacionals	interna8yonals
investigación	imbestixa8yon
lacos	lakos
levan	leban
lingüistico	lingwistiko
lurs	lus
menistro	menistro
metodos	meto8os
muralla	muraLa
nueit	nweth~
para	para
permiten	permiten
perén	peren
plegoron	plexoron
polacos	polakos
profesionals	profesyonals
quedan	kE8an
quedoron	kE8oron
razons	ra8ons
scientifica	es8yEntifika
semana	semana
sexual	sekswal
sirven	sirben
solar	solar
tant	tanth~
terrestre	terestre
vocabulario	bokabularyo
Academia	aka8emya
Bellas	beLas
Club	klub
Constitución	konstitu8yon
Lituania	litwanya
Meya	meya
Pireneus	pirenes
Tot	toth~
Tres	tres
Viena	byEna
XVII	de8isEteno
allora	aLora
caracters	karaktes
castellana	kasteLana
centros	8entros
clamada	klama8a
colección	kolek8yon
comercio	komer8yo
conoixen	konoSen
conservan	konserban
cubierta	kubyErta
culturas	kulturas
derivaus	deribas
dioses	dyoses
dotze	do8e
escribió	eskribyo
escritos	eskritos
etimolochía	etimoloCia
evitar	ebitar
fiesta	fyEsta
individuos	indibi8wos
industria	industrya
leyenda	leyEnda
literalment	literalmenth~
longaria	longarya
manca	manka
maximo	maksimo
mezcla	me8kla
minchar	minCar
musulmana	musulmana
nacionals	na8yonals
ocasions	okasyons
orichens	oriCens
parabras	parabras
periodos	peryo8os
planas	planas
plegau	plexa
poemas	poemas
rasgos	rasxos
revista	rebista
sexo	sekso
usuarios	uswaryos
versant	bersanth~
Bell	bel
Cambridge	kambridxe
Chesús	Cesus
David	dabi
Isabel	isabel
Suecia	swE8ya
Torre	tore
V	be baSa
VI	seseno
Ya	ya
aduya	a8uya
alas	alas
altras	altras
artistica	artistika
campanya	kampa5a
chusto	Custo
conflictos	komfliktos
creya	kreya
curto	kurto
descendients	des8endyEnth~s
diners	dines
do	do
documenta	dokumenta
educación	e8uka8yon
eixemplos	eSemplos
especials	espe8yals
etapa	etapa
feitas	fetas
formando	formando
fuertes	fwErtes
identidat	i8enti8ath~
ideyas	i8eyas
liquido	liki8o
naixió	naSyo
necesidat	ne8esi8ath~
oracions	ora8yons
partitos	partitos
producir	pro8u8ir
programas	proxramas
publicó	publiko
quimica	kimika
qué	ke
qüestión	kwestyon
radices	ra8i8es
rechistro	reCistro
rusa	rusa
sabe	sabe
significato	signifikato
sinyal	si5al
sufixos	sufiSos
tabla	tabla
tecnolochía	teknoloCia
tendencia	tenden8ya
tornan	tornan
tuca	tuka
verbal	berbal
árbols	arbols
Alifonso	alifonso
Consellero	konseLero
Esto	esto
Huesca	gwEska
Mequinenza	mekinen8a
Mont	month~
Natural	natural
Occidental	ok8i8ental
Saturno	saturno
Toponimia	toponimya
agosto	axosto
armenios	armenyos
brancas	brankas
cadaguna	ka8axuna
cheneración	Cenera8yon
chira	Cira
conchunta	konCunta
contexto	konteksto
els	els
emplegan	emplexan
entidat	enti8ath~
expansión	ekspansyon
favor	fabor
fisica	fisika
fonema	fonema
fusión	fusyon
gas	xas
humán	uman
influencias	imflwEn8yas
institucions	institu8yons
interpretación	interpreta8yon
latins	latins
luita	luita
moneda	mone8a
numerosas	numerosas
octubre	oktubre
paper	paper
parar	parar
perque	perkE
piel	pyEl
posibles	posibles
prencipios	pren8ipyos
reciben	re8iben
revolución	rebolu8yon
ribera	ribera
sala	sala
substantivo	substantibo
superiors	superyos
tamas	tamas
tarde	tar8e
temporal	temporal
teorías	teorias
tipico	tipiko
urbán	urban
veyen	beyEn
á	a ak8Entwa8a
Atlas	atlas
Beluns	beluns
Biblioteca	biblyoteka
Cassini	kassini
Colección	kolek8yon
Luna	luna
Mayor	mayor
Pirineo	pirineo
Segunda	sexunda
amuestran	amwEstran
artistas	artistas
artistico	artistiko
azul	a8ul
carne	karne
cerca	8erka
chenerals	Cenerals
chovens	Cobens
clasica	klasika
complexo	komplekso
considerar	konsi8erar
consonant	konsonanth~
contrario	kontraryo
cursas	kursas
definición	defini8yon
deixó	deSo
electrica	elektrika
escala	eskala
esdevenió	es8ebenyo
espacial	espa8yal
espanyols	espa5ols
fegura	fexura
figura	fixura
finalidat	finali8ath~
freqüencia	frekwen8ya
fundo	fundo
hombre	ombre
imachens	imaCens
independients	independyEnth~s
interpretacions	interpreta8yons
matrimonio	matrimonyo
mesmas	mesmas
mil	mil
morió	moryo
motivos	motibos
municipals	muni8ipals
organos	orxanos
parlan	parlan
partius	partius
piedras	pyE8ras
plan	plan
podrían	po8rian
portugués	portuxes
prenioron	prenyoron
qualo	kwalo
refirme	refirme
relativa	relatiba
representar	representar
respuesta	respwEsta
sinyals	si5als
tipica	tipika
ubierto	ubyErto
verda	ber8a
viello	byELo
viene	byEne
viento	byEnto
web	beb
zaguerías	8axErias
Comité	komite
División	dibisyon
Esquema	eskEma
Estas	estas
Existe	eksiste
Fabla	fabla
Frank	frank
General	xeneral
Luenga	lwEnga
Madrid	ma8ri
Países	paises
Presenta	presenta
Salvador	salba8or
XII	do8eno
amaneixió	amaneSyo
animal	animal
baixas	baSas
buenas	bwEnas
cadagún	ka8axun
cantón	kanton
clubs	klubs
collas	koLas
comparanza	komparan8a
competicions	kompeti8yons
comuna	komuna
conoixius	konoSius
continental	kontinental
corazón	kora8on
cristiana	kristyana
cruz	kru8
debe	debe
deixa	deSa
derivan	deriban
desapareixer	desapareSer
emplegau	emplexa
emplegos	emplexos
encomenzó	enkomen8o
esportes	esportes
estudeos	estu8eos
expresión	ekspresyon
fablants	fablanth~s
femenina	femenina
formó	formo
grafía	xrafia
guerras	gEras
igualment	ixwalmenth~
metano	metano
minerals	minerals
mitat	mitath~
modernos	mo8ernos
motivo	motibo
nativos	natibos
necesidatz	ne8esi8a8
normal	normal
obtener	obtener
organismos	orxanismos
pachina	paCina
paisache	pasaCe
partidos	parti8os
pelo	pelo
pobreza	pobre8a
podió	po8yo
posteriorment	posteryormenth~
profesional	profesyonal
proposición	proposi8yon
ra	ra
reinos	renos
sierras	syEras
suposa	suposa
tecnicas	teknikas
verbals	berbals
verde	ber8e
Antis	antis
Anvista	ambista
Fútbol	futbol
Mar	mar
Seu	se
Socialista	so8yalista
William	biLyam
amplaria	amplarya
articlo	artiklo
astí	asti
baloncesto	balon8esto
barrio	baryo
basa	basa
belún	belun
benasqués	benaskes
caballo	kabaLo
cambeos	kambeos
caza	ka8a
chacimientos	Ca8imyEntos
charrar	Carar
chents	Centh~s
cheografica	Ceoxrafika
cognato	kognato
component	komponenth~
conchunción	konCun8yon
conciertos	kon8yErtos
conoixencia	konoSen8ya
conte	konte
cuerpos	kwErpos
curva	kurba
decidió	de8i8yo
deixar	deSar
describe	deskribe
discografica	diskoxrafika
discos	diskos
distinción	distin8yon
doncas	donkas
du	du
espectadors	espekta8os
europeus	eropes
familiar	familyar
fauna	fana
foneticas	fonetikas
guitarra	gitara
hipotesi	ipotesi
instrumento	instrumento
licencia	li8en8ya
lisos	lisos
literaria	literarya
mamiferos	mamiferos
masculín	maskulin
medios	me8yos
n	Ene
necesariament	ne8esaryamenth~
obchectivo	obCektibo
oral	oral
pensar	pensar
penya	pe5a
perder	per8er
piezas	pyE8as
pista	pista
pistas	pistas
potencia	poten8ya
presentar	presentar
pronombres	pronombres
radio	ra8yo
rechional	reCyonal
recibir	re8ibir
relichiosas	reliCyosas
repuis	repuis
restos	restos
rota	rota
tenendo	tenendo
terrestres	terestres
uellos	gwELos
unico	uniko
urbana	urbana
Alavez	alabe8
Aragonés	araxones
Can	kan
Castellón	kasteLon
Diario	dyaryo
Espanyola	espa5ola
Europea	eropea
Gara	xara
Huei	gwe
Liga	lixa
Puet	pwEth~
XIV	kator8eno
York	york
amaneixen	amaneSen
artificial	artifi8yal
autoridatz	atori8a8
auxiliar	aksilyar
camins	kamins
cantaire	kantare
centrals	8entrals
cercuito	8erkuito
chineses	Cineses
clama	klama
concello	kon8eLo
continar	kontinar
correspondient	korespondyEnth~
curso	kurso
definir	definir
deixando	deSando
destacan	destakan
diminutivo	diminutibo
documentación	dokumenta8yon
duque	dukE
ellos	eLos
esporte	esporte
estrelas	estrelas
europeas	eropeas
facilment	fa8ilmenth~
fembras	fembras
fisico	fisiko
fizo	fi8o
frontera	frontera
helenismos	elenismos
historicos	istorikos
leyer	leyEr
macizo	ma8i8o
maratón	maraton
marcas	markas
marcha	marCa
mecanica	mekanika
mensaches	mensaCes
metodo	meto8o
midas	mi8as
mira	mira
mui	mui
norueste	noruEste
orichinals	oriCinals
paretz	pare8
participoron	parti8iporon
particlas	partiklas
patrimonio	patrimonyo
personal	personal
pintura	pintura
plans	plans
potencial	poten8yal
publicación	publika8yon
puertas	pwErtas
punta	punta
reacción	reak8yon
relacionau	rela8yona
relichioso	reliCyoso
respectivament	respektibamenth~
retz	re8
sectors	sektos
software	softwer
standard	estandar
tenioron	tenyoron
tractato	traktato
trescruzato	treskru8ato
ueste	gwEste
variable	baryable
vei	be
verdat	ber8ath~
veyió	beyyo
visible	bisible
vive	bibe
Alpes	alpes
Bavera	babera
Estato	estato
Finlandia	finlandya
Gramática	xramatika
Grecia	xre8ya
Gredos	xre8os
Khan	kan
Londres	londres
Nuestra	nwEstra
Pedro	pe8ro
Ramón	ramon
Roya	roya
Sol	sol
Sovietica	sobyEtika
Suiza	sui8a
Tradicionalment	tra8i8yonalmenth~
abril	abril
aconseguir	akonsexir
actos	aktos
agricola	axrikola
antimás	antimas
autoridat	atori8ath~
bizantins	bi8antins
canals	kanals
castellano	kasteLano
celebra	8elebra
censo	8enso
chacimiento	Ca8imyEnto
cierto	8yErto
clamato	klamato
conflicto	komflikto
consumo	konsumo
continent	kontinenth~
describir	deskribir
distinguir	distingir
doble	doble
documentau	dokumenta
efectos	efektos
embotada	embota8a
escritura	eskritura
eslavo	eslabo
esleito	esleto
esto	esto
etnografico	etnoxrafiko
fierro	fyEro
frisón	frison
fuego	fwExo
fuese	fwEse
funcionamiento	fun8yonamyEnto
ganar	xanar
habría	abria
hemisferio	emisferyo
hese	ese
instrumentos	instrumentos
larga	larxa
lengua	lengwa
masclos	masklos
mayors	mayos
meter	meter
musicals	musikals
nomadas	noma8as
normas	normas
paret	pareth~
parlar	parlar
patrón	patron
pinturas	pinturas
platos	platos
plazas	pla8as
podioron	po8yoron
prenen	prenen
primerías	primerias
pus	pus
quatreno	kwatreno
radiación	ra8ya8yon
realizar	reali8ar
relacionaus	rela8yonas
remontan	remontan
replega	replexa
reptils	reptils
rumán	ruman
salir	salir
scientifico	es8yEntifiko
seguir	sexir
sirve	sirbe
tozal	to8al
trol	trol
variacions	barya8yons
viviban	bibiban
vías	bias
Autonoma	atonoma
Categoría	katexoria
Chapón	Capon
Chunto	Cunto
Chusé	Cuse
Estos	estos
Felipe	felipe
Ixa	iSa
Ixo	iSo
Luis	luis
Rumanía	rumania
VII	sEteno
Valle	baLe
Villa	biLa
World	borl
XI	on8eno
abaixo	abaSo
altos	altos
amigos	amixos
arco	arko
biens	byEns
bulgaros	bulxaros
caracteriza	karakteri8a
casco	kasko
celtas	8eltas
chermanismos	Cermanismos
complemento	komplemento
completa	kompleta
constitución	konstitu8yon
corrients	koryEnth~s
costato	kostato
curtos	kurtos
cómo	komo
dau	da
diario	dyaryo
diccionario	dik8yonaryo
diftongo	diftongo
dura	dura
equipos	ekipos
escritas	eskritas
esportiva	esportiba
estase	estase
exposición	eksposi8yon
fabricación	fabrika8yon
famoso	famoso
finals	finals
fruito	fruito
historiadors	istorya8os
hora	ora
imperial	imperyal
indicar	indikar
intrés	intres
locucions	loku8yons
maquinas	makinas
materia	materya
mete	mete
mirar	mirar
misión	misyon
monts	month~s
muertos	mwErtos
nieu	nye
peixes	peSes
pendendo	pendendo
pintor	pintor
popularidat	populari8ath~
preso	preso
procesión	pro8esyon
prochectos	proCektos
profesor	profesor
protagonista	protaxonista
ret	reth~
rock	rok
romanico	romaniko
ropa	ropa
salita	salita
sangre	sangre
scenario	es8enaryo
seguiu	sexiu
sigan	sixan
siguen	sixEn
sinyor	si5or
sovietico	sobyEtiko
termino	termino
termín	termin
terrenos	terenos
transición	transi8yon
tribus	tribus
universal	unibersal
universidat	unibersi8ath~
vez	be8
viella	byELa
visigodos	bisixo8os
Adintro	a8intro
Baixos	baSos
Campionato	kampyonato
Chusticia	Custi8ya
Concello	kon8eLo
Consultato	konsultato
Diputación	diputa8yon
Don	don
Fuent	fwEnth~
Gobierno	xobyErno
Grupo	xrupo
Hongría	ongria
Kirk	kirk
Maria	marya
Mexico	meksiko
Oxford	oksfor
Parlamento	parlamento
Peninsula	peninsula
Primera	primera
Pueden	pwE8en
Ribagorza	ribaxor8a
Street	estreeth~
actriz	aktri8
anyals	a5als
aplicacions	aplika8yons
baixar	baSar
be	be
belatros	belatros
bispe	bispe
blancas	blankas
bomba	bomba
caballos	kabaLos
cabalto	kabalto
cadena	ka8ena
capaz	kapa8
catolicos	katolikos
chermanico	Cermaniko
chirmans	Cirmans
ciclo	8iklo
coda	ko8a
companyers	kompa5Es
composicions	komposi8yons
concreto	konkreto
controlar	kontrolar
costera	kostera
creixer	kreSer
cubilar	kubilar
decisión	de8isyon
dentrada	dentra8a
depresión	depresyon
derivato	deribato
dió	dyo
dolars	dolas
emplega	emplexa
esdevenindo	es8ebenindo
establió	establyo
estadio	esta8yo
estudeo	estu8eo
exclusivament	eksklusibamenth~
existiba	eksistiba
facilidat	fa8ili8ath~
factors	faktos
feble	feble
federal	fe8eral
fenomenos	fenomenos
fundador	funda8or
habitadors	abita8os
habito	abito
hectarias	ektaryas
historicas	istorikas
humanas	umanas
iba	iba
indicativo	indikatibo
indichenas	indiCenas
interpretar	interpretar
letras	letras
lexicos	leksikos
masiau	masya
menester	menester
menutos	menutos
militar	militar
mosica	mosika
motor	motor
muro	muro
musclos	musklos
noble	noble
ocupación	okupa8yon
pareixito	pareSito
participios	parti8ipyos
partz	par8
permitió	permityo
perteneixe	perteneSe
perteneixen	perteneSen
plato	plato
popularment	popularmenth~
pos	pos
prenendo	prenendo
privar	pribar
pronuncia	pronun8ya
publicacions	publika8yons
publicato	publikato
publicau	publika
pues	pwEs
raso	raso
recient	re8yEnth~
recients	re8yEnth~s
reconoiximiento	rekonoSimyEnto
recuperar	rekuperar
referencias	referen8yas
reinato	renato
relichions	reliCyons
relichiosos	reliCyosos
representant	representanth~
representants	representanth~s
respective	respektibe
riqueza	rikE8a
rurals	rurals
seguida	sexi8a
sudueste	su8wEste
tanyer	ta5Er
teniu	teniu
tensión	tensyon
tornada	torna8a
torres	tores
totalment	totalmenth~
tractau	trakta
ubierta	ubyErta
variar	baryar
vien	byEn
vita	bita
zifra	8ifra
Agustín	axustin
Armenia	armenya
Bretanya	breta5a
Cinca	8inka
Española	espa5ola
George	xeorxe
India	indya
Louis	lowis
Media	me8ya
Pueyo	pwEyo
Red	re
Serbia	serbya
Sistema	sistema
Todas	to8as
Turolenses	turolenses
VIII	gwiteno
abundants	abundanth~s
acabaus	akabas
actuacions	aktwa8yons
anglesa	anglesa
armas	armas
arredols	are8ols
aspectos	aspektos
autonoma	atonoma
b	be
caixa	kaSa
carta	karta
casó	kaso
chelera	Celera
chinés	Cines
colonia	kolonya
considerada	konsi8era8a
diferiencia	diferyEn8ya
dividita	dibi8ita
divisions	dibisyons
ducato	dukato
durando	durando
economicos	ekonomikos
encomienza	enkomyEn8a
entibo	entibo
esfensa	esfensa
establita	establita
formada	forma8a
g	ge
global	global
gols	xols
guión	gyon
historicament	istorikamenth~
individual	indibi8wal
inferiors	imferyos
latinas	latinas
libertat	libertath~
luego	lwExo
malautía	malatia
masas	masas
mediterrania	me8iteranya
mercato	merkato
mercau	merka
molimento	molimento
nacions	na8yons
nombrato	nombrato
normalment	normalmenth~
ocupaba	okupaba
orientación	oryEnta8yon
paisaches	pasaCes
particularment	partikularmenth~
pasando	pasando
pasoron	pasoron
plegan	plexan
portalada	portala8a
posicions	posi8yons
precipitación	pre8ipita8yon
prefixo	prefiSo
presonal	presonal
pro	pro
rechistros	reCistros
relaciona	rela8yona
reproducción	repro8uk8yon
republica	republika
reserva	reserba
revuelta	rebwElta
récord	rekor
serán	seran
significaus	signifikas
sinonimo	sinonimo
situacions	sitwa8yons
subespecie	subespe8yE
substantivos	substantibos
sustantivos	sustantibos
t	te
tampoco	tampoko
tradicions	tra8i8yons
trafico	trafiko
uello	gwELo
urbans	urbans
valors	balos
victimas	biktimas
vivió	bibyo
Atra	atra
B	be
Barranco	baranko
C	8e
Chaime	Came
Chapeto	Capeto
Chunta	Cunta
Fernández	fernande8
Ferrando	ferando
GPL	gepeEle
Imachen	imaCen
Ixe	iSe
Jean	xean
Literatura	literatura
Loís	lois
Mesmo	mesmo
Más	mas
Orden	or8en
Pablo	pablo
Penya	pe5a
Rei	re
Representa	representa
Robert	roberth~
Sinyora	si5ora
Tanto	tanto
Tomo	tomo
agricolas	axrikolas
amplament	amplamenth~
apareixen	apareSen
aquell	akEl
britanicos	britanikos
cadiera	ka8yEra
calcula	kalkula
cambras	kambras
campionato	kampyonato
cans	kans
cantos	kantos
capiella	kapyELa
caracteristico	karakteristiko
cargos	karxos
catalana	katalana
cayer	kayEr
chugador	Cuxa8or
cielo	8yElo
civilización	8ibili8a8yon
cobalto	kobalto
coincide	kon8i8e
coincidindo	kon8i8indo
combate	kombate
combinación	kombina8yon
completo	kompleto
conchuncions	konCun8yons
condatos	kondatos
condición	kondi8yon
constant	konstanth~
constituye	konstituyE
construyó	konstruyo
contar	kontar
contiene	kontyEne
costas	kostas
creyan	kreyan
cristianismo	kristyanismo
crosta	krosta
crovate	krobate
cubierto	kubyErto
curtas	kurtas
cutio	kutyo
decadas	deka8as
der	der
despoblato	despoblato
destín	destin
dividen	dibi8en
dividito	dibi8ito
documento	dokumento
emplegando	emplexando
erosión	erosyon
escriben	eskriben
escritor	eskritor
esdevenir	es8ebenir
esportistas	esportistas
estreita	estreta
expresar	ekspresar
fases	fases
formacions	forma8yons
formal	formal
fundó	fundo
fuyir	fuyir
ganato	xanato
gara	xara
hierba	yErba
individuals	indibi8wals
irregulars	irexulas
italiana	italyana
literario	literaryo
malautías	malatias
marins	marins
menas	menas
mesa	mesa
meyos	meyos
microtoponimos	mikrotoponimos
morir	morir
muros	muros
museu	muse
naixen	naSen
naus	nas
nobleza	noble8a
nombrau	nombra
pagar	paxar
patas	patas
perfecto	perfekto
polaco	polako
practicament	praktikamenth~
prencipiar	pren8ipyar
prencipioron	pren8ipyoron
principios	prin8ipyos
probable	probable
productor	pro8uktor
publicas	publikas
puedan	pwE8an
pueyo	pwEyo
puya	puya
qualos	kwalos
quedando	kE8ando
quiesto	kyEsto
raza	ra8a
reforma	reforma
representacions	representa8yons
residencia	resi8en8ya
responsable	responsable
restaurants	restaranth~s
risgo	risxo
romanas	romanas
romanica	romanika
single	single
suma	suma
superficies	superfi8yEs
tals	tals
también	tambyen
tiengan	tyEngan
titol	titol
toneladas	tonela8as
tribu	tribu
trobada	troba8a
títols	titols
venda	benda
viva	biba
vivos	bibos
x	Se
Al	al
Astí	asti
Baixa	baSa
Bielsa	byElsa
Castiello	kastyELo
Cort	korth~
Cristo	kristo
Cuenca	kwEnka
Cultura	kultura
Cultural	kultural
Dios	dyos
Federal	fe8eral
Festival	festibal
Fierro	fyEro
Filología	filoloxia
Fuellas	fwELas
Henrique	enrikE
Historicament	istorikamenth~
Hitler	itler
Joan	xoan
Macedonia	ma8e8onya
Manstein	mansten
Monte	monte
Pierre	pyEre
Plan	plan
Plana	plana
Records	rekors
Star	estar
Sydney	sidne
Tienen	tyEnen
Uniu	uniu
XIII	tre8eno
acceso	ak8eso
administrativas	administratibas
alcuerdo	alkwEr8o
alemanas	alemanas
alfabeto	alfabeto
amigo	amixo
aproximadament	aproksima8amenth~
arabismos	arabismos
barrancos	barankos
budismo	bu8ismo
chuegos	CwExos
clau	kla
competencia	kompeten8ya
conceptos	kon8eptos
conoiximiento	konoSimyEnto
consello	konseLo
consideratos	konsi8eratos
constituyen	konstituyEn
contienen	kontyEnen
contraste	kontraste
correspondients	korespondyEnth~s
creyoron	kreyoron
criterios	kriteryos
criticas	kritikas
cuello	kwELo
cultos	kultos
cursos	kursos
definiu	definiu
dentrata	dentrata
desapareixió	desapareSyo
desembolicó	desemboliko
desepara	desepara
destacando	destakando
difusión	difusyon
disenyos	dise5os
diversidat	dibersi8ath~
edicions	e8i8yons
eleccions	elek8yons
electrons	elektrons
espectro	espektro
estacions	esta8yons
excepción	eks8ep8yon
ezquierda	e8kyEr8a
faixas	faSas
fama	fama
familiars	familyas
ficción	fik8yon
figurar	fixurar
fixa	fiSa
formula	formula
francico	fran8iko
freqüents	frekwenth~s
fruitos	fruitos
funda	funda
goyo	xoyo
gramatical	xramatikal
gusto	xusto
habitan	abitan
homosexuals	omosekswals
in	in
industrias	industryas
intención	inten8yon
intresant	intresanth~
introducción	intro8uk8yon
invasión	imbasyon
irregular	irexular
italians	italyans
laterals	laterals
leit	leth~
lingüisticos	lingwistikos
magnitut	magnituth~
mapa	mapa
metals	metals
metropolitana	metropolitana
meyana	meyana
millón	miLon
mirando	mirando
moleculas	molekulas
moros	moros
nación	na8yon
noreste	noreste
novela	nobela
obchectivos	obCektibos
operación	opera8yon
opinión	opinyon
oración	ora8yon
ordens	or8ens
organo	orxano
ortografía	ortoxrafia
pareixe	pareSe
parroquial	parokyal
participación	parti8ipa8yon
pasato	pasato
pastors	pastos
patrimonials	patrimonyals
permanent	permanenth~
pesca	peska
pilota	pilota
plastico	plastiko
plena	plena
posesión	posesyon
practicas	praktikas
radar	ra8ar
rango	rango
recibito	re8ibito
relacionatos	rela8yonatos
residents	resi8enth~s
seguridat	sexuri8ath~
septentrional	septentryonal
signos	signos
simbolos	simbolos
suposó	suposo
te	te
terminacions	termina8yons
tornoron	tornoron
treballa	trebaLa
treballan	trebaLan
treballó	trebaLo
turco	turko
túnel	tunel
uga	uxa
variables	baryables
viache	byaCe
vivo	bibo
vueito	bweto
zaguero	8axEro
é	e ak8Entwa8a
Aquí	aki
Archivo	arCibo
Benedet	bene8eth~
Bohemia	boemya
Bulgaria	bulxarya
Crimea	krimea
Debito	debito
E	e
Is	is
Javier	xabyEr
Moldavia	mol8abya
Noruega	noruExa
Patrimonio	patrimonyo
Paul	pal
País	pais
Plaza	pla8a
President	presi8enth~
Revolución	rebolu8yon
Román	roman
Sancho	sanCo
Tenió	tenyo
Tién	tyen
Turquía	turkia
Vicente	bi8ente
Vlaquia	blakya
Zen	8en
adchectivo	adCektibo
afers	afes
alternativa	alternatiba
arquitectura	arkitektura
bronze	bron8e
calient	kalyEnth~
cargas	karxas
celebracions	8elebra8yons
cheneracions	Cenera8yons
chermanicas	Cermanikas
chuntos	Cuntos
cierta	8yErta
clamaus	klamas
clasifican	klasifikan
colonización	koloni8a8yon
columnas	kolumnas
conchuntos	konCuntos
conseguir	konsexir
consonants	konsonanth~s
construir	konstruir
contes	kontes
cort	korth~
costatos	kostatos
costaus	kostas
coste	koste
crei	kre
creixe	kreSe
cristals	kristals
cubre	kubre
cucho	kuCo
curta	kurta
decenas	de8enas
dentrar	dentrar
dentró	dentro
dependendo	dependendo
descrito	deskrito
devez	debe8
dients	dyEnth~s
dificultatz	difikulta8
difícil	difi8il
diosa	dyosa
directo	direkto
dispositivos	dispositibos
duración	dura8yon
encomienzan	enkomyEn8an
entidatz	enti8a8
equivalents	ekibalenth~s
esferencia	esferen8ya
estandar	estandar
etnico	etniko
explica	eksplika
fembra	fembra
ficacio	fika8yo
fisicos	fisikos
fundación	funda8yon
graus	xras
guitarrista	gitarista
habendo	abendo
habioron	abyoron
habiu	abiu
hongaros	ongaros
legal	lexal
leito	leto
localización	lokali8a8yon
locución	loku8yon
mando	mando
mantenimiento	mantenimyEnto
masculina	maskulina
mayestro	mayEstro
medallas	me8aLas
millas	miLas
mils	mils
minoritaria	minoritarya
minorías	minorias
muerto	mwErto
muestra	mwEstra
nacionalidat	na8yonali8ath~
naixe	naSe
ne	ne
nino	nino
operacions	opera8yons
ordinadors	or8ina8os
organicos	orxanikos
pan	pan
paralela	paralela
pareixita	pareSita
participan	parti8ipan
plataforma	plataforma
pobres	pobres
poeta	poeta
precipitacions	pre8ipita8yons
prencipe	pren8ipe
promoción	promo8yon
publicos	publikos
quatrena	kwatrena
quedar	kE8ar
quimicas	kimikas
reflecta	reflekta
reglas	rexlas
relatos	relatos
rematan	rematan
reservas	reserbas
resultaus	resultas
ritmo	ritmo
salas	salas
salen	salen
scena	es8ena
seguro	sexuro
seqüencia	sekwen8ya
serbios	serbyos
sigla	sixla
simients	simyEnth~s
simpla	simpla
simples	simples
sitúa	situa
soldatos	sol8atos
sonitos	sonitos
sovietica	sobyEtika
sovieticos	sobyEtikos
substancia	substan8ya
tardano	tar8ano
teatro	teatro
tenito	tenito
treballando	trebaLando
trescruza	treskru8a
urbano	urbano
vechetals	beCetals
vecinas	be8inas
verticals	bertikals
vesitants	besitanth~s
vientos	byEntos
viviba	bibiba
Africa	afrika
Alta	alta
Australia	astralya
CPU	kpu
Canal	kanal
Catalana	katalana
Consultau	konsulta
Ebro	ebro
Estatos	estatos
Estau	esta
Fuentes	fwEntes
Galia	xalya
González	xon8ale8
Guadalachara	gwa8alaCara
Guardia	gwar8ya
Guía	gia
Herzegovina	er8exobina
Ibn	ibn
Jack	xak
James	xames
Jesús	xesus
Leyón	leyon
Madeira	ma8era
Mare	mare
Martin	martin
Meyo	meyo
Millor	miLor
Nacions	na8yons
Naixitos	naSitos
Poco	poko
Prensas	prensas
Pérez	pere8
Road	roa
Sin	sin
Tomás	tomas
Va	ba
Vietnam	byEtnam
Yugoslavia	yuxoslabya
actors	aktos
alimentos	alimentos
altarias	altaryas
amés	ames
apareixió	apareSyo
arte	arte
asociación	aso8ya8yon
berbers	berbes
botigas	botixas
brazos	bra8os
cantidatz	kanti8a8
capas	kapas
capeza	kape8a
capitán	kapitan
celebran	8elebran
celula	8elula
chaponés	Capones
chenerico	Ceneriko
chentilicio	Centili8yo
chermanicos	Cermanikos
cheso	Ceso
chica	Cika
chudicial	Cu8i8yal
cinematografica	8inematoxrafika
clarament	klaramenth~
com	kom
companyía	kompa5ia
complexos	kompleksos
comunas	komunas
conoixidas	konoSi8as
consigue	konsixE
continación	kontina8yon
continoron	kontinoron
convierte	kombyErte
cosacos	kosakos
costumbres	kostumbres
crisi	krisi
critica	kritika
dando	dando
declaró	deklaro
descubierto	deskubyErto
determinar	determinar
determinato	determinato
dichital	diCital
dificils	difi8ils
dimana	dimana
dispositivo	dispositibo
doctrina	doktrina
durada	dura8a
economicas	ekonomikas
electronica	elektronika
emplegada	emplexa8a
escritors	eskritos
esdevenito	es8ebenito
esleitos	esletos
especifica	espe8ifika
espelunga	espelunga
esportivas	esportibas
estable	estable
estatus	estatus
estrato	estrato
etnonimo	etnonimo
europea	eropea
eventos	ebentos
explicación	eksplika8yon
expresa	ekspresa
falla	faLa
falta	falta
federación	fe8era8yon
fibra	fibra
flor	flor
foro	foro
francesas	fran8esas
fósils	fosils
ganador	xana8or
gosaba	xosaba
gubernador	xuberna8or
habrá	abra
homosexualidat	omosekswali8ath~
humanidat	umani8ath~
imperativo	imperatibo
infantil	imfantil
intensa	intensa
intervención	interben8yon
latitutz	latitu8
libels	libels
lingüistas	lingwistas
líder	li8er
mantiene	mantyEne
melitant	melitanth~
membrana	membrana
mesuras	mesuras
modernas	mo8ernas
mugants	muxanth~s
neolatinas	neolatinas
nos	nos
occitanismos	ok8itanismos
oposición	oposi8yon
orbita	orbita
orichinau	oriCina
parcialment	par8yalmenth~
pareixidas	pareSi8as
particla	partikla
partida	parti8a
pasachers	pasaCes
pasan	pasan
pasos	pasos
pendient	pendyEnth~
penyas	pe5as
percepción	per8ep8yon
perdió	per8yo
personals	personals
piensa	pyEnsa
placas	plakas
plevia	plebya
polo	polo
positiva	positiba
presonals	presonals
principe	prin8ipe
propuesta	propwEsta
quitó	kito
recinto	re8into
recuperación	rekupera8yon
relativos	relatibos
representato	representato
romanización	romani8a8yon
saber	saber
satelite	satelite
scenas	es8enas
seguidors	sexi8os
segundos	sexundos
sentir	sentir
significativa	signifikatiba
solitario	solitaryo
solos	solos
solución	solu8yon
sovieticas	sobyEtikas
subordinada	subor8ina8a
suficient	sufi8yEnth~
tercio	ter8yo
transformación	transforma8yon
trobó	trobo
tunica	tunika
une	une
utilizau	utili8a
variación	barya8yon
violencia	byolen8ya
visión	bisyon
vivindo	bibindo
vuelo	bwElo
vuelta	bwElta
árbol	arbol
Antón	anton
Austria	astrya
Belunas	belunas
Brasil	brasil
Broto	broto
Casas	kasas
Cinco	8inko
Comarca	komarka
Conejero	konexero
Destaca	destaka
Edad	e8a
Einstein	ensten
Escudo	esku8o
Escuela	eskwEla
Evolución	ebolu8yon
Gosa	xosa
Hispania	ispanya
Ligallo	lixaLo
Meseta	meseta
Monesterio	monesteryo
Murcia	mur8ya
Nuevo	nwEbo
Odiseu	o8ise
Orichinalment	oriCinalmenth~
Paleolitico	paleolitiko
Peter	peter
Podemos	po8emos
Posteriorment	posteryormenth~
Prene	prene
Quasi	kwasi
Radio	ra8yo
Recibió	re8ibyo
Secilia	se8ilya
St	Esete
Su	su
Superior	superyor
Tiene	tyEne
Universitarias	unibersitaryas
Vaticano	batikano
Ventura	bentura
Venus	benus
absoluta	absoluta
achent	aCenth~
acido	a8i8o
actuación	aktwa8yon
actuar	aktwar
adaptación	a8apta8yon
administrativament	administratibamenth~
adultos	a8ultos
aerio	aeryo
alazetz	ala8e8
aldeyas	al8eyas
amaneix	amaneS
amariello	amaryELo
ambient	ambyEnth~
apareixioron	apareSyoron
armenia	armenya
arribar	aribar
artes	artes
ataque	atakE
atletas	atletas
autoctona	atoktona
bellos	beLos
bizantín	bi8antin
boca	boka
brazo	bra8o
caballers	kabaLes
cabecera	kabe8era
cadenas	ka8enas
cambiar	kambyar
capable	kapable
centimetros	8entimetros
chenetica	Cenetika
cheografía	Ceoxrafia
cheolochico	CeoloCiko
chusticia	Custi8ya
clasificar	klasifikar
comité	komite
composau	komposa
condicional	kondi8yonal
conoixió	konoSyo
considerablement	konsi8erablementh~
construito	konstruito
continan	kontinan
costumbre	kostumbre
dato	dato
delta	delta
des	des
determinadas	determina8as
di	di
distintas	distintas
distintos	distintos
distribuye	distribuyE
dominios	dominyos
duró	duro
emblema	emblema
emplegata	emplexata
encluye	enkluyE
equipo	ekipo
era	era
esfuerzo	esfwEr8o
espacios	espa8yos
esperanto	esperanto
estreito	estreto
etnica	etnika
exclusiva	eksklusiba
exemplars	eksemplas
exitos	eksitos
expedición	ekspe8i8yon
externa	eksterna
ferrocarril	ferokaril
filosofía	filosofia
firme	firme
flora	flora
fluvial	flubyal
foranos	foranos
formaban	formaban
fuesen	fwEsen
haigan	axan
hipotesis	ipotesis
humano	umano
impacto	impakto
individuo	indibi8wo
insectos	insektos
internos	internos
kg	kaxe
lingüisticas	lingwistikas
luitar	luitar
luna	luna
mandato	mandato
mapas	mapas
medico	me8iko
mensache	mensaCe
minoría	minoria
miran	miran
misions	misyons
mitolochía	mitoloCia
monarquía	monarkia
montanyosas	monta5osas
mozarabe	mo8arabe
musclo	musklo
musicos	musikos
musulmán	musulman
nomenclatura	nomenklatura
norma	norma
nuestro	nwEstro
ocupan	okupan
organismo	orxanismo
pareixiu	pareSiu
parella	pareLa
pars	pas
partidarios	parti8aryos
partido	parti8o
perfectament	perfektamenth~
piloto	piloto
piso	piso
placa	plaka
planetas	planetas
plano	plano
plegada	plexa8a
plegando	plexando
pleno	pleno
potencias	poten8yas
presupuesto	presupwEsto
produz	pro8u8
promeyo	promeyo
propietario	propyEtaryo
proposicions	proposi8yons
proposito	proposito
provenients	probenyEnth~s
provienen	probyEnen
quadro	kwa8ro
razas	ra8as
realiza	reali8a
realment	realmenth~
reals	reals
recipient	re8ipyEnth~
rector	rektor
reformas	reformas
relacionato	rela8yonato
relativo	relatibo
representaba	representaba
restauración	restara8yon
ronda	ronda
rotación	rota8yon
rotas	rotas
selva	selba
semellants	semeLanth~s
siglo	sixlo
significar	signifikar
sindembargo	sindembarxo
sinyors	si5os
sobirán	sobiran
sociedatz	so8yE8a8
sonda	sonda
soniu	soniu
suelos	swElos
testimonio	testimonyo
tipicas	tipikas
torismo	torismo
totalidat	totali8ath~
tozuelo	to8wElo
traduccions	tra8uk8yons
transportar	transportar
tren	tren
trens	trens
trobaban	trobaban
turcos	turkos
vapor	bapor
varía	baria
vertical	bertikal
veyemos	beyEmos
viellos	byELos
vinient	binyEnth~
vivienda	bibyEnda
vuelos	bwElos
Altoaragoneses	altoaraxoneses
Balbastro	balbastro
Belarrusia	belarusya
Buena	bwEna
Chris	Cris
City	8iti
Comisión	komisyon
Conseller	konseLer
Dreito	8reto
Fuerza	fwEr8a
Galitzia	xali8ya
Gaulle	xaLe
IX	nueno
Jones	xones
Lei	le
Negra	nexra
North	nort
Pacifico	pa8ifiko
Peña	pe5a
Pilar	pilar
Popular	popular
Praga	praxa
Prencipió	pren8ipyo
Reparo	reparo
Río	rio
Totas	totas
Ucraína	ukraina
Varsovia	barsobya
abraca	abraka
abundant	abundanth~
acceder	ak8e8er
achents	aCenth~s
actor	aktor
administrativo	administratibo
aire	are
aon	aon
apareixer	apareSer
aquells	akEls
aquí	aki
atmosfera	atmosfera
basica	basika
bispes	bispes
cabos	kabos
caita	kata
cambeó	kambeo
campanyas	kampa5as
campionatos	kampyonatos
cantar	kantar
cartas	kartas
catolica	katolika
celta	8elta
ch	Ce
chaponesa	Caponesa
cheografico	Ceoxrafiko
chodiga	Co8ixa
chodigo	Co8ixo
cima	8ima
coinciden	kon8i8en
colaboración	kolabora8yon
columna	kolumna
composa	komposa
composadas	komposa8as
concreta	konkreta
conseqüencias	konsekwen8yas
considerable	konsi8erable
consideraus	konsi8eras
contextos	kontekstos
continents	kontinenth~s
contién	kontyen
copias	kopyas
correcta	korekta
correu	kore
cortz	kor8
costeras	kosteras
creyada	kreya8a
creyen	kreyEn
debiu	debiu
decisions	de8isyons
definito	definito
deixan	deSan
denomina	denomina
derivación	deriba8yon
desapareixe	desapareSe
descripción	deskrip8yon
deseparación	desepara8yon
designa	designa
designar	designar
dialectal	dyalektal
dialectals	dyalektals
dificultat	difikultath~
dio	dyo
dirichita	diriCita
disenyau	dise5a
disponible	disponible
distancias	distan8yas
distingue	distingE
dividiu	dibi8iu
duques	dukEs
eixe	eSe
electrico	elektriko
entorno	entorno
entrada	entra8a
esdevinioron	es8ebinyoron
eslavas	eslabas
español	espa5ol
especificament	espe8ifikamenth~
esportivos	esportibos
estratos	estratos
estudiants	estu8yanth~s
etimolochica	etimoloCika
etnicos	etnikos
exposicions	eksposi8yons
facto	fakto
faina	fana
fese	fese
feto	feto
figuras	fixuras
fluvials	flubyals
fondo	fondo
foranas	foranas
glandulas	glandulas
gol	xol
golfo	xolfo
gosaban	xosaban
gramatica	xramatika
guaires	gwares
habla	abla
hibiernos	ibyErnos
hierarquía	yErarkia
historias	istoryas
iban	iban
industrials	industryals
iu	iu
largos	larxos
lechislativo	leCislatibo
levó	lebo
literarios	literaryos
mala	mala
maorís	maoris
maquina	makina
marinas	marinas
marrón	maron
masclo	masklo
mayoritariament	mayoritaryamenth~
me	me
mencionan	men8yonan
mencionato	men8yonato
metro	metro
meyaus	meyas
militars	militas
ministro	ministro
molimentos	molimentos
muere	mwEre
narancha	naranCa
natal	natal
ninvió	nimbyo
nombran	nombran
novelas	nobelas
obtenió	obtenyo
organizacions	orxani8a8yons
ortodoxa	orto8oksa
ortodoxos	orto8oksos
otomán	otoman
parellanas	pareLanas
participó	parti8ipo
pasiva	pasiba
patrimonial	patrimonyal
peix	peS
pensamiento	pensamyEnto
periodico	peryo8iko
permitir	permitir
petrolio	petrolyo
picos	pikos
poders	po8es
predominan	pre8ominan
presienta	presyEnta
primaria	primarya
primavera	primabera
procesions	pro8esyons
proteínas	proteinas
psicolochía	sikoloCia
qualque	kwalkE
quarta	kwarta
quimico	kimiko
relacionadas	rela8yona8as
representau	representa
resulta	resulta
revistas	rebistas
romance	roman8e
romano	romano
romanz	roman8
sabor	sabor
sape	sape
seccions	sek8yons
secreto	sekreto
semellant	semeLanth~
sendicatos	sendikatos
serían	serian
simient	simyEnth~
sobiranía	sobirania
solido	soli8o
sonora	sonora
sus	sus
tecnolochías	teknoloCias
tematica	tematika
tendría	tendria
terminolochía	terminoloCia
trachectoria	traCektorya
transmeso	transmeso
trenta	trenta
trobato	trobato
troboron	troboron
turquica	turkika
videos	bi8eos
vins	bins
votos	botos
yo	yo
être	etre
America	amerika
Biescas	byEskas
Cerro	8ero
Chaca	Caka
Charles	Carles
Comunidat	komuni8ath~
Costa	kosta
Croacia	kroa8ya
Cup	kup
Democratica	demokratika
Dinamarca	dinamarka
Domingo	domingo
Ella	eLa
Els	els
English	englis
Enta	enta
Fueva	fwEba
Fundación	funda8yon
Galicia	xali8ya
Galligo	xaLixo
Han	an
Jaime	xame
Karabakh	karabak
Libre	libre
Marilyn	marilin
Martínez	martine8
Molimento	molimento
Montenegro	montenexro
Monts	month~s
Municipal	muni8ipal
N	Ene
Nápols	napols
Organización	orxani8a8yon
Otomán	otoman
Pamplona	pamplona
Quercus	kErkus
Respective	respektibe
Sciencias	es8yEn8yas
Semana	semana
Sinyor	si5or
Sobre	sobre
Talment	talmenth~
Teneba	teneba
Tercera	ter8era
Territorio	teritoryo
UEFA	gwEfa
Veïnat	benath~
accento	ak8ento
acidos	a8i8os
activos	aktibos
administrativos	administratibos
afirma	afirma
altament	altamenth~
altra	altra
amostranza	amostran8a
amplas	amplas
analochía	analoCia
aniellos	anyELos
arriba	ariba
atomos	atomos
baile	bale
basata	basata
bases	bases
blancos	blankos
boiras	boras
bosniacos	bosnyakos
cabal	kabal
calandario	kalandaryo
calendatas	kalendatas
calients	kalyEnth~s
campiona	kampyona
capiellas	kapyELas
capítol	kapitol
causas	kasas
cayen	kayEn
celebrar	8elebrar
cercuitos	8erkuitos
chardín	Car8in
charrau	Cara
cheneros	Ceneros
cheograficos	Ceoxrafikos
chugaban	Cuxaban
cientos	8yEntos
cinqueno	8inkEno
circulación	8irkula8yon
civils	8ibils
claras	klaras
colechio	koleCyo
comportamientos	komportamyEntos
composada	komposa8a
conoixeba	konoSeba
construita	konstruita
contaminación	kontamina8yon
conteniu	konteniu
contrimuestra	kontrimwEstra
convertiu	kombertiu
copa	kopa
creixen	kreSen
cultismos	kultismos
decreto	dekreto
define	define
definida	defini8a
demografica	demoxrafika
dependencia	dependen8ya
derivar	deribar
desaparición	desapari8yon
describen	deskriben
desemboca	desemboka
despoblau	despobla
destacatos	destakatos
determinau	determina
dice	di8e
dichitals	diCitals
dieta	dyEta
diya	diya
dominación	domina8yon
dorsal	dorsal
eficient	efi8yEnth~
eixemplars	eSemplas
electronicos	elektronikos
empecipió	empe8ipyo
entrenador	entrena8or
eslecions	esle8yons
espacials	espa8yals
especifico	espe8ifiko
especificos	espe8ifikos
esportivo	esportibo
esquena	eskEna
establimiento	establimyEnto
estatal	estatal
evident	ebi8enth~
exacta	eksakta
exercitos	ekser8itos
factor	faktor
faiga	faxa
fambre	fambre
fesen	fesen
fisicas	fisikas
fotografía	fotoxrafia
franca	franka
frases	frases
fruita	fruita
funcional	fun8yonal
gana	xana
garras	xaras
golpe	xolpe
gotico	xotiko
grant	xranth~
gubiernos	xubyErnos
h	aCe
habita	abita
horizontal	ori8ontal
ibons	ibons
incluyindo	inkluyindo
indoeuropea	indoeropea
intelectual	intelektwal
labor	labor
laboratorio	laboratoryo
largas	larxas
liberar	liberar
linache	linaCe
mamifers	mamifes
manifestacions	manifesta8yons
manifiesta	manifyEsta
mantenió	mantenyo
mantienen	mantyEnen
marina	marina
masiva	masiba
materna	materna
mayestros	mayEstros
medida	me8i8a
mental	mental
meridionals	meri8yonals
mesurar	mesurar
minchan	minCan
monesterios	monesteryos
montanyosa	monta5osa
mover	mober
mundials	mundyals
murallas	muraLas
muscular	muskular
nacionalismo	na8yonalismo
navegación	nabexa8yon
negativa	nexatiba
nombrar	nombrar
nota	nota
notables	notables
noticias	noti8yas
nuestra	nwEstra
ocupando	okupando
ocurre	okure
ofreixe	ofreSe
ondas	ondas
opera	opera
ordinador	or8ina8or
papels	papels
parellas	pareLas
peninsular	peninsular
perdiu	per8iu
perduga	per8uxa
plantilla	plantiLa
pobladors	pobla8os
pobre	pobre
podendo	po8endo
poesía	poesia
poquetz	pokE8
poseyen	poseyEn
posiblement	posiblementh~
pozos	po8os
pre	pre
prebatinas	prebatinas
prefixos	prefiSos
prencipiando	pren8ipyando
presas	presas
presentó	presento
presonache	presonaCe
previament	prebyamenth~
procede	pro8e8e
procedents	pro8e8enth~s
producito	pro8u8ito
protecher	proteCer
qualidat	kwali8ath~
quarto	kwarto
quedau	kE8a
quereba	kEreba
rechira	reCira
recientment	re8yEnmenth~
reconoixita	rekonoSita
reconquiesta	rekonkyEsta
recorriu	rekoriu
recurso	rekurso
refirmar	refirmar
reflexión	refleksyon
regularment	rexularmenth~
relacionar	rela8yonar
requiere	rekyEre
rica	rika
salida	sali8a
santo	santo
sciencias	es8yEn8yas
sendero	sendero
sepoltura	sepoltura
setio	setyo
substancias	substan8yas
sufrachio	sufraCyo
sur	sur
sustancias	sustan8yas
sían	sian
tartres	tartres
tendrá	tendra
tetulo	tetulo
tienden	tyEnden
tocar	tokar
toristico	toristiko
tramo	tramo
trampo	trampo
transchenero	transCenero
trobau	troba
turismo	turismo
uellas	gwELas
urbanas	urbanas
usau	usa
valencia	balen8ya
vasca	baska
vasos	basos
vechetal	beCetal
viviendas	bibyEndas
volar	bolar
voluntarios	boluntaryos
zarrar	8arar
án	an
Adams	a8ams
Aeria	aerya
Albarracín	albara8in
Alionor	alyonor
Apareixe	apareSe
Arredol	are8ol
Asimov	asimob
Asinasmesmo	asinasmesmo
Balcans	balkans
Banco	banko
Banks	banks
Beach	beaC
Belchica	belCika
Carmen	karmen
Chorche	CorCe
Civil	8ibil
Confederación	komfe8era8yon
César	8esar
Daroca	daroka
Departamento	departamento
Die	dyE
Es	es
Finalment	finalmenth~
Fuente	fwEnte
Gupta	xupta
Hu	u
Island	islan
López	lope8
M	Eme
Mallorca	maLorka
Mediterrania	me8iteranya
Moncayo	monkayo
Patrick	patrik
Primer	primer
Puede	pwE8e
Puent	pwEnth~
Puerta	pwErta
Puerto	pwErto
Quatre	kwatre
Rafael	rafael
Ran	ran
Rechión	reCyon
Recibe	re8ibe
Royal	royal
Saint	santh~
Sellier	seLyEr
Teatro	teatro
Teherán	teeran
Tena	tena
Universal	unibersal
Viello	byELo
Villas	biLas
acaban	akaban
academicos	aka8emikos
accidents	ak8i8enth~s
adverbial	adberbyal
afecta	afekta
africana	afrikana
altro	altro
amanata	amanata
amaneixe	amaneSe
ambients	ambyEnth~s
americana	amerikana
aquella	akELa
asociacions	aso8ya8yons
atorga	atorxa
auxiliars	aksilyas
avión	abyon
basada	basa8a
basicament	basikamenth~
bebidas	bebi8as
biera	byEra
buenos	bwEnos
busca	buska
cadieras	ka8yEras
campesins	kampesins
capitals	kapitals
catalans	katalans
caye	kayE
chenerar	Cenerar
chens	Cens
chovenil	Cobenil
chudicio	Cu8i8yo
chugando	Cuxando
chunta	Cunta
chóven	Coben
ciertas	8yErtas
ciudadanía	8yu8a8ania
clamatos	klamatos
clasicos	klasikos
clero	klero
comarcal	komarkal
combina	kombina
combustible	kombustible
comercios	komer8yos
completivas	kompletibas
complexa	kompleksa
compromís	kompromis
comunista	komunista
conducta	kondukta
confluyencia	komfluyEn8ya
confusión	komfusyon
consiguioron	konsixyoron
continentals	kontinentals
coordinador	koor8ina8or
correr	korer
creticas	kretikas
cruzada	kru8a8a
cráter	krater
cría	kria
cubren	kubren
cuento	kwEnto
data	data
deben	deben
decadencia	deka8en8ya
defensa	defensa
definita	definita
demanda	demanda
demás	demas
dentra	dentra
depende	depende
derivatos	deribatos
descubrió	deskubryo
deseyo	deseyo
desintegración	desintexra8yon
diaspora	dyaspora
directa	direkta
disponibles	disponibles
dople	dople
dormir	dormir
duro	duro
elaboración	elabora8yon
electricos	elektrikos
emigración	emixra8yon
emigroron	emixroron
emplegatos	emplexatos
empresa	empresa
encargau	enkarxa
encomenzoron	enkomen8oron
eno	eno
entalto	entalto
entero	entero
escandinavo	eskandinabo
esfera	esfera
especialidat	espe8yali8ath~
establir	establir
etz	e8
evidencia	ebi8en8ya
exactament	eksaktamenth~
existents	eksistenth~s
extensions	ekstensyons
externos	eksternos
fayena	fayEna
feguras	fexuras
ferramientas	feramyEntas
finalment	finalmenth~
formatos	formatos
fortaleza	fortale8a
fueros	fwEros
fundata	fundata
godos	xo8os
gramaticals	xramatikals
grano	xrano
gravación	xraba8yon
gravedat	xrabe8ath~
griegas	xryExas
habituals	abitwals
hereu	ere
hibierno	ibyErno
ibn	ibn
implica	implika
imposible	imposible
incluius	inkluius
incoativos	inkoatibos
indicador	indika8or
ingredients	ingre8yEnth~s
ingresos	ingresos
inscripcions	inskrip8yons
internacionalment	interna8yonalmenth~
invariable	imbaryable
invasions	imbasyons
investigacions	imbestixa8yons
lanzamiento	lan8amyEnto
lateral	lateral
lechislación	leCisla8yon
limfaticos	limfatikos
liquida	liki8a
luengo	lwEngo
lunas	lunas
magnetico	magnetiko
manifestación	manifesta8yon
mantién	mantyen
maritimo	maritimo
masculins	maskulins
medalla	me8aLa
mediterranio	me8iteranyo
microorganismos	mikroorxanismos
microtoponimo	mikrotoponimo
mineral	mineral
minima	minima
molins	molins
muebles	mwEbles
murió	muryo
m²	Eme 8os
napas	napas
narracions	nara8yons
negativas	nexatibas
nivels	nibels
nominal	nominal
nusaltros	nusaltros
observar	obserbar
oficio	ofi8yo
operativo	operatibo
ortograficas	ortoxrafikas
pachinas	paCinas
paralelas	paralelas
parroquias	parokyas
particulars	partikulas
pavo	pabo
permitiba	permitiba
permitindo	permitindo
pisos	pisos
plachas	plaCas
platiellos	platyELos
plegata	plexata
plegato	plexato
plumas	plumas
poderba	po8erba
policía	poli8ia
posan	posan
posesions	posesyons
posibilidatz	posibili8a8
precisión	pre8isyon
predomina	pre8omina
predominant	pre8ominanth~
preparación	prepara8yon
preposicions	preposi8yons
propagación	propaxa8yon
proporción	propor8yon
proposau	proposa
proposó	proposo
punk	punk
quartel	kwartel
r	Ere
racial	ra8yal
radical	ra8ikal
reaccions	reak8yons
reconoixencia	rekonoSen8ya
reconoixer	rekonoSer
rectangular	rektangular
regla	rexla
relato	relato
rematanza	rematan8a
republicas	republikas
responsabilidat	responsabili8ath~
resultatos	resultatos
revueltas	rebwEltas
robots	roboth~s
royos	royos
ruinas	ruinas
santuario	santwaryo
satelites	satelites
secundario	sekundaryo
sedimentos	se8imentos
semanas	semanas
septentrionals	septentryonals
siente	syEnte
siglos	sixlos
significaba	signifikaba
silaba	silaba
sinonimos	sinonimos
substrato	substrato
succesión	suk8esyon
suizo	sui8o
superficial	superfi8yal
tallo	taLo
tasa	tasa
tecnico	tekniko
teito	teto
territorials	teritoryals
titular	titular
tractamiento	traktamyEnto
trastes	trastes
trescruzar	treskru8ar
tripulación	tripula8yon
tu	tu
turquicos	turkikos
ubrió	ubryo
universidatz	unibersi8a8
usato	usato
venir	benir
viaches	byaCes
viellas	byELas
visibles	bisibles
vlacos	blakos
Ángel	anxel
Aires	ares
Alfonso	alfonso
Anatolia	anatolya
Andreu	andre
Antes	antes
Atro	atro
Berenguer	berengEr
Blanca	blanka
Blas	blas
Borgonya	borxo5a
Buenos	bwEnos
CD	8e8e
Calatayú	kalatayu
Cambra	kambra
Canadá	kana8a
Catolica	katolika
Chardín	Car8in
Cheorchia	CeorCya
Cine	8ine
Colechio	koleCyo
Comunista	komunista
Congo	kongo
Coreya	koreya
Cortes	kortes
Costantinoble	kostantinoble
Danubio	danubyo
Dentre	dentre
Dentro	dentro
Diz	di8
Eduardo	e8war8o
Eixemplos	eSemplos
Estadio	esta8yo
Fat	fath~
Ferrández	ferande8
Golfo	xolfo
Guadalajara	gwa8alaxara
Head	ea
Heinrich	enriC
IP	ipe
ISO	iso
ISSN	issn
Iberica	iberika
Islas	islas
Joseph	xosep
Krajina	kraxina
League	leaxE
Lengua	lengwa
Letras	letras
León	leon
Logo	loxo
Léxico	leksiko
Matarranya	matara5a
Michael	miCael
Moscú	mosku
Muit	muith~
Mónegue	monexE
Navarro	nabaro
Nº	Eneor8inal maskulin
Occident	ok8i8enth~
P	pe
Partiu	partiu
Pireneu	pirene
Platón	platon
Porto	porto
Poseye	poseyE
Pueblos	pwEblos
Quaid	kwa
Rechional	reCyonal
Reina	rena
Ribas	ribas
Royo	royo
Santiago	santyaxo
Semontano	semontano
Sociedad	so8yE8a
Solament	solamenth~
Steven	esteben
Sánchez	sanCe8
Thomas	tomas
Toledo	tole8o
URSS	uEreEseEse
Victoria	biktorya
Zona	8ona
abellas	abeLas
aconsigue	akonsixE
actas	aktas
activa	aktiba
adreza	a8re8a
aduyó	a8uyo
adverbials	adberbyals
adverbio	adberbyo
alans	alans
aletas	aletas
alumnos	alumnos
amanatas	amanatas
amariella	amaryELa
ambitos	ambitos
americán	amerikan
aniello	anyELo
anunció	anun8yo
aparent	aparenth~
aplicación	aplika8yon
artificials	artifi8yals
asambleya	asambleya
asambleyas	asambleyas
asegurar	asexurar
ataques	atakEs
au	a
autonomas	atonomas
azuls	a8uls
baixan	baSan
baixos	baSos
banco	banko
bandas	bandas
barcos	barkos
basicos	basikos
beluna	beluna
breu	bre
café	kafe
caleba	kaleba
cantons	kantons
caras	karas
carbonio	karbonyo
carreteras	kareteras
castellanas	kasteLanas
castellanismo	kasteLanismo
castiellos	kastyELos
cauz	ka8
celebración	8elebra8yon
celebre	8elebre
centra	8entra
ceramica	8eramika
chenitivo	Cenitibo
cheolochía	CeoloCia
chinesa	Cinesa
choventut	Cobentuth~
chuez	CwE8
chugar	Cuxar
chunyo	Cu5o
chóvens	Cobens
cinquena	8inkEna
citar	8itar
clasificacions	klasifika8yons
climatico	klimatiko
coalición	koali8yon
codete	ko8ete
colaboró	kolaboro
coloca	koloka
colonial	kolonyal
coloquial	kolokyal
coma	koma
comentarios	komentaryos
comparten	komparten
composata	komposata
comunistas	komunistas
concentra	kon8entra
confundir	komfundir
conservar	konserbar
conservau	konserba
construyida	konstruyi8a
construyir	konstruyir
convento	kombento
cooperación	koopera8yon
coordinación	koor8ina8yon
cordelera	kor8elera
coro	koro
corredor	kore8or
creyador	kreya8or
creyato	kreyato
creyau	kreya
cristianas	kristyanas
criterio	kriteryo
criticos	kritikos
cubrir	kubrir
cuencas	kwEnkas
cul	kul
decide	de8i8e
declinación	deklina8yon
definicions	defini8yons
dels	dels
dentradas	dentra8as
derivadas	deriba8as
desapareixioron	desapareSyoron
desapareixiu	desapareSiu
desaugua	desaxwa
descubrimiento	deskubrimyEnto
descubrimientos	deskubrimyEntos
desembocadura	desemboka8ura
deseparato	deseparato
deseparau	desepara
desinencia	desinen8ya
despoblados	despobla8os
destacable	destakable
destacato	destakato
detectar	detektar
determina	determina
determinan	determinan
diferenciar	diferen8yar
diftongación	diftonga8yon
dimensión	dimensyon
dirichent	diriCenth~
dirichito	diriCito
disenyato	dise5ato
disolución	disolu8yon
disposición	disposi8yon
dividió	dibi8yo
dunas	dunas
emitir	emitir
enchaquia	enCakya
encluyen	enkluyEn
enemigo	enemixo
entender	entender
entroron	entroron
equilibrio	ekilibryo
escatas	eskatas
esferencias	esferen8yas
esfuerzos	esfwEr8os
española	espa5ola
especificas	espe8ifikas
espelungas	espelungas
estatals	estatals
estatua	estatwa
estausunidenses	estasuni8enses
estilos	estilos
estructural	estruktural
estudiar	estu8yar
etapas	etapas
etnicas	etnikas
evolucions	ebolu8yons
ex	eks
excepcions	eks8ep8yons
existir	eksistir
exteriors	eksteryos
fabricas	fabrikas
faigan	faxan
famosos	famosos
feminín	feminin
ferramienta	feramyEnta
fina	fina
financiero	finan8yEro
fluido	flui8o
foco	foko
fondón	fondon
fonetico	fonetiko
formalment	formalmenth~
formoron	formoron
francos	frankos
français	fran8as
fuesa	fwEsa
ganando	xanando
garchola	xarCola
grafico	xrafiko
herencio	eren8yo
hesen	esen
hi	i
homonima	omonima
identificar	i8entifikar
ideyal	i8eyal
incendio	in8endyo
influyó	imfluyo
inicialment	ini8yalmenth~
intentos	intentos
irregularidatz	irexulari8a8
islam	islam
ixes	iSes
laboral	laboral
lexica	leksika
librement	librementh~
licherament	liCeramenth~
liders	li8es
lingüista	lingwista
lituans	litwans
lochica	loCika
luengaches	lwEngaCes
malas	malas
malotías	malotias
mampostería	mamposteria
maniera	manyEra
manto	manto
marchar	marCar
marguins	marxins
masculinas	maskulinas
mencions	men8yons
meten	meten
meyatos	meyatos
minutos	minutos
mirandés	mirandes
mixtas	miStas
molín	molin
monarca	monarka
monches	monCes
mongols	mongols
motors	motos
multiples	multiples
nacionalista	na8yonalista
nacionalistas	na8yonalistas
naixencia	naSen8ya
naiximiento	naSimyEnto
naixita	naSita
nasal	nasal
necesario	ne8esaryo
negros	nexros
noción	no8yon
nombra	nombra
normals	normals
numeración	numera8yon
occitans	ok8itans
ocuporon	okuporon
ofensiva	ofensiba
ofreix	ofreS
olimpico	olimpiko
onda	onda
onsos	onsos
opción	op8yon
ordenó	or8eno
padre	pa8re
papa	papa
pareixen	pareSen
parellana	pareLana
parlamento	parlamento
parques	parkEs
pelache	pelaCe
pelos	pelos
pena	pena
percusión	perkusyon
persa	persa
perspectiva	perspektiba
pierde	pyEr8e
platero	platero
plurals	plurals
poblata	poblata
polaca	polaka
portugueses	portuxEses
posa	posa
posar	posar
prebar	prebar
premite	premite
presentación	presenta8yon
prestichio	prestiCyo
profundidat	profundi8ath~
propietarios	propyEtaryos
proporciona	propor8yona
proposa	proposa
provenzal	proben8al
provincial	probin8yal
puertos	pwErtos
qualidatz	kwali8a8
quitar	kitar
qüestions	kwestyons
rapedo	rape8o
raro	raro
rayo	rayo
rechionals	reCyonals
reconoixiu	rekonoSiu
recupera	rekupera
redota	re8ota
regano	rexano
relacionada	rela8yona8a
releu	rele
relichiosa	reliCyosa
rematando	rematando
reparto	reparto
representando	representando
resolución	resolu8yon
responsables	responsables
reyals	reyals
ribagorzano	ribaxor8ano
riego	ryExo
rocoso	rokoso
rodiato	ro8yato
romanicas	romanikas
ruedas	ruE8as
rusio	rusyo
saxón	sakson
sentimiento	sentimyEnto
signo	signo
simbolica	simbolika
sistematica	sistematika
soldaus	sol8as
sozmesos	so8mesos
subespecies	subespe8yEs
subordinadas	subor8ina8as
superar	superar
tallar	taLar
tamien	tamyEn
tardana	tar8ana
tasament	tasamenth~
teatral	teatral
tendencias	tenden8yas
tipicament	tipikamenth~
tractar	traktar
transistors	transistos
tribals	tribals
trozos	tro8os
ubicación	ubika8yon
ubiertos	ubyErtos
usando	usando
veranos	beranos
via	bya
vienen	byEnen
villas	biLas
vital	bital
yoga	yoxa
zucre	8ukre
Ánchel	anCel
álbums	albums
