kan	kan
fi	fi
hin	hin
akka	aka
isaa	isa
ture	ture
kana	kana
yoo	7o
tokko	toko
waan	wan
yeroo	7ero
keessa	kessa
keessatti	kessati
itti	iti
gara	gara
koo	ko
irratti	irrati
dha	8a
kun	kun
jiru	jiru
keessaa	kessa
bara	bara
nama	nama
booda	boda
na	na
isa	isa
ni	ni
irraa	irra
mana	mana
qabu	kabu
garuu	garu
qaba	kaba
irra	irra
osoo	oso
ishee	iSe
hanga	hanga
malee	male
immoo	immo
natti	nati
jira	jira
inni	inni
bakka	baka
of	of
isaanii	isani
Yeroo	7ero
keenya	ke5a
wal	wal
Oromoo	oromo
kunis	kunis
adda	ada
sana	sana
baayyee	ba77e
walitti	waliti
jedhu	je8u
guddaa	guda
ykn	7kn
isaan	isan
wajjin	wajjin
jedhamu	je8amu
Piiter	piter
hunda	hunda
karaa	kara
Bara	bara
biraa	bira
hojii	hoji
kutaa	kuta
kanaa	kana
afaan	afan
erga	erga
ol	ol
guyyaa	gu77a
waliin	walin
ani	ani
jedhee	je8e
qofa	kofa
haa	ha
naa	na
amma	amma
biyya	bi77a
Garuu	garu
naannoo	nanno
turan	turan
akkan	akan
immo	immo
sitti	siti
kanaan	kanan
waggaa	waga
lafa	lafa
Aanaa	ana
kessatti	kessati
maqaa	maka
argamu	argamu
kessa	kessa
akkasumas	akasumas
jechuun	jeCun
nu	nu
sadarkaa	sadarka
Kana	kana
Akka	aka
lama	lama
ummata	ummata
dura	dura
jechuu	jeCu
miti	miti
warra	warra
ammoo	ammo
maal	mal
Afrikaa	afrika
akkuma	akuma
Kan	kan
ittiin	itin
gadi	gadi
si	si
Afaan	afan
Kiitii	kiti
abbaa	aba
kuni	kuni
addaa	ada
namoota	namota
jedhama	je8ama
kee	ke
namni	namni
nan	nan
harka	harka
jalqabaa	jalkaba
humna	humna
taane	tane
Faandaan	fandan
iddoo	ido
haala	hala
jalqabe	jalkabe
jiran	jiran
gosa	gosa
yeroon	7eron
Kunis	kunis
ofii	ofi
bishaan	biSan
Kanaaf	kanaf
isaas	isas
iyyuu	i77u
mataa	mata
Haa	ha
tokkoo	toko
aanaa	ana
addunyaa	adu5a
dandeenye	dande5e
jedhe	je8e
walii	wali
garaa	gara
kanin	kanin
kiyya	ki77a
siin	sin
waraanaa	warana
sababa	sababa
jalqaba	jalkaba
jecha	jeCa
qaban	kaban
magaalaa	magala
hafe	hafe
kanatti	kanati
Waan	wan
Amma	amma
illee	ille
lamaan	laman
beeku	beku
godhe	go8e
seenaa	sena
sun	sun
Obbo	obo
hunduu	hundu
jireenya	jire5a
mootummaa	motumma
odoo	odo
sirna	sirna
yaada	7ada
fuula	fula
jala	jala
kiitii	kiti
obbo	obo
ti	ti
argama	argama
dhugaa	8uga
kanan	kanan
waraana	warana
Maargoot	margot
dhufe	8ufe
naan	nan
namoonni	namonni
yokan	7okan
bira	bira
gaarii	gari
qabne	kabne
gidduu	gidu
jiruu	jiru
namaa	nama
too	to
Eeyyee	e77e
Teslaan	teslan
jedhamee	je8ame
darbee	darbe
dhibee	8ibe
addaan	adan
duukaa	duka
haaraa	hara
jedha	je8a
Sana	sana
hedduu	hedu
qabdu	kabdu
biratti	birati
gaafa	gafa
icciitii	iCCiti
ijoollee	ijolle
ishii	iSi
Addunyaa	adu5a
hundi	hundi
keenyaa	ke5a
turre	turre
xiqqoo	tiko
ija	ija
rakkoo	rako
waanti	wanti
Oromoon	oromon
argate	argate
guddaan	gudan
jalaa	jala
kanaaf	kanaf
meeshaa	meSa
miira	mira
qaama	kama
turte	turte
Abbaa	aba
aadaa	ada
fakkaata	fakata
jaarraa	jarra
muraasa	murasa
Gadaa	gada
godhu	go8u
jalatti	jalati
sii	si
Erga	erga
isheen	iSen
waanan	wanan
dhufu	8ufu
kaasee	kase
qabdi	kabdi
tokkoon	tokon
Egaa	ega
Mana	mana
guutuu	gutu
maatii	mati
manaa	mana
qabsoo	kabso
barnoota	barnota
bayye	ba77e
caalaa	Cala
duraa	dura
hidhaa	hi8a
jedhanii	je8ani
ammaa	amma
ati	ati
irraan	irran
sammuu	sammu
Akkuma	akuma
akkam	akam
fakkaatu	fakatu
himuu	himu
nyaata	5ata
seelii	seli
Kun	kun
beeka	beka
lafaa	lafa
lammaffaa	lammaffa
sanaa	sana
uummata	ummata
Yoo	7o
gochuu	goCu
kudha	ku8a
Namoonni	namonni
achi	aCi
akkasii	akasi
gidduutti	giduti
godha	go8a
wayita	wa7ita
Aanaan	anan
Ani	ani
Inni	inni
Sababiin	sababin
aabbaa	aba
isaatti	isati
namatti	namati
carraa	Carra
dhimma	8imma
jedhamuun	je8amun
jedheen	je8en
jettee	jete
amantii	amanti
isaani	isani
kompitara	kompitara
nutti	nuti
sanatti	sanati
tokkotti	tokoti
warri	warri
Akkasumas	akasumas
dhufee	8ufe
aadde	ade
barumsaa	barumsa
haadha	ha8a
kamiyyuu	kami77u
sagantaa	saganta
barbaadu	barbadu
darbe	darbe
dheeraa	8era
fayyadamuun	fa77adamun
hojjatu	hojjatu
kitaaba	kitaba
osoon	oson
seera	sera
Guyyaa	gu77a
akkas	akas
deeme	deme
jette	jete
kaan	kan
meetira	metira
nuu	nu
seete	sete
siif	sif
sirriitti	sirriti
takkaa	taka
argaman	argaman
lakkoofsa	lakofsa
sarkiyuutii	sarki7uti
turee	ture
yoon	7on
Maqaan	makan
dhiiga	8iga
dirqama	dirkama
himu	himu
Aadde	ade
Karaa	kara
Waraana	warana
dhukkuba	8ukuba
durii	duri
uume	ume
barumsa	barumsa
beekkama	bekama
duraan	duran
fedhii	fe8i
garee	gare
jirru	jirru
jirutti	jiruti
meeshaalee	meSale
sagalee	sagale
yookaan	7okan
Maal	mal
Namni	namni
caala	Cala
dhufan	8ufan
jiraatu	jiratu
kkf	kakafa
naaf	naf
qorannoo	koranno
shan	San
walakkaa	walaka
Oromiyaa	oromi7a
cimaa	Cima
ilma	ilma
jirti	jirti
kooti	koti
sadii	sadi
sanyii	sa5i
taatu	tatu
yaalii	7ali
Dhugaa	8uga
ajaja	ajaja
amala	amala
ammas	ammas
barnootaa	barnota
dhaloota	8alota
dubbii	dubi
mootummaan	motumman
nuti	nuti
qabatee	kabate
taate	tate
uffata	uffata
Waggaa	waga
Yuurooppi	7uropi
arge	arge
baayyeen	ba77en
bifa	bifa
deemu	demu
ergaa	erga
gochaa	goCa
godhee	go8e
hime	hime
isaaf	isaf
ofitti	ofiti
tajaajila	tajajila
Itti	iti
Yeroon	7eron
and	and
dhufeenya	8ufe5a
gochuun	goCun
harmee	harme
jiraachuu	jiraCu
kanas	kanas
mucaa	muCa
waantota	wantota
Yuunivarsiitii	7univarsiti
akkamitti	akamiti
fudhatee	fu8ate
gad	gad
gale	gale
ganna	ganna
hundaa	hunda
ilaalcha	ilalCa
jedhan	je8an
karantii	karanti
kootti	koti
laga	laga
mala	mala
malees	males
qabata	kabata
wanti	wanti
Abbaan	aban
Fakkeenyaaf	fake5af
Haala	hala
aabbaan	aban
ala	ala
ammayyaa	amma77a
dhalate	8alate
gaaffii	gaffi
haga	haga
harmeen	harmen
kanarratti	kanarrati
kompitaraa	kompitara
qabaachuu	kabaCu
saba	saba
the	the
wayii	wa7i
Innis	innis
Maraatoonii	maratoni
Piiteriin	piterin
baatirii	batiri
barsiisaa	barsisa
dhumaa	8uma
eenyu	e5u
fayyadamu	fa77adamu
gogaa	goga
kuma	kuma
maaltu	maltu
miirri	mirri
mirga	mirga
olii	oli
otoo	oto
qofaa	kofa
tiyya	ti77a
xiqqaate	tikate
Magaalaa	magala
afur	afur
argamti	argamti
bahee	bahe
dhiibbaa	8iba
dhuma	8uma
dorgommii	dorgommi
jalqabu	jalkabu
miliyoona	mili7ona
miseensa	misensa
oduu	odu
qabuu	kabu
xiqqaa	tika
yaaliin	7alin
Gara	gara
Hanga	hanga
Kuush	kuS
Namoota	namota
anaa	ana
as	as
balaa	bala
dubartii	dubarti
gala	gala
gargaarsa	gargarsa
ilaaluu	ilalu
jalqabee	jalkabe
jedhaman	je8aman
maqaan	makan
olaanaa	olana
onnee	onne
tti	ti
wantoota	wantota
yerro	7erro
Mariin	marin
barate	barate
duubatti	dubati
fufe	fufe
gudda	guda
hafan	hafan
harkaa	harka
hima	hima
hojjatame	hojjatame
ifa	ifa
jalqaban	jalkaban
n	na
Isa	isa
abbaan	aban
baayyen	ba77en
beekkamu	bekamu
daangaa	danga
dabalatee	dabalate
deebiin	debin
dhufa	8ufa
dhufuu	8ufu
fayyadaman	fa77adaman
galgala	galgala
gammachuu	gammaCu
godhame	go8ame
hagam	hagam
hundumaa	hunduma
jechuudha	jeCu8a
jireenyaa	jire5a
keessoo	kesso
km	kama
kunii	kuni
maaliif	malif
qabee	kabe
qarqara	karkara
qilleensa	killensa
qillensa	killensa
qulqulluu	kulkullu
sochii	soCi
yaadu	7adu
Dubbii	dubi
anis	anis
argatu	argatu
baayyinaan	ba77inan
bahaa	baha
dhibeen	8iben
dubbatu	dubatu
ergan	ergan
galee	gale
gossa	gossa
hojjachuu	hojjaCu
jedhame	je8ame
jedhamuu	je8amu
jirra	jirra
lubbuu	lubu
nagaa	naga
qabame	kabame
seene	sene
sirrii	sirri
ummatta	ummata
umurii	umuri
waa	wa
Laga	laga
Warri	warri
amana	amana
ana	ana
baate	bate
barbaada	barbada
beekama	bekama
biroo	biro
biyyaa	bi77a
biyyoota	bi77ota
deemee	deme
dhiigaa	8iga
eenyummaa	e5umma
galaa	gala
galu	galu
gochuuf	goCuf
godina	godina
hamaa	hama
jiraatan	jiratan
kanneen	kannen
lamaa	lama
lubbuun	lubun
olitti	oliti
takka	taka
tiraanzisterii	tirantsisteri
umrii	umri
xumure	tumure
yaaduu	7adu
Bakka	baka
Kutaa	kuta
Olompiikii	olompiki
aangoo	ango
afuura	afura
ammaatti	ammati
barbaachisaa	barbaCisa
bilisa	bilisa
buufata	bufata
deebii	debi
fayyadamuu	fa77adamu
fudhate	fu8ate
gadii	gadi
gahu	gahu
galatti	galati
guutuutti	gututi
haalli	halli
hedduun	hedun
hundaaf	hundaf
isaati	isati
jalqabaaf	jalkabaf
jechi	jeCi
jedhamutti	je8amuti
jiraachaa	jiraCa
marsaa	marsa
mata	mata
muraasni	murasni
ogummaa	ogumma
qabanii	kabani
qubee	kube
taanaan	tanan
waraanni	waranni
Anis	anis
Finfinnee	finfinne
Isaan	isan
Kireeler	kireler
Koloneel	kolonel
Mootummaa	motumma
Oliiqaa	olika
Qananiisaan	kananisan
Teslaa	tesla
barreeffama	barreffama
barreesse	barresse
beekkamaa	bekama
biraan	biran
deemuu	demu
dhabuu	8abu
dhiisuu	8isu
durbaa	durba
gama	gama
guddate	gudate
hamma	hamma
ifatti	ifati
iin	in
isaanis	isanis
jechoota	jeCota
kompitarri	kompitarri
laata	lata
mooraa	mora
qaamaa	kama
qawwee	kawwe
saffisa	saffisa
san	san
tokkoyyuu	toko77u
Agarii	agari
Arsii	arsi
Dr	dara
anniisaa	annisa
barreessuu	barressu
biraatti	birati
damee	dame
fishiinii	fiSini
gaazii	gatsi
gabaabaa	gababa
guddina	gudina
hawaasa	hawasa
hojjate	hojjate
jijjiirama	jijjirama
mootii	moti
nuun	nun
saayinsii	sa7insi
sanaan	sanan
seenee	sene
uumuu	umu
vaayiresii	va7iresi
yookan	7okan
Aabbaan	aban
Hayila	ha7ila
Kaleessa	kalessa
abdii	abdi
addaatti	adati
agarsiisa	agarsisa
alaa	ala
dubartoota	dubartota
dubbata	dubata
faa	fa
fakkaatiin	fakatin
fudhachuu	fu8aCu
ganama	ganama
godhan	go8an
hojiirra	hojirra
ibsu	ibsu
isaaniif	isanif
isaanitti	isaniti
kanarraa	kanarra
kanuma	kanuma
kenna	kenna
kilometers	kilometers
kolonii	koloni
oole	ole
parsentii	parsenti
qabate	kabate
qabatu	kabatu
qabna	kabna
qabuuf	kabuf
ummataa	ummata
voolteejii	volteji
yaadannoo	7adanno
yookiin	7okin
Abbabaan	ababan
Haalli	halli
Jeneraal	jeneral
KHG	kahaga
Waraanni	waranni
agarsiisu	agarsisu
armaan	arman
asii	asi
baha	baha
bahan	bahan
balbala	balbala
barachuu	baraCu
barbaachisu	barbaCisu
beekne	bekne
bulchiinsa	bulCinsa
dafee	dafe
dandeettii	dandeti
deeman	deman
dhiira	8ira
dhiiraa	8ira
dijitaalaa	dijitala
dubbachuuf	dubaCuf
eegale	egale
elektirikii	elektiriki
fudhatama	fu8atama
garba	garba
gita	gita
guyyoota	gu77ota
halkan	halkan
hojiin	hojin
hojjachaa	hojjaCa
ibolaa	ibola
kennu	kennu
kuusaa	kusa
lamatti	lamati
mallattoo	mallato
mirgaa	mirga
namicha	namiCa
nyaataa	5ata
odeeffannoo	odeffanno
ofirraa	ofirra
oolu	olu
qabeenya	kabe5a
qabnu	kabnu
qabxii	kabti
square	skuare
Ameerikaa	amerika
Biriiten	biriten
Boodarra	bodarra
Caamsaa	Camsa
Dargii	dargi
Godina	godina
Kuni	kuni
Meeppeen	mepen
Sheek	Sek
Tarii	tari
The	the
antiraaksii	antiraksi
baaxii	bati
bahe	bahe
bahuu	bahu
barattoota	baratota
beekamu	bekamu
bilisummaa	bilisumma
boodarra	bodarra
deema	dema
deemuun	demun
fayyadama	fa77adama
gahaa	gaha
galuu	galu
guutummaa	gutumma
hojjatan	hojjatan
hoo	ho
in	in
innis	innis
isheef	iSef
kaanii	kani
kabaja	kabaja
kallattii	kallati
kenne	kenne
kennuu	kennu
kessaa	kessa
kudhan	ku8an
loon	lon
lubbu	lubu
mara	mara
qabamee	kabame
qofatu	kofatu
siinqee	sinke
siyaasaa	si7asa
suuta	suta
tasa	tasa
tasaa	tasa
tolu	tolu
ummanni	ummanni
wagga	waga
ABOn	abon
Firaansi	firansi
Harmeen	harmen
Jalqaba	jalkaba
Mosee	mose
Nama	nama
Osoo	oso
Piyeer	pi7er
Roontigan	rontigan
Shaampiyoonaa	Sampi7ona
Waanti	wanti
aansee	anse
afaanii	afani
akkamii	akami
alatti	alati
argachuu	argaCu
argamtu	argamtu
baasu	basu
baatee	bate
ballina	ballina
barbaade	barbade
baruumsaa	barumsa
biiroo	biro
dheeraaf	8eraf
dhuunfaa	8unfa
diimaa	dima
fakkii	faki
fidu	fidu
gargaara	gargara
goota	gota
guddoo	gudo
ilmaan	ilman
jaalala	jalala
jirre	jirre
jirtu	jirtu
keessan	kessan
keessattis	kessatis
kennaa	kenna
kibba	kiba
kuufannoo	kufanno
lammii	lammi
mitii	miti
mormii	mormi
qabamu	kabamu
qarshii	karSi
raadiyoo	radi7o
sirni	sirni
tokkoffa	tokoffa
torba	torba
warraa	warra
yoomillee	7omille
ABO	abo
Ammas	ammas
Gaafa	gafa
Haaluma	haluma
Hoolaandi	holandi
Isaanis	isanis
Maalumaafuu	malumafu
Maccaa	maCCa
Marii	mari
Poorchugaal	porCugal
Sababa	sababa
Waaqayyo	waka77o
aartii	arti
achii	aCi
achuma	aCuma
adunya	adu5a
amantaa	amanta
argatan	argatan
argee	arge
ayyaana	a77ana
biyyotta	bi77ota
boodas	bodas
caalu	Calu
darbuu	darbu
dhagahame	8agahame
dhibba	8iba
dubbachuu	dubaCu
dubbate	dubate
dubbisuu	dubisu
duraatti	durati
eegaa	ega
eessa	essa
fayyaa	fa77a
gaafate	gafate
gargar	gargar
ibsa	ibsa
ifaa	ifa
jedhamti	je8amti
jedhuun	je8un
jettu	jetu
kamiiyyuu	kami77u
konkolaataa	konkolata
koon	kon
loltoota	loltota
magaala	magala
narra	narra
niwuukilaaraa	niwukilara
ofiin	ofin
qabuun	kabun
qodaa	koda
qooda	koda
saddeet	sadet
taatee	tate
tokkoffaa	tokoffa
tooftaa	tofta
torban	torban
tureef	turef
ulfaataa	ulfata
uuma	uma
uummanni	ummanni
wanta	wanta
yaadaa	7ada
Baalee	bale
Bilisummaa	bilisumma
Garba	garba
Hojii	hoji
Maaliif	malif
Magaalaan	magalan
Tulluu	tullu
Walumaa	waluma
a	a
akkana	akana
akkasuma	akasuma
argitee	argite
baasee	base
barruu	barru
bineensota	binensota
biyyatti	bi77ati
boombii	bombi
caalaatti	Calati
dabarsu	dabarsu
dachaa	daCa
darbu	darbu
deemaa	dema
dhagahamu	8agahamu
dhiigni	8igni
dhiisee	8ise
fiyuuzyinii	fi7uZini
fudhatu	fu8atu
fuudhee	fu8e
guddachaa	gudaCa
gurguddaa	gurguda
guutummaan	gutumman
guyyaan	gu77an
hangan	hangan
ijoollummaa	ijollumma
ilaaluun	ilalun
irraatti	irrati
ittin	itin
jedhuu	je8u
jennee	jenne
kenname	kenname
kitaabota	kitabota
lola	lola
lolaa	lola
maashinii	maSini
mudate	mudate
narratti	narrati
qabaatu	kabatu
qabachuu	kabaCu
qabaman	kabaman
raajii	raji
sirba	sirba
tahuu	tahu
tokkoof	tokof
turu	turu
waanin	wanin
waldaa	walda
xalayaa	tala7a
yaalaa	7ala
yommuu	7ommu
Adda	ada
Baatiriin	batirin
Dhuguman	8uguman
Gadaan	gadan
Haroon	haron
II	i
Jechi	jeCi
Kitaaba	kitaba
Meeppee	mepe
Naannoo	nanno
Naazii	natsi
Raashiyaa	raSi7a
Sababni	sababni
Ummata	ummata
aanee	ane
achitti	aCiti
adii	adi
argame	argame
argatte	argate
arguu	argu
asattoo	asato
bakki	baki
beekta	bekta
boqonnaa	bokonna
bulchaa	bulCa
daldalaa	daldala
duree	dure
gaafatiin	gafatin
gahe	gahe
galle	galle
galtee	galte
gargaaruu	gargaru
gidiraa	gidira
godhamu	go8amu
gurguddoo	gurgudo
haati	hati
hafeen	hafen
hafne	hafne
halluu	hallu
humnaa	humna
ilaalu	ilalu
ishe	iSe
jedhamtu	je8amtu
jiraata	jirata
jiranii	jirani
kiyyaa	ki77a
kootii	koti
maatiin	matin
manni	manni
miidhaa	mi8a
nafxanyaa	nafta5a
nuuf	nuf
per	per
seena	sena
shanii	Sani
sodaa	soda
sodaan	sodan
taasise	tasise
tahe	tahe
tajaajilaa	tajajila
tajaajilu	tajajilu
tarii	tari
tola	tola
umriin	umrin
uummataa	ummata
waanta	wanta
xixiqqoo	titiko
Dhihaa	8iha
Duusel	dusel
Guyyaan	gu77an
Humna	humna
I	i
Jimmaa	jimma
Kompitaroonni	kompitaronni
Laatinii	latini
Mahaammad	mahammad
Mee	me
Mootummaan	motumman
Naayil	na7il
Oliiqaan	olikan
Si	si
Taayitaa	ta7ita
Ummanni	ummanni
Waaqni	wakni
Walakkaa	walaka
Xaaliyaanii	tali7ani
ajajaa	ajaja
akkamiin	akamin
amanu	amanu
argu	argu
barachaa	baraCa
bare	bare
barreeffame	barreffame
birra	birra
bittaa	bita
dabalataa	dabalata
dabarse	dabarse
dabarsuu	dabarsu
darban	darban
dhaaba	8aba
dhagahama	8agahama
diina	dina
diinagdee	dinagde
dubbatama	dubatama
faayidaa	fa7ida
fayyadame	fa77adame
fii	fi
foon	fon
gatii	gati
guddicha	gudiCa
hafu	hafu
herregaa	herrega
horii	hori
ibsuuf	ibsuf
isaatiin	isatin
isaatin	isatin
isatti	isati
jechaa	jeCa
jirruu	jirru
kennameef	kennamef
km²	kama lama
lafee	lafe
leenjii	lenji
madda	mada
maraatoonii	maratoni
murtii	murti
qaamni	kamni
qilleensaa	killensa
reefu	refu
sadarka	sadarka
summii	summi
tilmaamaan	tilmaman
urjii	urji
uumama	umama
waaqa	waka
waggoota	wagota
warqee	warke
yihuudota	7ihudota
Abbabaa	ababa
Abdiisaa	abdisa
Arabaa	araba
Bahaa	baha
Booranaa	borana
Dhuma	8uma
Firaanki	firanki
Hagayya	haga77a
Harmee	harme
Islaamaa	islama
Kanaafuu	kanafu
Kanas	kanas
Kunii	kuni
Of	of
Sillaasee	sillase
Waldaa	walda
abjuu	abju
ajajni	ajajni
akkanaa	akana
akkuman	akuman
anaaloogii	analogi
baane	bane
baayoogaazii	ba7ogatsi
bayinna	ba7inna
bayyee	ba77e
beekan	bekan
beektu	bektu
bineensa	binensa
bishaanii	biSani
biyyi	bi77i
bulaa	bula
daldala	daldala
dandeessu	dandessu
daqiiqaa	dakika
deebisee	debise
dhahaa	8aha
dhigaa	8iga
dhihaa	8iha
dhiifama	8ifama
dhukkubbii	8ukubi
faallaa	falla
fakkaatan	fakatan
fida	fida
fiduu	fidu
fiigicha	figiCa
filannoo	filanno
galgalaa	galgala
gammachuun	gammaCun
goone	gone
gootummaa	gotumma
gurra	gurra
gurraacha	gurraCa
guyyaatti	gu77ati
haasaa	hasa
himi	himi
hunduma	hunduma
ijaan	ijan
jaalalli	jalalli
jechuunis	jeCunis
jedhus	je8us
jenne	jenne
kaaba	kaba
malle	malle
muka	muka
murteesse	murtesse
qabattu	kabatu
rakkisaa	rakisa
rakkoon	rakon
sababiinsaas	sababinsas
siree	sire
speed	sped
turiin	turin
weerara	werara
yaadadhu	7ada8u
yaade	7ade
yerootti	7eroti
Agariin	agarin
Haroo	haro
Huseen	husen
Jaarraa	jarra
Jarman	jarman
Jechuun	jeCun
Kaaba	kaba
Koongoo	kongo
Kutaan	kutan
Minilik	minilik
New	new
Niwuu	niwu
Noobelii	nobeli
Sirni	sirni
Takka	taka
Waaqa	waka
akkaataa	akata
amino	amino
ardii	ardi
arganne	arganne
baase	base
bahu	bahu
bakkee	bake
baratee	barate
bodda	boda
boolla	bolla
calu	Calu
dabalaa	dabala
dandeenyu	dande5u
de	de
dhaan	8an
dhiba	8iba
dhufeenyi	8ufe5i
dubbisee	dubise
egaa	ega
fagoo	fago
fedhu	fe8u
fudhachuun	fu8aCun
fudhatan	fu8atan
galan	galan
geesse	gesse
giddu	gidu
gootu	gotu
guddoon	gudon
hiriyaa	hiri7a
hojjata	hojjata
hubachuu	hubaCu
ijoolleen	ijollen
isii	isi
ittuma	ituma
jaalatu	jalatu
jabaa	jaba
ka	ka
kam	kam
kamiinuu	kaminu
kanaafis	kanafis
koos	kos
lakkaawwamu	lakawwamu
maali	mali
maddii	madi
mataan	matan
mootummoota	motummota
nyaatu	5atu
oduun	odun
paatentii	patenti
qabaa	kaba
qabatte	kabate
raawwachuu	rawwaCu
rakkina	rakina
riikardii	rikardi
sadaffaa	sadaffa
seenan	senan
seeran	seran
tarminaalii	tarminali
tilmaaman	tilmaman
tokkollee	tokolle
tokkootti	tokoti
utuu	utu
uumamuu	umamu
waadaa	wada
waantonni	wantonni
wajjiin	wajjin
wave	wave
Aabbaa	aba
Amajjii	amajji
Ammoo	ammo
Badhaasa	ba8asa
Barnoota	barnota
Barumsa	barumsa
Bitootessa	bitotessa
Dhibeen	8iben
Ebla	ebla
Harargee	hararge
Hojiin	hojin
Ijiipti	ijipti
Kanaafis	kanafis
Kompitarri	kompitarri
Miira	mira
Nuti	nuti
Oromo	oromo
Qofa	kofa
Shawaa	Sawa
Ummatni	ummatni
Warra	warra
World	world
aanu	anu
agarsiise	agarsise
alla	alla
ammallee	ammalle
anii	ani
argamani	argamani
argamuu	argamu
argan	argan
argatee	argate
asoosama	asosama
baasuu	basu
barreeffamaa	barreffama
baruu	baru
beekamaa	bekama
beekuu	beku
biyyattii	bi77ati
dararaa	darara
darbaa	darba
density	densit7
dhaabbata	8abata
dheerina	8erina
dhufanii	8ufani
dide	dide
duraaf	duraf
duuba	duba
eegalee	egale
elektiroonikii	elektironiki
faana	fana
fincaanii	finCani
fufuun	fufun
gargaaru	gargaru
gargara	gargara
gas	gas
godheen	go8en
gubbaa	guba
guddatee	gudate
hallu	hallu
hawwii	hawwi
hidhame	hi8ame
hiriyoota	hiri7ota
hojjachuuf	hojjaCuf
ibsutti	ibsuti
isaaniis	isanis
ittan	itan
jedhamanii	je8amani
jedhanitti	je8aniti
jedhutti	je8uti
jiddu	jidu
jiraate	jirate
kaase	kase
keenyatti	ke5ati
keessati	kessati
keessattuu	kessatu
koof	kof
koree	kore
kufe	kufe
manneen	mannen
maraa	mara
mijataa	mijata
moggaafame	mogafame
mosee	mose
murteessaa	murtessa
muuziqaa	mutsika
namichi	namiCi
nyaachuu	5aCu
oola	ola
otuu	otu
parsentiin	parsentin
qabduu	kabdu
qofaan	kofan
qonnaa	konna
qonnaan	konnan
quba	kuba
raawwatu	rawwatu
ragaa	raga
rakkisa	rakisa
seenu	senu
sekendii	sekendi
shakkii	Saki
tilmaama	tilmama
turetti	tureti
tuubii	tubi
walaloo	walalo
yeroof	7erof
Akkam	akam
Akkuman	akuman
Alamuun	alamun
Ana	ana
Ayyaana	a77ana
Bakki	baki
Daawud	dawud
Dambii	dambi
Dargiin	dargin
Dhuguma	8uguma
Dhukkubni	8ukubni
Haati	hati
Habashaa	habaSa
Hayilasillaasee	ha7ilasillase
Inumaayyuu	inuma77u
Kibbaa	kiba
Kunimmoo	kunimmo
Magarsaa	magarsa
Manni	manni
Marsiin	marsin
Onesmoos	onesmos
Oromoota	oromota
Qabsoo	kabso
Qorannoo	koranno
Qorannoon	korannon
Sadarkaa	sadarka
Seelii	seli
Tiraanzisteriin	tirantsisterin
Walitti	waliti
Wallagga	wallaga
afaanota	afanota
amalli	amalli
anaan	anan
argaa	arga
argachuun	argaCun
atumti	atumti
baadiyyaa	badi77a
baasuuf	basuf
baatii	bati
baatiriin	batirin
badhaasa	ba8asa
badu	badu
bahanii	bahani
ballini	ballini
bayee	ba7e
chaarjii	Carji
daandii	dandi
dandeenya	dande5a
dhaqee	8ake
dhibaa	8iba
dhibbantaa	8ibanta
dhibbeentaa	8ibenta
dhiyaatan	8i7atan
dhiyoo	8i7o
dogoggora	dogogora
duratti	durati
fagaatee	fagate
fakkaatee	fakate
fakki	faki
fedhiin	fe8in
fiildii	fildi
fiixee	fite
funyaan	fu5an
fuuldura	fuldura
gaaffiin	gaffin
gadda	gada
gaddi	gadi
galuuf	galuf
gargari	gargari
geessu	gessu
godhaa	go8a
godhuu	go8u
guddisuu	gudisu
haalota	halota
haaraan	haran
hariiroo	hariro
hidda	hida
hidhaatti	hi8ati
hiika	hika
himaa	hima
himee	hime
hoogganaa	hogana
ibse	ibse
ibsuu	ibsu
intala	intala
irrattis	irratis
ishiin	iSin
isin	isin
ittisuuf	itisuf
jedhamani	je8amani
jedhetti	je8eti
jijjirama	jijjirama
jirran	jirran
jirtuu	jirtu
kaabaa	kaba
kaleessaa	kalessa
kanarra	kanarra
karantiin	karantin
karoora	karora
keemikaalaa	kemikala
keenyaan	ke5an
keessummaa	kessumma
kennuuf	kennuf
kuniis	kunis
kutta	kuta
loltuu	loltu
makame	makame
mee	me
michuu	miCu
mitteenii	miteni
moggaa	moga
mucayyoo	muCa77o
namootaa	namota
niitii	niti
odeessuu	odessu
qabachuuf	kabaCuf
qabaniif	kabanif
qabattee	kabate
qabeenyaa	kabe5a
qabnee	kabne
qabneef	kabnef
raawwatamu	rawwatamu
saxaxa	satata
seenaan	senan
shoora	Sora
sirumaa	siruma
tilmaamuu	tilmamu
tilmamaan	tilmaman
toluu	tolu
turuu	turu
umuriin	umurin
uumu	umu
waanuma	wanuma
yaadni	7adni
Achiin	aCin
Amaara	amara
Ballina	ballina
Baqqalaa	bakala
Biiroo	biro
Biyya	bi77a
Dhimma	8imma
Dilbata	dilbata
Dorgommii	dorgommi
Finfinneetti	finfinneti
Ganda	ganda
Hayileen	ha7ilen
Indiyaa	indi7a
Kanarraan	kanarran
Kanarratti	kanarrati
Kitaabni	kitabni
Kurii	kuri
Lafa	lafa
Oromoof	oromof
Oromoonni	oromonni
Oromootti	oromoti
Rakkoo	rako
Seenaa	sena
Tokko	toko
Tokkummaa	tokumma
Tsahaay	tsaha7
WBO	wbo
Wallaggaa	wallaga
Westiingihaawus	westingihawus
addunyaan	adu5an
ajjeesee	ajjese
akkasitti	akasiti
argine	argine
arguuf	arguf
baakteeriyaa	bakteri7a
baayyina	ba77ina
bahaatti	bahati
barachuuf	baraCuf
barbaachisa	barbaCisa
bareedaa	bareda
barreessee	barresse
battalumatti	batalumati
bayyinan	ba77inan
beektaa	bekta
beekuun	bekun
bekkama	bekama
biqiltuu	bikiltu
bitaa	bita
booddee	bode
busaa	busa
carraan	Carran
cina	Cina
cinaa	Cina
dabalata	dabalata
dabarsee	dabarse
dadhabe	da8abe
dandii	dandi
deemuuf	demuf
dhaabe	8abe
dhabee	8abe
dhokannaa	8okanna
dhufeera	8ufera
dursaa	dursa
eessaa	essa
elektrikii	elektriki
fakkaate	fakate
falmaa	falma
fesashi	fesaSi
fide	fide
fudhanne	fu8anne
fufee	fufe
fufuu	fufu
funaantuu	funantu
gaafachuu	gafaCu
gaariin	garin
gabatee	gabate
galaanaa	galana
galche	galCe
gammoojjii	gammojji
gamoo	gamo
garaagaraa	garagara
garagaraa	garagara
godheera	go8era
guutame	gutame
guutuun	gutun
haasofne	hasofne
hafee	hafe
hagas	hagas
hojjetu	hojjetu
hulaa	hula
ilaala	ilala
ilaallama	ilallama
isaaniitti	isaniti
ispoorii	ispori
jalqabde	jalkabde
jalqabne	jalkabne
jedhurraa	je8urra
jettiin	jetin
jirus	jirus
kaa	ka
kaayyoo	ka77o
kaleessa	kalessa
kanaatti	kanati
kennan	kennan
kiilomeetira	kilometira
kootiin	kotin
laabiraatorii	labiratori
lamaanuu	lamanu
maalii	mali
male	male
mataasaa	matasa
miseensota	misensota
moo	mo
mucaan	muCan
murteessuu	murtessu
nyaatan	5atan
obboleettii	oboleti
oolle	olle
oromoo	oromo
plate	plate
qabachu	kabaCu
qabamanii	kabamani
qabamuu	kabamu
qabatanii	kabatani
qabeeyyii	kabe77i
qabiyyee	kabi77e
qabsoon	kabson
qoratu	koratu
raadaarii	radari
rakkisu	rakisu
saalaa	sala
sabdaneessaa	sabdanessa
saffisaan	saffisan
sagal	sagal
sammuun	sammun
seenuu	senu
semiikondaakterii	semikondakteri
tarkaanfii	tarkanfi
tiin	tin
tiyoorii	ti7ori
tiyyaa	ti77a
tokkon	tokon
ulfaata	ulfata
uumaa	uma
uumame	umame
uummame	ummame
uummamu	ummamu
vacuum	vaCum
walakkaan	walakan
waliinii	walini
walqunnamtii	walkunnamti
xiqqo	tiko
xiyyeeffannoo	ti77effanno
yaa	7a
yaadaan	7adan
yaalan	7alan
yaale	7ale
yihuudotaa	7ihudota
