abdisere	obdiser3
abnorm	obnorm
abonnere	obuner3
abort	obot
abortere	oboter3
absolutt	opsul3t
abstrakt	opstrokt
absurd	ops3d
adapter	odopt3r
addere	oder3
adekvat	od3kvot
adjektiv	ody3ktiv
adkomst	odkomst
adlyde	odlid3
administrasjon	odministroSun
administrativ	odministrotiv
administrere	odministrer3
adoptere	odopter3
adresse	odrEs3
adressere	odr3ser3
advare	odvor3
adverb	odvErb
affære	ofEr3
afghansk	ofgonsk
afrika	ofriko
aften	oft3n
aftens	oft3ns
agder	ogd3r
agere	oger3
aggressiv	ogr3siv
agitere	ogiter3
agnete	oNnet3
agurk	og3rk
akademisk	okodemisk
ake	ok3
akebrett	ok3br3t
aker	ok3r
akklimatisere	oklimotisEr3
akkompagnere	okumponyer3
akkumulere	ok3m3ler3
akselerere	oks3l3rer3
akseptabel	oks3ptob3l
akseptere	oks3pter3
aksje	okS3
aksjonere	okSuner3
akt	okt
aktbilde	oktbild3
akte	okt3
aktiv	oktiv
aktsom	oktsom
aktuell	okt3El
akustisk	ok3stisk
akutt	ok3t
akvarell	okvorEl
akvarellmaling	okvorElmoliN
alarmere	olormer3
alarmerende	olormer3n3
alarmsystem	olormsistem
albue	olb3
alder	old3r
aldrende	oldr3n3
aldri	oldri
ale	ol3
alene	olen3
alfabetisk	olfobetisk
alkoholfri	olkuhulfri
alkoholfritt øl	olkuhulfrit El
alle	7ol3
allegorisk	ol3gurisk
allerede	ol3red3
allergi	olErgi
allergisk	olErgisk
alliere	olier3
alliert	oliet
allmenn	olm3n
alltid	olti oltid
alpin	olpin
alt	olt
alter	olt3r
alternativ	oltEnotiv
altså	oltso
alvorlig	olvoLi
alvorlige	olvoLi3
alvorligere	olvoLir3
alvorligst	olvoLikst
alvorligste	olvoLikst3
amatørmessig	omterm3si
amatørmessige	omterm3si3
amatørmessigere	omterm3sir3
amatørmessigst	omterm3sikst
amatørmessigste	omterm3sikst3
ambassade	ombosod3
ambisiøs	ombisies
amerikansk	om3rikonsk
amerikansk-canadisk	om3rikonskonodisk
amme	om3
amper	omp3r
amputere	omp3ter3
amt	omt
an-	on
anaconda	onokondo
analog	onolog
analogisk	onologisk
analysere	onoliser3
analytisk	onolitisk
ananas	ononos
anarkistisk	onorkistisk
anatomisk	onotumisk
anbefale	onb3fol3
and	on
ande	on3
andektig	ondEkti
andektige	ondEkti3
andektigere	ondEktir3
andektigst	ondEktikst
andektigste	ondEktikst3
andpusten	onp3st3n
andre	ondr3
andreas	ondreos
ane	on3
anekdote	onEkdut3
anerkjenne	onErSEn3
angi	onyi
angivelig	onyiv3li
angivelige	onyiv3li3
angiveligere	onyiv3lir3
angiveligst	onyiv3likst
angiveligste	onyiv3likst3
angre	oNr3
angripe	ongrip3
angst	oNst
angsten	oNstn
angå	ongo
anholde	onhol3
anke	oNk3
ankel	oNk3l
anker	oNk3r
anklage	oNklog3
ankomme	oNkom3
ankre	oNk3r3
ankret	oNk3r3
anledning	onledniN
anmelde	onmEl3
anmode	onmud3
annen	o3n on3n
annerledes	on3Led3s
annonsere	onoNser3
anonym	onunim
anorakk	onurok
anorektisk	onurEktisk
ansatt	onsot
anse	onse
anselig	onseli
anselige	onseli3
anseligere	onselir3
anseligst	onselikst
anseligste	onselikst3
ansette	onsEt3
ansikt	onsikt
anskaffe	onskof3
anslå	onSLo
anspent	onspEnt
anstendig	onstEni
anstendige	onstEni3
anstendigere	onstEnir3
anstendigst	onstEnikst
anstendigste	onstEnikst3
anstrenge	onstrEN3
anstrenge seg	onstrEN3sEi
anstrengende	onstrEN3n3
ansvarlig	onsvoLi
ansvarlige	onsvoLi3
ansvarligere	onsvoLir3
ansvarligst	onsvoLikst
ansvarligste	onsvoLikst3
ansvarsfull	onsvoSf3l
ansvarsløs	onsvoSLes
anta	onto
antaste	ontost3
antenne	ontEn3
antikk	ontik
antikvarisk	ontikvorisk
antisemittisk	ontis3mitisk
antrekk	ontr3k
antyde	ontid3
anvende	onvEn3
anvise	onvis3
aparte	opot3
apatisk	opotisk
ape	op3
apokalypse	opukolips3
apokalyptisk	opukoliptisk
apostel	opost3l
apotek	oputek
apparat	oporot
appelere	op3ller3
appell	opEl
appellere	op3ler3
appelsin	op3lsin
appetitt	op3tit
appetittlig	op3titli
appetittlige	op3titli3
appetittligere	op3titlir3
appetittligst	op3titlikst
appetittligste	op3titlikst3
applaudere	oplE3der3
applaus	oplE3s
aprikos	oprikus
april	opril
arabisk	orobisk
arbeid	orbEid
arbeide	orbEid3
arbeider	orbEid3r
arbeidsledig	orbEidsledi
arbeidsledige	orbEidsledi3
arbeidsledigere	orbEidsledir3
arbeidsledigst	orbEidsledikst
arbeidsledigste	orbEidsledikst3
arbeidsløs	orbEidsles
arbeidsom	orbEidsom
arg	org
argument	org3mEnt
argumentere	org3m3nter3
ark	ork
arkaisk	orkoisk
arkeolog	ork3ulog
arkeologi	orkEulugi
arkeologisk	ork3ulogisk
arkitekt	orkitEkt
arkitektonisk	orkit3ktunisk
arkivere	orkiver3
arm	orm
arme	orme
arnt	ont
arr	or
arrangement	oroNS3moN
arrangere	oroNSer3
arrestere	or3ster3
arrogant	orugont
arte	ot3
artig	oti
artige	oti3
artigere	otir3
artigst	otikst
artigste	otikst3
artisjokk	otiSok
artistisk	otistisk
arve	orv3
arvelig	orv3li
arvelige	orv3li3
arveligere	orv3lir3
arveligst	orv3likst
arveligste	orv3likst3
asen	osn
asfaltere	osfolter3
asjett	oSEt
askebeger	osk3beg3r
asosial	osusiol
asparges	osporgEs
aspirere	ospirer3
aspirin	ospirin
assimilere	osimiler3
assistere	osister3
assosiere	osusier3
assurere	os3rer3
astma	osmo
astmatisk	osmotisk
astrologisk	ostrulogisk
astronomisk	ostrunumisk
at	ot
atal	otol
ateistisk	ot3istisk
atlantisk	otlontisk
atle	otl3
atletisk	otletisk
atrium	otri3m
atskillig	otSili
atskillige	otSili3
atskilligere	otSilir3
atskilligst	otSilikst
atskilligste	otSilikst3
atskilt	odSilt
atten	ot3n
attest	otEst
attestere	ot3ster3
attraktiv	otroktiv
attrå	otro
audiovisuell	E3diuvis3El
august	E3g3st
australsk	E3strolsk
autentisk	E3tEntisk
automatisk	E3tumotisk
automatisk dør	E3tumotiskder
autorisere	E3turiser3
autoritær	E3turitEr
av	ov
av og til	ovotil
avansere	ovoNser3
avbestille	ovbEstil3
avbilde	ovbild3
avblåse	ovblos3
avbryte	ovbrit3
avdekke	ovdEk3
avduke	ovd3k3
avdød	ovded
avertere	ovEter3
avfall	ovfol
avføring	ovferiN
avgang	ovgoN
avgifter	ovyift3r
avgjøre	ovyer3
avgjørelse	ovyer3ls3
avgjørende	ovyer3n3
avgrense	ovgrEns3
avhengig	ovhENi
avhengige	ovhENi3
avhengigere	ovhENir3
avhengigst	ovhENikst
avhengigste	ovhENikst3
avholdt	ovholt
avhøre	ovher3
avis	ovis
aviskiosk	ovisSiosk
avkjøle	ovSel3
avkledd	ovklEd
avkrefte	ovkrEft3
avlang	ovloN
avle	ovl3
avlede	ovled3
avlegge	ovlEi3
avleire	ovlEir3
avlevere	ovl3ver3
avlive	ovliv3
avlyse	ovlis3
avløse	ovles3
avmålt	ovmolt
avreise	ovrEis3
avrunde	ovr3n3
avse	ovse
avsender	ovsEn3r
avsi	ovsi
avsides	ovsid3s
avsidesliggende	ovsid3slig3n3
avsindig	ovsini
avsindige	ovsini3
avsindigere	ovsinir3
avsindigst	ovsinikst
avsindigste	ovsinikst3
avskaffe	ovskof3
avskjedige	ovSedig3
avskjære	ovSEr3
avskrekke	ovskrEk3
avskrekkende	ovskrEk3n3
avskrive	ovskriv3
avsky	ovSi
avskyelig	ovSi3li
avskyelige	ovSi3li3
avskyeligere	ovSi3lir3
avskyeligst	ovSi3likst
avskyeligste	ovSi3likst3
avslappa	ovSLop3t
avslappet	ovSLop3t
avslutte	ovSL3t3
avslå	ovSLo
avsløre	ovSLer3
avstand	ovston
avstå	ovsto
avtale	ovtol3
avverge	ovErg3
avvikle	ovikl3
avvise	ovis3
avvisende	ovis3n3
avvæpne	ovepn3
ba	bo
baby	bEibi
bacon	bEik3n
bad	bod bo
bade	bod3
badehette	bod3hEt3
badekåpe	bod3kop3
badering	bod3riN
badevakt	bod3vokt
badminton	bEdmint3n
badstue	bost3
bagasje	bogoS3
bagasjeluke	bogoS3l3k3
bagasjerom	bogoS3rum
bagatellisere	bogot3liser3
bak	bok
bake	bok3
baker	bok3r
bakeri	bok3ri
bakk	bok
bakke	bok3
bakken	bokn
baklengs	boklENs
baklys	boklis
bakse	boks3
baksnakke	boksnok3
bakt	bokt
bakte	bokt3
bakteriell	bokt3riEl
bakvaske	bokvosk3
bakvendt	bokv3nt
bakverk	bokvErk
balansere	boloNser3
balansert	boloNset
bale	bol3
balkong	bolkoN
ball	bol
balle	bol3
ballett	bolEt
ballkjole	bolSul3
ballsal	bolsol
ballspill	bolspil
balltrening	boltreniN
balsamere	bolsomer3
banal	bonol
banan	bonon
band	bEn
bandasjere	bonoSer3
bande	bon3
bane	bon3
banebrytende	bon3brit3n3
bank	boNk
banke	boNk3
banne	bon3
banner	bon3r
bannlyse	bonlis3
bar	bor
barbarisk	borborisk
barbent	borbent
barberblad	borberblo
barbere	borber3
barbervann	borbervon
bardus	bod3s
bare	bor3
baren	bon
barer	bor3r
barn	bon
barna	bono
barnebarn	bon3bon
barnebasseng	bon3bosEN
barnebillett	bon3bilEt
barnehage	bon3hog3
barneheis	bon3hEis
barnelege	bon3leg3
barnemat	bon3mot
barnemoderasjon	bon3mud3roSun
barnepass	bon3pos
barneporsjon	bon3puSun
barneseng	bon3sEN
barnesete	bon3set3
barnesjukdom	bon3S3kdum
barnevakt	bon3vokt
barokk	borok
baron	borun
baroni	boruni
barrikadere	borikoder3
barsk	boSk
bart	bot
barten	botn
baryton	boriton
base	bos3
basehopping	bos3hopiN
basere	boser3
basilikum	bosilik3m
basun	boS3n
batalje	botoly3
batteri	bot3ri
be	be
be noen om noe	benu3numnu3
bearbeide	beorbEid3
bebo	bEbu
bebreide	bEbrEid3
bedagelig	b3dog3li
bedagelige	b3dog3li3
bedageligere	b3dog3lir3
bedageligst	b3dog3likst
bedageligste	b3dog3likst3
bederva	b3dErv3t
bedervet	b3dErv3t
bedra	b3dro
bedrag	b3drog
bedrageri	bEdrog3ri
bedre	bedr3
bedrive	b3driv3
bedrøvelig	b3drev3li
bedrøvelige	b3drev3li3
bedrøveligere	b3drev3lir3
bedrøveligst	b3drev3likst
bedrøveligste	b3drev3likst3
bedugga	b3d3g3t
bedugget	b3d3g3t
bedårende	b3dor3n3
bedømme	b3dEm3
bedøve	b3dev3
befale	b3fole
befaring	b3foriN
befinne	b3fin3
befinne seg	bEfin3sEi
befolke	b3folk3
befordre	b3fodr3
befri	b3fri
befrielse	b3friy3ls3
befrier	b3friy3r
befrukte	b3fr3kt3
begava	b3gov3t
begegnen	b3gegn3n
begeistret	bEgEistr3t
begeistret for	bEgEistr3tfor
begge	bEi3
begi	b3yi
begjære	b3yEr3
begjærlig	b3yELi
begjærlige	b3yELi3
begjærligere	b3yELir3
begjærligst	b3yELikst
begjærligste	b3yELikst3
begrave	b3grov3
begrensa	b3grEns3t
begrense	b3grEns3
begrenset	b3grEns3t
begrep	b3grep
begripe	b3grip3
begripelig	b3grip3li
begripelige	b3grip3li3
begripeligere	b3grip3lir3
begripeligst	b3grip3likst
begripeligste	b3grip3likst3
begrunne	b3gr3n3
begynne	bEyin3
begynnelse	bEyinEls3
begå	bEgo
behage	b3hog3
behagelig	b3hog3li
behagelige	b3hog3li3
behageligere	b3hog3lir3
behageligst	b3hog3likst
behageligste	b3hog3likst3
behandle	b3honl3
beherska	b3hESko
beherske	b3hESk3
behersket	b3hESk3t
beholde	b3hol3
beholder	bEhol3r
behørig	b3heri
behørige	b3heri3
behørigere	b3herir3
behørigst	b3herikst
behørigste	b3herikst3
behøve	b3hev3
beige	beS beZ3
bein	bEin
beinhard	bEinhor
beisk	bEisk
beist	bEist
beite	bEit3
bekjempe	b3SEmp3
bekjenne	b3SEn3
bekjent	b3SEnt
bekjente	bESEnt3
bekjentskap	bESEntskop
bekken	bEkn
bekkener	bEkn3r
bekkenet	bEkn3
beklage	b3klog3
beklage seg over	bEklog3sEiov3r
beklagelig	b3klog3li
beklagelige	b3klog3li3
beklageligere	b3klog3lir3
beklageligst	b3klog3likst
beklageligste	b3klog3likst3
beklager	b3klog3r
bekle	b3kle
beklemt	b3klEmt
bekmørk	bekmErk
bekrefte	b3krEft3
bekvem	b3kvEm
bekymre	b3Simr3
bekymre seg om	bESimr3sEium
beleilig	b3lEili
beleilige	b3lEili3
beleiligere	b3lEilir3
beleiligst	b3lEilikst
beleiligste	b3lEilikst3
beleire	b3lEir3
belest	b3lest
belgier	bElgi3r
belgisk	bElgisk
belje	bEly3
belme	bELm3
belte	bElt3
beltet	bElt3
belyse	b3lis3
belære	b3lEr3
belønne	b3lEn3
belønning	bElEniN
beløp	bElep
bemerke	b3mErk3
bemerkelsesverdig	b3mErk3ls3svEdi
bemerkelsesverdige	b3mErk3ls3svEdi3
bemerkelsesverdigere	b3mErk3ls3svEdir3
bemerkelsesverdigst	b3mErk3ls3svEdikst
bemerkelsesverdigste	b3mErk3ls3svEdikst3
bemyndige	b3minig3
ben	ben
bende	bEn3
benekte	b3nEkt3
benk	bENk
bensinkanne	bEnsinkon3
bensinpumpe	bEnsinpump3
benytte	b3nit3
benåde	b3nod3
benådning	b3nodniN
beordre	b3odr3
ber	ber
beredt	b3rEt
beregne	b3rEin3
beregning	b3rEiniN
berette	b3rEt3
berge	bErg3
bergningstjeneste	bErgiNstyEn3st3
bergta	bErkto
bero	b3ru
berolige	bEruli3
beroligende middel	bEruligEn3 mid3l
berusa	b3r3s3t
beruset	b3r3s3t
berykta	b3rikt3t
beryktet	b3rikt3t
berømme	b3rEm3
berømt	b3rEmt
berøre	b3rer3
besatt	b3sot
beseire	b3sEir3
besette	b3sEt3
besikte	b3sikt3
besiktigelse	b3siktigEls3
besinne	b3sin3
besitte	b3sit3
beskatte	b3skot3
beskjed	b3Se
beskjeden	b3Sed3n
beskjeftige	b3SEftig3
beskjære	b3SEr3
beskrive	b3skriv3
beskytte	b3Sit3
beskyttelsesfaktor	bESitEls3sfoktur
beslaglegge	b3SLogl3g3
beslekta	b3SLEkt3t
beslektet	b3SLEkt3t
beslutte	b3SL3t3
besluttsom	b3SL3tsom
best	best
bestandig	b3stoni
bestandige	b3stoni3
bestandigere	b3stonir3
bestandigst	b3stonikst
bestandigste	b3stonikst3
beste	bEst3
bestefar	bEst3for
bestemme	b3stEm3
bestemor	bEst3mur
bestemt	b3stEmt
bestialsk	b3stiolsk
bestige	b3stig3
bestikk	bestik
bestikke	b3stik3
bestille	b3stil3
bestilling	bEstiliN
bestimmt	b3Stimt
bestride	b3strid3
bestå	b3sto
bestå av	bEstoov
bestøve	b3stev3
besvare	b3svor3
besvime	b3svim3
besvimelse	bEsvimEls3
besværlig	b3svELi
besværlige	b3svELi3
besværligere	b3svELir3
besværligst	b3svELikst
besværligste	b3svELikst3
besynderlig	b3sin3Li
besynderlige	b3sin3Li3
besynderligere	b3sin3Lir3
besynderligst	b3sin3Likst
besynderligste	b3sin3Likst3
besøk	b3sek
besøke	b3sek3
besøke noen	b3sek3nu3n
besørge	b3sErg3
betale	b3tol3
betale kontant	bEtol3 kuntont
betale ut	bEtol3
betaling	bEtoliN
betatt	b3tot
betegne	b3tEin3
betenkelig	b3tENk3li
betenkelige	b3tENk3li3
betenkeligere	b3tENk3lir3
betenkeligst	b3tENk3likst
betenkeligste	b3tENk3likst3
betennelse	bEtEnEls3
betent	b3tEnt
betjene	b3tyen3
betjening	bEtyeniN
betlehem	betlEm
betone	b3tun3
betong	bEtoN
betrakte	b3trokt3
betraktelig	b3trokt3li
betraktelige	b3trokt3li3
betrakteligere	b3trokt3lir3
betrakteligst	b3trokt3likst
betrakteligste	b3trokt3likst3
betro	b3tru
betryggende	b3trig3n3
betvile	b3tvil3
bety	b3ti
betydelig	b3tid3li
betydelige	b3tid3li3
betydeligere	b3tid3lir3
betydeligst	b3tid3likst
betydeligste	b3tid3likst3
betydning	bEtidniN
betydningsfull	b3tidniNsf3l
beundre	b33ndr3
bevare	b3vor3
beve	bev3
bevege	b3veg3
bevegelig	b3veg3li
bevegelige	b3veg3li3
bevegeligere	b3veg3lir3
bevegeligst	b3veg3likst
bevegeligste	b3veg3likst3
bevegelse	b3veg3ls3
bevegelseshemmet	bEvegEls3shEm3t
bever	bEv3r
bevilge	b3vilg3
bevise	b3vis3
bevisst	b3vist
bevisstløs	b3vistles
bevitne	b3vitn3
bevokte	b3vokt3
bibel	bib3l
bibelen	bib3ln bibEn
bibler	bibl3r
bidra	bidro
bie	bi3
bifall	bifol
bifalle	bifol3
biff	bif
bifil	bifil
bihulebetennelse	bih3l3bEtEnEls3
bikini	bikini
bikkje	biS3
bil	bil
bilbelte	bilbElt3
bilde	bild3
bilene	biln3
biljekk	bilyEk
billede	bil3d3
billedhogger	bilEdhog3r
billedhugger	bil3dh3g3r
billedlig	bil3dli
billedlige	bil3dli3
billedligere	bil3dlir3
billedligst	bil3dlikst
billedligste	bil3dlikst3
billett	bilEt
billettluke	bilEtl3k3
billettmaskin	bilEtmoSin
billettpris	bilEtpris
billig	bili
billige	bili3
billigere	bilir3
billigst	bilikst
billigste	bilikst3
bilradio	bilrodiu
bilsete for baby	bilset3forbEibi
biltog	biltog
binde	bin3
biologisk	biulogisk
bis	bis
bisarr	bisor
bisette	bisEt3
bisk	bisk
bister	bist3r
bistå	bisto
bit	bit
bite	bit3
biter	bit3r
bitre	bitr3
bitrere	bitr3r3
bitrest	bitr3st
bitter	bit3r
bittert	bit3t
bivåne	bivon3
bjeffe	byEf3
bjørk	byErk
bla	blo
blad	blod blo
blafre	blofr3
blakk	blok
blande	blon3
blandet	blon3t
blank	bloNk
blankett	bloNkEt
blant	blont
blasfemisk	blosfemisk
blass	blos
bleie	blEi3r
blek	blek
bleke	blek3
blemme	blEm3
blende	blEn3
bli	bli
bli enige om	blieni3um
blid	bli
blikk	blik
blikkstille	blikstil3
blind	blin
blinde	blin3
blindehund	blin3h3n
blindeskrift	blin3skrift
blindestokk	blin3stok
blinke	bliNk3
blinklys	bliNklis
blod	blu
blodig	bludi
blodige	bludi3
blodigere	bludir3
blodigst	bludikst
blodigste	bludikst3
blodtype	blutip3
blodåre	bluor3
blogg	blog
blokk	blok
blokkere	bloker3
blomkål	blumkol
blomst	blomst
blomster	blomst3r
blomsterbutikk	blumst3rb3tik
blomstre	blomstr3
blomstrende	blomstr3n3
blond	blon
blote	blut3
blott	blot
blotte	blot3
blues	bl3s
blunde	bl3n3
blunke	bluNk3
bluse	bl3s3
blusse	bl3s3
blyg	blig
blygsel	bliks3l
blå	blo
blåbær	blobEr
blåfrossen	blofros3n
blåne	blon3
blåse	blos3
blåser	blos3r
blåveis	blovEis
blåøyd	bloEyd
blære	blEr3
blærete	blEr3t3
blø	ble
blødning	bledniN
bløffe	blEf3
bløt	blet
bløtgjøre	bletyer3
bløtlegge	bletlEi3
bo	bu
bobil	bubil
boble	bobl3
body	bodi
boikotte	boykot3
bok	buk
bokhandel	bukhon3l
boks	boks
bokser	boksEr
boksing	boksiN
bokstav	bukstov
bokstavelig	bukstov3li
bokstavelige	bukstov3li3
bokstaveligere	bukstov3lir3
bokstaveligst	bukstov3likst
bokstaveligste	bukstov3likst3
boksåpner	boksopn3r
bolig	buli
bolige	buli3
boligere	bulir3
boligst	bulikst
boligste	bulikst3
bolte	bolt3
bombardere	bumboder3
bombe	bumb3
bomme	bum3
bompenger	bumpEng3r
bondegård	bun3gor
bone	bun3
bord	bod bur
bordtennis	butEnis
bore	bor3
borg	borg
borgerlig	borg3li
borgerlige	borg3li3
borgerligere	borg3lir3
borgerligst	borg3likst
borgerligste	borg3likst3
bort	but
borte	but3
bortføre	butfer3
bortimot	butimut
bortimot klokka tolv	butimut kloko tol
bortkasta	butkosto
bortkastet	butkosto
bortreist	butrEist
bortskjemt	butS3mt
bosette	busEt3
bosse	bEs3
bosted	busted
bot	but
botanisk	butonisk
bote	bet3
botsøvelse	butsev3ls3
bowling	bouliN
bra	bro
bragd	brogd
brake	brok3
brakke	brok3
brann	bron
brannfarlig	bronfoLi
brannmann	bronmon
brannsalve	bronsolv3
brannslokker	bronSLok3r
brannvesen	bronves3n
brasiliansk	brosilionsk
bratt	brot
braute	brE3t3
bre	bre
bred	bre
bredd	brEd
bredde	brEd3
breddeformat	brEd3fumot
bredt	brEt
breer	bre3r
brei	brEi
breke	brek3
brekke	brEk3
brems	brEms
bremse	brEms3
brenne	brEn3
brer	brer
brette	brEt3
brev	brev
bringe	briN3
bringe tilbake	briN3tilbok3
bringen	briN3n
bris	bris
briste	brist3
britisk	britisk
bro	bru
brodere	bruder3
broderi	brodEri
broen	bruun bruwn
broer	bruw3r bruur
broket	bruk3t
bronkitt	bruNkit
bronse	broNs3
bror	brur
brors	bruS
brosjyre	bruSir3
brosme	brosm3
bru	br3
brudd	br3d
brukbar	br3kbor
bruke	br3k3
brukket	bruk3t
brukthandel	br3kthon3l
brumme	brum3
brun	br3n
brune	br3n3
brus	br3s
bruse	br3s3
brutal	br3tol
bry	bri
brygge	brig3
bryllup	bril3p
brysk	brisk
brysom	brisom
bryst	brist
brystvorte	bristvut3
bryte opp	brit3op
brå	bro
bråk	brok
bråke	brok3
bråkete	brok3t3
bråkjekk	broSEk
brød	bre
brødrister	brerist3r
brøle	brel3
brønn	brEn
brøyte	brEyt3
bu	b3
bud	b3d
buddhistisk	b3distisk
budsjett	b3dSEt
budsjettere	b3dS3ter3
bue	b33
bugne	buNn3
bukett	b3kEt
bukke	buk3
bukse	buks3
bukt	b3kt
bukte	bukt3
buldre	b3ldr3
bule	b3l3
bulgarsk	b3lgoSk
bulke	b3lk3
bunad	b3nod
bunke	buNk3
bunn	b3n
bunt	bont
bunte	b3nt3
burde	b3d3
buss	b3s
bustete	b3st3t3
butt	b3t
by	bi
bybuss	bib3s
bydel	bidel
byer	biy3r
bygd	bigd
byge	big3 bi3
bygg	big
bygge	big3
byggeplass	big3plos
byggverk	bigvErk
bygning	bigniN
bykart	bikot
bykse	biks3
byll	bil
bymur	bim3r
bypass	boipos
byr	bir
byrundtur	r3nt3r
byråkratisk	birokrotisk
bysentrum	bisEntr3m
bytte	bit3
både	bod3
båe	bo3
bål	bol
båre	bor3
båt	bot
båtene	botn3
bærbar	bErbor
bærbar cd-spiller	bErboTedespil3r
bære	bEr3
bøker	bek3r
bølge	bElg3
bøllete	bEl3t3
bønder	bEn3r
bønn	bEn
bønne	bEn3
bønnene	bEn3n3
bønnfalle	bEnfol3
børse	bES3
børste	bESt3
bøte	bet3
bøtelegge	bet3lEi3
bøter	bet3r
bøye	bEy3
ca.	sirko
campe	kEmp3
camping	kEmpiN
canada	konodo
canadisk	konodisk
catering	kEitEriN
cd	Tede
cd-spiller	Tedespil3r
cent	sEnt
centimeter	sEntimet3r
champagne	Sompony3
choke	Sok
cirka	sirko
crawle	krol3
cruise	kr3s
curling	TELiN
cyanid	siyonid
da	do
dabbe	dob3
dag	dog
dagdrøm	dogdrEm
dagdrømme	dogdrEm3
dagens rett	dog3nsrEt
daggry	dogri
daglig	dogli
dagligdags	doglidoks
daglige	dogli3
dagligere	doglir3
dagligst	doglikst
dagligste	doglikst3
dagligvareforretning	doglivor3forEtniN
dagligvarehandel	doglivor3hon3l
dagskort	dokskot
dagslys	dokslis
dagsorden	doksod3n
dagstur	dokst3r
dal	dol
dale	dol3
dalen	don
dam	dom
dame	dom3
dampe	domp3
dandere	donder3
danne	don3
dannet	don3t
dans	dons
danse	dons3
danseorkester	dons3orkEst3r
danser	dons3r
danserinne	dons3rin3
danseteater	donsEteot3r
dansk	donsk
danske	donsk3
datere	doter3
dato	dotu
datter	dot3r
david	dovid
de	di
de beste	dibEst3
debattere	d3boter3
debutere	d3b3ter3
dedisere	d3diser3
defekt	dEfEkt
defensiv	dEfoNsiv
defilere	d3filer3
definere	d3finer3
definitiv	dEfinitiv
deg	dEi
degenerere	deg3n3rer3
degradere	degroder3
deilig	dEili
deilige	dEili3
deiligere	dEilir3
deiligst	dEilikst
deiligste	dEilikst3
deise	dEis3
dekadent	d3kodEnt
dekk	dEk
dekke	dEk3
deklamere	d3klomer3
deklarere	d3klorer3
dekorere	d3kurer3
dekret	d3kret dEkret
dekretere	dEkr3ter3
del	del
delaktig	delokti
delaktige	delokti3
delaktigere	deloktir3
delaktigst	deloktikst
delaktigste	deloktikst3
dele	del3
delegere	d3l3ger3
delikat	d3likot
delikatesseforretning	dElikotEs3forEtniN
delirisk	d3lirisk
delkasko	delkosku
delta	dElto
delvis	delvis
dem	dEm
dement	d3mEnt
dementere	d3moNter3
demokratisk	d3mukrotisk
demonstrativ	domonstrotiv
demonstrere	d3munstrer3
demontere	demunter3
dempe	dEmp3
dempet	dEmp3t
demre	dEmr3
den	dEn
den bekjente	dEnbESEnt3
den beste	dEnbEst3
den gangen	dEngoN3n
den skadede	dEnskod3d3
denge	dEN3
denn	dEn
denne	dEn3
deodorant	dEuduront
deponere	d3puner3
deportere	d3puter3
deprimert	d3primet
der	dEr
dere	der3
deres	der3s
deretter	dErEt3r
derfor	dErfor
dersom	dESom
desember	d3sEmb3r
desertere	d3sEter3
desidert	d3sidet
designe	disEin3
desimal	d3simol
desinfisere	dEsinfiser3
desorientert	dEsori3ntet
desperat	d3sp3rot
despot	dEsput
despotisme	dEsputism3
dessert	dEsEr
dessuten	dEs3t3n
dessverre	dEsvEr3
destruere	d3str3er3
destruktiv	dEstr3ktiv
det	dE
det beste	dEbEst3
det er	dEEr
det finnes	dEfin3s
det fins	dEfins
det samme	dEsom3
detaljert	d3tolyet
detektiv	dEt3ktiv
dette	dEt3
diabetiker	diobetik3r
diagnose	diognus3
diagonal	diogunol
dialyse	diyolis3
diare	diore
die	di3
diett	diEt
differensiere	dif3roNsiyer3
diffus	dif3s
difteri	dift3ri
diftong	diftoN
diftongere	diftoNger3
diger	dig3r
digital	digitol
dike	dik3
dikt	dikt
dikte	dikt3
diktere	dikter3
dikterisk	dikt3risk
dilte	dilt3
dim	dim
dimme	dim3
din	din
dine	dine
dingle	diNl3
dings	diNs
diplomatisk	diplumotisk
direkt	dirEkt
direkte	dirEkt3
direkte fly	dirEkt3fli
direktiv	dir3ktiv
dirigent	dirigEnt
dirigere	diriger3
dirke	dirk3
dirre	dir3
disig	disi
disige	disi3
disigere	disir3
disigst	disikst
disigste	disikst3
disiplinere	disipliner3
disiplinær	disiplinEr
diske	disk3
diskotek	diskutek
diskre	diskre
diskriminere	diskriminer3
diskré	diskre
diskutabel	disk3tob3l
diskutere	disk3ter3
diskvalifisere	diskvolifiser3
dispensere	dispoNser3
disponere	dispuner3
disponibel	dispunib3l
disputere	disp3ter3
disse	dis3
dissekere	dis3ker3
distansere	distonser3
distingvert	distiNvet
distrahere	distroher3
distre	distre
distribuere	distrib3er3
distré	distre
ditt	dit
diverse	divES3
dividere	divider3
djerv	dyErv
djevel	dyev3l
djevelsk	dyev3lsk
dobbel	dob3l
doble	dobl3
dog	dog
dogme	dogm3
doktrinær	dotrinEr
dokumentere	duk3m3nter3
dom	dum dom
dominant	duminont
dominere	duminer3
domkirke	dumSirk3
dommer	dom3r
donere	duner3
dope	dup3
doppelt	doplt
dorme	dorm3
dorsk	doSk
dort	dot
dosere	duser3
dossere	doser3
dov	dev
doven	dov3n
dra	dro
drakt	drokt
drama	dromo
dramatikk	dromotik
dramatisk	dromotisk
drap	drop
drasse	dros3
drastisk	drostisk
dreie	drEi3
drektig	drEkti
drektige	drEkti3
drektigere	drEktir3
drektigst	drEktikst
drektigste	drEktikst3
drenere	dr3ner3
drepe	drep3
dress	drEs
dressere	dr3ser3
dressing	drEsiN
dreven	drev3n
driftig	drifti
driftige	drifti3
driftigere	driftir3
driftigst	driftikst
driftigste	driftikst3
drikk	drik
drikke	drik3
drille	dril3
drin	drin
dringend	driN3nt
driste	drist3
dristig	dristi
dristige	dristi3
dristigere	dristir3
dristigst	dristikst
dristigste	dristikst3
drive	driv3
dronning	droniN
droppe	drop3
drosje	droS3
drosjesjåfør	droS3Sofer
druesukker	dr33s3k3r
drukken	druk3n
drukne	drukn3
dryppe	drip3
drysse	dris3
dråpe	drop3
drøfte	drEft3
drøm	drEm
drømme	drEm3
drømmeaktig	drEmokti
drønne	drEn3
drøvel	drEv3l
drøy	drEy
drøye	drEy3
du	d3
dualisme	d3wolism3
due	d33
duell	d3wEl
duellere	d3wEler3
dufte	d3ft3
duge	d3g3
dugge	d3g3
dugnad	d3gnod
duk	d3k
dukke	d3k3
dukkert	duk3t
dulte	d3lt3
dum	dum
dumdristig	dumdristi
dumdristige	dumdristi3
dumdristigere	dumdristir3
dumdristigst	dumdristikst
dumdristigste	dumdristikst3
dumm	dom
dumme	dum3
dump	dump
dumpe	dumpe
dundre	d3ndr3
dunke	duNk3
dunkel	doNkl duNk3l
dunste	d3nst3
duo	d3wu
duplisere	d3pliser3
duplo	d3plu
durabelig	d3rob3li
durabelige	d3rob3li3
durabeligere	d3rob3lir3
durabeligst	d3rob3likst
durabeligste	d3rob3likst3
dure	d3r3
durkdreven	d3rkdrev3n
dusin	d3sin
dusj	d3S
dusje	d3S3
duve	d3v3
dvele	dvel3
dy	di
dybde	dibd3
dydig	didi
dydige	didi3
dydigere	didir3
dydigst	didikst
dydigste	didikst3
dykke	dik3
dyktig	dikti
dyktige	dikti3
dyktigere	diktir3
dyktigst	diktikst
dyktigste	diktikst3
dynamisk	dinomisk
dynasti	dinosti
dynke	diNk3
dyp	dip
dyppe	dip3
dypt	dipt
dyr	dir
dyrebar	dir3bor
dyrisk	dirisk
dyrke	dirk3
dyrlege	diLeg3
dysse	dis3
dyster	dist3r
dytte	dit3
dyvåt	divot
dåne	don3
dåp	dop
dåpshandling	dopshondliN
dåre	dor3
dårlig	doLi
dårlige	doLi3
dårligere	doLir3
dårligst	doLikst
dårligste	doLikst3
dø	de
død	ded
dødelig	ded3li
dødelige	ded3li3
dødeligere	ded3lir3
dødeligst	ded3likst
dødeligste	ded3likst3
døgn	dEyn
dølge	dElg3
dømme	dEm3
døpe	dep3
dør	der
dørslag	dESLog
dørstokk	deStok
døse	des3
døsig	desi
døsige	desi3
døsigere	desir3
døsigst	desikst
døsigste	desikst3
døv	dev
døyve	dEyv3
e-post	epost
ebbe	Eb3
eddik	Edik
edel	ed3l
edru	edr3
edruelig	Edr33li
edruelige	Edr33li3
edrueligere	Edr33lir3
edrueligst	Edr33likst
edrueligste	Edr33likst3
edvard	Edvod Edvot
effektiv	Ef3ktiv
egen	egn eg3n
egenhendig	eg3nhEni
egenhendige	eg3nhEni3
egenhendigere	eg3nhEnir3
egenhendigst	eg3nhEnikst
egenhendigste	eg3nhEnikst3
egennyttig	eg3niti
egennyttige	eg3niti3
egennyttigere	eg3nitir3
egennyttigst	eg3nitikst
egennyttigste	eg3nitikst3
egenrådig	eg3nrodi
egenrådige	eg3nrodi3
egenrådigere	eg3nrodir3
egenrådigst	eg3nrodikst
egenrådigste	eg3nrodikst3
egentlig	eg3ntli
egentlige	eg3ntli3
egentligere	eg3ntlir3
egentligst	eg3ntlikst
egentligste	eg3ntlikst3
egg	Eg
egge	Ei3
eggerøre	Ei3rer3
egle	Eil3
egne	Ein3
egoistisk	Eiuistisk
egosentrisk	egusEntrisk
egyptisk	Egiptisk
ei	Ei
ei uke til	Ei3k3til
eie	Ei3
eiendom	Ei3nom
eier	Ei3r
ekkel	Ek3l
eksakt	Eksokt
eksaltert	Eksoltet
eksaminere	Eksominer3
eksempel	EksEmp3l
eksemplarisk	Eks3mplorisk
eksentrisk	EksEntrisk
eksepsjonell	Eks3pSunEl
eksistensiell	Eksist3nsiEl
eksistere	Eksister3
ekskludere	Ekskl3der3
eksklusiv	Ekskl3siv
eksosrør	Eksusrer
eksotisk	Eksutisk
ekspandere	EkspoNder3
ekspedere	Eksp3der3
eksperiment	Eksp3rimEnt
eksperimentell	Eksp3rim3ntEl
eksperimentere	Eksp3rim3nter3
eksplodere	Ekspluder3
eksplosiv	Eksplusiv
eksponere	Ekspuner3
eksportere	Ekspoter3
ekspresjonisme	EksprESunism3
ekspressbrev	EksprEsbrev
ekspressbuss	EksprEsb3s
ekstatisk	Ekstotisk
ekstensiv	Ekst3nsiv
ekstra	Ekstro
ekstraordinær	EkstroodinEr
ekstrem	Ekstrem
ekte	Ekt3
ektemann	Ekt3mon
ektepar	Ekt3por
ekteskap	Ekt3skop
elastisk	Elostisk
elde	Eld3
eldes	Eld3s
eldgammel	Elgom3l
eldre	Eldr3
elefant	El3font
elegant	El3gont
elektrisk	ElEktrisk
elektrisk forretning	ElEktrisk forEtniN
elektriske artikler	ElEktrisk3 otikl3r
elektronisk	El3ktrunisk
elementær	El3m3ntEr
elendig	ElEni
elendige	ElEni3
elendigere	ElEnir3
elendigst	ElEnikst
elendigste	ElEnikst3
elf	Elf
eliminere	Eliminer3
elise	Elis3
eller	El3r
ellers	El3S
elleve	Elv3
ellevill	El3vil
elske	Elsk3
elsker	Elsk3r
elskling	ElskliN
elskverdig	ElskvEdi
elskverdige	ElskvEdi3
elskverdigere	ElskvEdir3
elskverdigst	ElskvEdikst
elskverdigste	ElskvEdikst3
elte	Elt3
elv	Elv
emballere	Emboler3
emigrere	Emigrer3
eminent	EminEnt
emmen	Em3n
emne	Emn3
emosjonell	EmuSunEl
empatisk	Empotisk
empfehlen	Empfel3n
empirisk	Empirisk
en	en
en gang	EngoN
en gang til	EngoNtil
enda	Eno
ende	En3
endelig	En3li
endelige	En3li3
endeligere	En3lir3
endeligst	En3likst
endeligste	En3likst3
endelse	En3ls3
endeløs	En3les
ender	En3r
endestasjon	En3stoSun
endevende	En3vEn3
endre	Endr3
endring	EndriN
ene	en3
energisk	EnErgisk
enerverende	EnErver3n3
enerådende	en3rod3n3
enes	en3s
eneste	en3st3
enestående	en3sto3n3
enfoldig	Enfoldi
enfoldige	Enfoldi3
enfoldigere	Enfoldir3
enfoldigst	Enfoldikst
enfoldigste	Enfoldikst3
eng	EN
engasjere	ENgoSer3
engelsk	EN3lsk
engste	ENst3
engstelig	ENst3li
engstelige	ENst3li3
engsteligere	ENst3lir3
engsteligst	ENst3likst
engsteligste	ENst3likst3
enhetlig	enhetli
enhetlige	enhetli3
enhetligere	enhetlir3
enhetligst	enhetlikst
enhetligste	enhetlikst3
enhver	EnvEr
enig	eni
enige	eni3
enigere	enir3
enigst	enikst
enigste	enikst3
enke	ENk3
enkel	ENk3l
enkelt	ENk3lt
enkeltstående	ENk3ltsto3n3
enkemann	ENk3mon
enkle	ENkl3
enklere	ENkl3r3
enklest	ENkl3st
enn	En
ennå ikke	Enoik3
enorm	Enorm
ens	ens
ensarta	ensoto
ensartet	ensoto
ensbetydende	ensb3tid3n3
ense	Ens3
ensfarga	ensforgo
ensfarget	ensforgo
ensformig	ensformi
ensformige	ensformi3
ensformigere	ensformir3
ensformigst	ensformikst
ensformigste	ensformikst3
ensidig	ensidi
ensidige	ensidi3
ensidigere	ensidir3
ensidigst	ensidikst
ensidigste	ensidikst3
enslig	enSLi
enslige	enSLi3
ensligere	enSLir3
ensligst	enSLikst
ensligste	enSLikst3
ensom	ensom
enten eller	Ent3n El3r
entre	Entr3
entusiastisk	Ent3siostisk
epidemisk	Epidemisk
epileptisk	EpilEptisk
episk	episk
episode	Episud3
eple	Epl3
eplekjekk	Epl3SEk
epoke	Epuk3
er	Er
erfare	Erfor3
erfaren	Erfor3n
erfaring	ErforiN
ergerlig	Erg3li
ergerlige	Erg3li3
ergerligere	Erg3lir3
ergerligst	Erg3likst
ergerligste	Erg3likst3
ergre	Ergr3
ergre seg over	Ergr3sEiov3r
erindre	Erindr3
erkjenne	ErSEn3
erklære	EklEr3 ErklEr3
erme	Erm3
ernst	Enst
ernære	EnEr3
erobre	Erubr3
erotisk	Erutisk
erstatte	EStot3
ert	Et
erte	Et3
erter	Et3r
erverve	ErvErv3
ese	es3
eskadre	Eskodr3
essensiell	Es3nsiEl
estetisk	Estetisk
et	Et
et annet sted	Eton3tsted
et avslitt leddbånd	EtovSLitlEdbon
et par	Etpor
etablere	Etobler3
etasje	EtoS3
etasjeseng	EtoS3sEN
ete	et3
eter	et3r
eterisk	Eterisk
etisk	etisk
etnisk	Etnisk
etnologisk museum	Etnulugisk m3sE3m
ett	Et
etter	Et3r
etterforske	Et3rfoSk3
etterfølge	Et3rfEl3
etterkomme	Et3rkom3
etterlate	Et3Lot3
etterligne	Et3LiNn3
etterlyse	Et3Lis3
ettermiddag	Et3rmidog
etternavn	Et3novn
etterpåklok	Et3rpokluk
etterse	Et3Se
ettersende	Et3SEn3
ettersøke	Et3Sek3
ettertenksom	Et3tENksom
ettertrykkelig	Et3trik3li
ettertrykkelige	Et3trik3li3
ettertrykkeligere	Et3trik3lir3
ettertrykkeligst	Et3trik3likst
ettertrykkeligste	Et3trik3likst3
ettroms leilighet	EtrumslEilihet
eu-borger	E3borg3r
euro	E3ru
europeer	E3rupe3r
europeisk	E3rupeisk
evakuere	Evok3er3
evaluere	Evol3er3
eventuell	Ev3nt3El
eventyr	evntir ev3ntir
eventyrlig	Ev3ntiLi
eventyrlige	Ev3ntiLi3
eventyrligere	Ev3ntiLir3
eventyrligst	Ev3ntiLikst
eventyrligste	Ev3ntiLikst3
evig	evi
evige	evi3
evigere	evir3
evigst	evikst
evigste	evikst3
evinnelig	Evin3li
evinnelige	Evin3li3
evinneligere	Evin3lir3
evinneligst	Evin3likst
evinneligste	Evin3likst3
evne	Evn3
fabelaktig	fob3lokti
fabelaktige	fob3lokti3
fabelaktigere	fob3loktir3
fabelaktigst	fob3loktikst
fabelaktigste	fob3loktikst3
fable	fobl3
fabrikant	fobrikont
fabrikasjon	fobrikoSun
fabrikk	fobrik
fabrikkere	fobriker3
fager	fog3r
faglig	fogli
faglige	fogli3
fagligere	foglir3
fagligst	foglikst
fagligste	foglikst3
faglært	foglEt
fair	fEr
fajanse	foyons3
fakke	fok3
fakkel	fok3l
fakse	foks3
faktisk	foktisk
falle	fol3
falleferdig	fol3fEdi
falleferdige	fol3fEdi3
falleferdigere	fol3fEdir3
falleferdigst	fol3fEdikst
falleferdigste	fol3fEdikst3
fallitt	folit
falme	folm3
falsk	folsk
falske	folsk3
familie	fomili3
familiær	fomiliEr
famle	foml3
fanatisk	fonotisk
fane	fon3
fange	foN3
fant	font
fantasere	fontoser3
fantastisk	fontostisk
far	for
fare	for3
farga	forg3t
farge	forg3
fargeblind	forg3blin
fargehandel	forg3hon3l
fargerik	forg3rik
farget	forg3t
farlig	foLi
farlige	foLi3
farligere	foLir3
farligst	foLikst
farligste	foLikst3
fart	fot
farte	fot3
fartsmåler	fotsmol3r
fasade	fosod3
fascinere	fosiner3
fascistisk	foSistisk
fase	fos3
fasjonabel	foSunob3l
fast	fost
faste	fost3
fastelavn	fost3lovn
fastende	fost3n3
fastholde	fosthol3
fastland	fostlon
fastsette	fostsEt3
fat	fot
fatal	fotol
fatle	fotl3
fatte	fot3
fattet	fot3t
fattig	foti
fattige	foti3
fattigere	fotir3
fattigslig	fotiSLi
fattigslige	fotiSLi3
fattigsligere	fotiSLir3
fattigsligst	fotiSLikst
fattigsligste	fotiSLikst3
fattigst	fotikst
fattigste	fotikst3
faun	fEwn
favorisere	fovuriser3
feber	feb3r
febrilsk	f3brilsk
februar	f3br3or
fedme	fEdm3
fehlen	fel3n
feide	fEid3
feie	fEi3
feig	fEig
feige	fEigi3
feigere	fEigir3
feigst	fEigikst
feigste	fEigikst3
feil	fEil
feilaktig	fEilokti
feilaktige	fEilokti3
feilaktigere	fEiloktir3
feilaktigst	fEiloktikst
feilaktigste	fEiloktikst3
feile	fEil3
feilfri	fEilfri
feilslått	fEilSLot
feiltagelse	fEiltogEls3
feire	fEir3
feit	fEit
fekte	fEkt3
felle	fEl3
felles	fEl3s
felt	fElt
fem	fEm
femten	fEmt3n
femti	fEmti
fengsel	fENS3l
fengsle	fENSL3
fennikel	fEnik3l
fenomenal	fEnum3nol
ferdes	fEd3s
ferdig	fEdi
ferdige	fEdi3
ferdigere	fEdir3
ferdigkokt	fEdikukt
ferdigst	fEdikst
ferdigste	fEdikst3
ferge	fEry3
ferie	feriy3
feriehus	feri3h3s
feriere	fErier3
ferje	fEry3
fersk	fESk
fersken	fESk3n
feste	fEst3
festival	fEstivol
festlig	fEstli
festlige	fEstli3
festligere	fEstlir3
festligst	fEstlikst
festligste	fEstlikst3
festne	fEstne
festning	fEstniN
fet	fet
fett	fEt
fetter	fEt3r
fettere	fEt3r3
fetteren	fEtEn
fettern	fEtEn
fiendtlig	fi3ntli
fiendtlige	fi3ntli3
fiendtligere	fi3ntlir3
fiendtligst	fi3ntlikst
fiendtligste	fi3ntlikst3
fiffig	fifi
fiffige	fifi3
fiffigere	fifir3
fiffigst	fifikst
fiffigste	fifikst3
figurere	fig3rer3
fike	fik3
fiken	fik3n
fiks	fiks
fiktiv	fiktiv
file	fil3
fille	fil3
fillete	fil3t3
film	film
filme	film3
filmfølsomhet	filmfElsomhet
filmskuespiller	filmsk33spil3r
filmtekniker	filmtEknik3r
filmteknikker	filmtEknik3r
filologisk	filulogisk
filosofisk	filusufisk
filteraktig	filt3rokti
filtrat	filtrot
filtrere	filtrer3
fin	fin
finansiere	finonsier3
finger	fiN3r
fingerring	fiN3riN
fingert	fiNget
fingre	fiNr3
finne	fin3
finne sted	fin3sted fin3ste
finner	fin3r
finnes	fin3s
finsk	finsk
fiolett	fiolEt
fiolinist	fiulinist
fire	fir3
firkanta	firkonto
firkantet	firkonto
firma	firmo
fisk	fisk
fiske	fisk3
fiskebein	fisk3bEin
fiskehandel	fisk3hon3l
fiskehavn	fisk3hovn
fiskekort	fisk3kut
fiskestang	fisk3stoN
fiskesuppe	fisk3s3p3
fiskevær	fisk3vEr
fit	fit
fitnessenter	fitnEsEnt3r
fjell	fyEl
fjellbygd	fyElbigd
fjellklatring	fyElklotriN
fjelltopp	fyEltop
fjellvegg	fyElvEg
fjern	fSEn
fjerne	fyEn3
fjernlys	fyEnlis
fjernsyn	fyEnsin
fjernsynsrom	fyEnsinsrum
fjollete	fyol3t3
fjord	fyur
fjorten	fyut3n
fjære	fyEr3
flagg	flog
flagge	flog3
flagre	flogr3
flakke	flok3
flakse	floks3
flamme	flom3
flamsk	flomsk
flaske	flosk3
flaskeåpner	flosk3opn3r
flass	flos
flasse	flos3
flat	flot
flate	flot3
flatt	flot
flatterende	floter3n3
flau	flE3
fleipe	flEip3
flekk	flEk
fleksibel	fl3ksib3l
flenge	flEN3
flerre	flEr3
flette	flEt3
flidd	flid
flikke	flik3
flimre	flimr3
flink	fliNk
flintskalla	flintskol3t
flintskallet	flintskol3t
flire	flir3
flittig	fliti
flittige	fliti3
flittigere	flitir3
flittigst	flitikst
flittigste	flitikst3
flo	flu
floke	fluk3
flokete	fluk3t3
flokke	flok3
flomme	flom3
florere	flurer3
flott	flot
flue	fl33
fly	fli
flyge	flig3
flyger	flig3r
flykte	flikt3
flyktig	flikti
flyktige	flikti3
flyktigere	fliktir3
flyktigst	fliktikst
flyktigste	fliktikst3
flyktning	fliktniN
flyplass	fliplos
flyplassavgift	fliplosovyift
flyplassbuss	fliplosb3s
flyreise	flirEis3
flyselskap	flisElskop
flyte	flit3
flytende	flit3n3
flytte	flit3
flyvert	flivEt
flyvertinne	flivEtin3
flå	flo
flådd	flod
flådde	flod3
flått	flot
flørte	flet3
fløte	flet3
fløy	flEy
fløyel	flEy3l
fløyte	flEyt3
fnise	fnis3
fnyse	fnis3
fokusere	fuk3ser3
folde	fol3
fole	ful3
folk	folk
folkekjær	folk3SEr
folkelig	folk3li
folkelige	folk3li3
folkeligere	folk3lir3
folkeligst	folk3likst
folkeligste	folk3likst3
folkemusikk	folk3m3sik
folklore	folklor
folkloreaften	folkloroft3n
folksom	folksom
fomle	fuml3
for	for
for det andre	fodEondr3
for min del	formindel
for mye	formi3
for ti minutter siden	fo ti min3t3 Sid3n
forakte	forokt3
foraktelig	forokt3li
foraktelige	forokt3li3
forakteligere	forokt3lir3
forakteligst	forokt3likst
forakteligste	forokt3likst3
foran	foron
forandre	forondr3
forandring	forondriN
forarge	fororg3
forbanna	forbon3t
forbanne	forbon3 fobon3
forbannet	forbon3t
forbarme	forborm3
forbause	forbE3s3
forbauselse	forbE3s3ls3
forbedre	forbedr3 fobedr3
forbeholde	forb3hol3
forberede	forb3red3
forbi	forbi
forbigå	forbigo
forbigående	forbigo3n3
forbilledlig	forbil3dli
forbilledlige	forbil3dli3
forbilledligere	forbil3dlir3
forbilledligst	forbil3dlikst
forbilledligste	forbil3dlikst3
forbinde	forbin3
forbindelse	forbin3ls3
forbli	forbli
forblø	forble
forbløffe	forblEf3
forbløffende	forblEf3n3
forbrenne	forbrEn3
forbrenning	forbrEniN
forbruk	forbr3k
forbruke	forbr3k3
forbrytelse	forbrit3ls3
forbud	forb3d
forbudt	forb3t
forbund for funksjonshemmede	forb3nforf3NkSunshEm3d3
forby	forbi
fordampe	fodomp3
fordel	fodel
fordelaktig	fodelokti
fordelaktige	fodelokti3
fordelaktigere	fodeloktir3
fordelaktigst	fodeloktikst
fordelaktigste	fodeloktikst3
fordele	fodel3
forderve	fodErv3
fordi	fodi
fordoble	fodobl3
fordomsfri	fodomsfri
fordomsfull	fodomsf3l
fordra	fodro
fordre	fodr3
fordreie	fodrEi3
fordringsfull	fodriNsf3l
fordringsløs	fodriNsles
fordrive	fodriv3
fordufte	fod3ft3
fordums	fod3ms
fordype	fodip3
fordømme	fodEm3
fordøye	fodEy3
fordøyelse	fodEyEls3
fore	fer3
forebygge	for3big3
foredle	foredl3
foregi	for3yi
foregripe	for3grip3
foregå	for3go
foregående	for3go3n3
forekomme	for3kom3
forelda	forEld3t
forelder	forEld3r
foreldet	forEld3t
foreldre	forEldr3
forelese	for3les3
foreligge	for3lig3
forelske	forElsk3
foreløpig	for3lepi
foreløpige	for3lepi3
foreløpigere	for3lepir3
foreløpigst	for3lepikst
foreløpigste	for3lepikst3
forene	foren3
forenkle	forENkl3
forenlig	forenli
forenlige	forenli3
forenligere	forenlir3
forenligst	forenlikst
forenligste	forenlikst3
foresatt	for3sot
foreskrive	for3skriv3
foreslå	for3slo
forespeile	for3spEil3
forestille	for3stil3
forestilling	for3stiliN
forestå	for3sto
foresveve	for3svev3
foreta	for3to
foretaksom	for3toksom
foretrekke	for3trEk3
forevige	forevig3
forfall	forfol
forfalle	forfol3
forfallen	forfol3n
forfalske	forfolsk3
forfatte	forfot3
forfatter	forfot3r
forfekte	forfEkt3
forfengelig	forfEN3li
forfengelige	forfEN3li3
forfengeligere	forfEN3lir3
forfengeligst	forfEN3likst
forfengeligste	forfEN3likst3
forferdelig	forfEd3li
forferdelige	forfEd3li3
forferdeligere	forfEd3lir3
forferdeligst	forfEd3likst
forferdeligste	forfEd3likst3
forfjamsa	forfyoms3t
forfjamset	forfyoms3t
forflytte	forflit3
forfremme	forfrEm3
forfriskning	forfriskniN
forfrossen	forfros3n
forfølge	forfEl3
forføre	forfer3
forgifte	foryift3
forgiftning	foryifniN
forgjengelig	foryEN3li
forgjengelige	foryEN3li3
forgjengeligere	foryEN3lir3
forgjengeligst	foryEN3likst
forgjengeligste	foryEN3likst3
forgjeves	foryev3s
forgreine	forgren3
forgripe	forgrip3
forgude	forg3d3
forgylle	foryil3
forhandle	forhonl3
forhandler	forhonl3r
forhandling	forhonliN
forhaste	forhost3
forhatt	forhot
forhekse	forhEks3
forhenværende	forh3nvEr3n3
forherlige	forhELig3
forhindre	forhindr3
forhold	forhol
forhåpentligvis	forhop3ntlivis
forhåpningsfull	forhopniNsf3l
forhøre	forher3
forhøye	forhEy3
forkaste	forkost3
forkastelig	forkost3li
forkastelige	forkost3li3
forkasteligere	forkost3lir3
forkasteligst	forkost3likst
forkasteligste	forkost3likst3
forkjølelse	forSelEls3
forklare	forklor3 foklor3
forklaring	forkloriN
forkle	forkl3
forkludre	forkl3dr3
forknytt	forknit
forkommen	forkom3n
forkorte	forkot3
forkortelse	forkot3ls3
forkynne	forSin3
forlange	foLoN3
forlate	foLot3
forlatt	foLot
forlede	foLed3
forleden	foLed3n
forlegen	foLeg3n
forlenge	foLEN3
forlise	foLis3
forlodds	foLods
forlokkende	foLok3n3
forlove	foLov3
forlovede	folov3d3
forløpe	foLep3
form	form
formal	formol
formane	formon3
forme	form3
formel	form3l
formell	formEl
formere	former3
formiddag	formidog
formidle	formidl3
forminske	forminsk3
formode	formud3
formodentlig	formud3ntli
formodentlige	formud3ntli3
formodentligere	formud3ntlir3
formodentligst	formud3ntlikst
formodentligste	formud3ntlikst3
formular	form3lor
formulere	form3ler3
fornavn	fonovn
fornedre	fonedr3
fornekte	fonEkt3
fornem	fonEm
fornemme	fonEm3
fornye	foni3
fornærme	fonErm3
fornærmelse	fonErmEls3
fornøyd	fonEyd
fornøyelig	fonEy3li
fornøyelige	fonEy3li3
fornøyeligere	fonEy3lir3
fornøyeligst	fonEy3likst
fornøyeligste	fonEy3likst3
fornøyelse	fonEyEls3
fornøyelsespark	fonEyEls3spork
forordne	forodn3
forpeste	forpEst3
forpleining	forplEiniN
forplikte	forplikt3
forpurre	forp3r3
forregne seg	forEin3sEi
forrest	for3st
forresten	forEst3n
forrett	for3t
forringe	foriN3
forrykende	forik3n3
forrykt	forikt
forråd	forod
forråde	forod3
forrådt	forot
forrædersk	fored3Sk
forsagt	foSokt
forsake	foSok3
forsalg	foSolg
forseggjort	foSEiut
forsikre	foSikr3
forsikring	foSikriN
forsiktig	foSikti
forsiktige	foSikti3
forsiktigere	foSiktir3
forsiktighet	foSiktihet
forsiktigst	foSiktikst
forsiktigste	foSiktikst3
forsinke	foSiNk3
forsinkelse	foSiNkEls3
forske	foSk3
forskjell	foS3l
forskjellig	foSEli
forskjellige	foSEli3
forskjelligere	foSElir3
forskjelligst	foSElikst
forskjelligste	foSElikst3
forskning	foSkniN
forskrift	foSkrift
forskrudd	foSkr3d
forskuttere	foSk3ter3
forskyve	foSiv3
forslag	foSLog
forslitt	foSLit
forsnakke	foSnok3
forsone	foSun3
forsove	foSov3
forspille	foSpil3
forstad	foSto
forstandig	foStoni
forstandige	foStoni3
forstandigere	foStonir3
forstandigst	foStonikst
forstandigste	foStonikst3
forsterke	foStErk3
forstoppelse	foStopEls3
forstrekning	foStrEkniN
forstuet	foSt33t
forstumme	foSt3m3
forstyrre	foStir3
forstå	foSto
forståelig	foSto3li
forståelige	foSto3li3
forståeligere	foSto3lir3
forståeligst	foSto3likst
forståeligste	foSto3likst3
forståelsesfull	foSto3ls3sf3l
forstørre	foStEr3
forsvare	foSvor3
forsvarlig	foSvoLi
forsvarlige	foSvoLi3
forsvarligere	foSvoLir3
forsvarligst	foSvoLikst
forsvarligste	foSvoLikst3
forsvinne	foSvin3
forsyne	foSin3
forsøk	foSek
forsøke	foSek3
forsømme	foSEm3
forsørge	foSErg3
fort	fut
fortapt	fotopt
fortau	fotE3
forte	fut3
fortelle	fotEl3
fortid	foti fotid
fortjene	fotyen3
fortløpende	futlep3n3
fortolle	fotol3
fortreffelig	fotrEf3li
fortreffelige	fotrEf3li3
fortreffeligere	fotrEf3lir3
fortreffeligst	fotrEf3likst
fortreffeligste	fotrEf3likst3
fortrenge	fotrEN3
fortrolig	fotruli
fortrolige	fotruli3
fortroligere	fotrulir3
fortroligst	fotrulikst
fortroligste	fotrulikst3
fortryllende	fotrilEn3
fortsette	fots3t3
fortumla	fotumlo
fortvila	fotvilo
fortvile	fotvil3
fortære	fotEr3
fortøye	fotEy3
forunderlig	for3n3Li
forunderlige	for3n3Li3
forunderligere	for3n3Lir3
forunderligst	for3n3Likst
forunderligste	for3n3Likst3
forundre	for3ndr3
forurense	for3rEns3
forurensning	for3rEnsniN
forurolige	for3ruli3
foruroligende	for3ruli3n3
forutinntatt	for3tintot
forutsette	for3ts3t3
forutsi	for3tsi
forutsigelig	for3tsig3li
forutsigelige	for3tsig3li3
forutsigeligere	for3tsig3lir3
forutsigeligst	for3tsig3likst
forutsigeligste	for3tsig3likst3
forvalte	forvolt3
forvandle	forvonl3
forveksle	forvEkSL3
forvelle	forvEl3
forvente	forvEnt3
forventningsfull	forvEntniNsf3l
forverre	forvEr3
forville	forvil3
forvirra	forviro
forvirre	forvir3
forvise	forvis3
forvisse	forvis3
forvitre	forvitr3
forårsake	foroSok3
forære	forEr3
foss	fos
fosse	fos3
fossil	fosil
fostre	fustr3
fot	fut
fotball	futbol
fotballkamp	futbolkomp
fotgjenger	futyEN3r
foto	futu
fotoforretning	futuforEtniN
fotografere	futugrofer3
fotografering	futugrofEriN
fra	fro
fra og med	froome
frabe	frobe
frafalle	frofol3
frakk	frok
frakte	frokt3
fram	from
framkalle	fromkol3
framlegge	frEmlEi3
framme	from3
framover	fromov3r
framsette	frEmsEt3
framsynt	frEmsint
framtre	frEmtre
frankere	froNker3
fransk	fronsk
franskbrød	fronskbre
franskmann	fronskmon
fraråde	frorod3
frase	fros3
frastøtende	frostet3n3
fravær	frovEr
fraværende	frovEr3n3
fred	fred
fredag	fredog
frede	fred3
fredelig	fred3li
fredelige	fred3li3
fredeligere	fred3lir3
fredeligst	fred3likst
fredeligste	fred3likst3
fredningstid	fredniNsti
fredsommelig	fredsom3li
fredsommelige	fredsom3li3
fredsommeligere	fredsom3lir3
fredsommeligst	fredsom3likst
fredsommeligste	fredsom3likst3
freidig	frEidi
freidige	frEidi3
freidigere	frEidir3
freidigst	frEidikst
freidigste	frEidikst3
frekk	frEk
frelse	frEls3
frembringe	frEmbriN3
fremdeles	fr3mdel3s
fremgang	frEmgoN
fremgangsrik	frEmgoNsrik
fremheve	frEmhev3
fremholde	frEmhol3
fremkalle	frEmkol3
fremlegge	frEmlEi3
fremme	frEm3
fremmed	frEm3d
fremmed valuta	frEm3dvol3to
fremragende	frEmrog3n3
fremsette	frEmsEt3
fremskreden	frEmskred3n
fremskritt	frEmskrit
fremskynde	frEmSin3
fremstille	frEmstil3
fremstående	frEmsto3n3
fremsynt	frEmsint
fremtre	frEmtre
fremtredende	frEmtred3n3
frese	fres3
fri	fri
frieren	frir3n
frifinne	frifin3
frigjøre	friyer3
frihet	frihet
friidrett	friidrEt
frikjenne	friSEn3
friklatring	friklotriN
frimerke	frimErk3
frimodig	frimudi
frimodige	frimudi3
frimodigere	frimudir3
frimodigst	frimudikst
frimodigste	frimudikst3
frisere	friser3
frisk	frisk
friste	frist3
frita	frito
fritid	fritid
fritidspark	fritidspork
fritt	frit
frivillig	frivili
frivillige	frivili3
frivilligere	frivilir3
frivilligst	frivilikst
frivilligste	frivilikst3
fro	fre
frokost	frukost
frokostrom	frukostrum
from	from
frossen	fros3n
frost	frost
frostvæske	frostvEsk3
frottere	froter3
fru	fr3
frukt	fr3kt
fruktbar	fr3ktbor
fruktesløs	fr3kt3sles
fryd	frid
fryde	frid3
frykt	frikt
frykte	frikt3
fryktelig	frikt3li friktli
fryktelige	frikt3li3
frykteligere	frikt3lir3
frykteligst	frikt3likst
frykteligste	frikt3likst3
frynse	frins3
frynsete	frins3t3
fryse	fris3
fråde	frod3
fråtse	frots3
frø	fre
frøken	frek3n
fugl	f3l
fukte	fukt3
fuktig	fukti
fuktige	fukti3
fuktigere	fuktir3
fuktigst	fuktikst
fuktigste	fuktikst3
ful	f3l
full	f3l
fullbefaren	f3lb3for3n
fullbyrde	f3lbid3
fullføre	f3lfer3
fullkommen	f3lkom3n
fullstendig	f3lstEni
fullstendige	f3lstEni3
fullstendigere	f3lstEnir3
fullstendigst	f3lstEnikst
fullstendigste	f3lstEnikst3
fult	f3lt
fundamental	f3nom3ntol
fundamentalistisk	f3nom3ntolistisk
fungere	f3Nger3
funkle	fuNkl3
funn	f3n
fure	f3r3
furte	f3t3
furu	f3r3
fusjonere	f3Suner3
fuske	f3sk3
fyke	fik3
fyldig	fildi
fyldige	fildi3
fyldigere	fildir3
fyldigst	fildikst
fyldigste	fildikst3
fylke	filk3
fylle	fil3
fylt	filt
fyr	fir
fyre	fir3
fyren	fiin
fyrer	fir3r
fyrstelig	fiSt3li
fyrstelige	fiSt3li3
fyrsteligere	fiSt3lir3
fyrsteligst	fiSt3likst
fyrsteligste	fiSt3likst3
fyrstikk	fiStik
fyrverkeri	firvErk3ri
fysiologisk	fisiulogisk
fysisk	fisisk
få	fo
få lov til	folovtil
få vite	fovit3
fåfengt	fofENt
fåmælt	fomelt
får	for
fårete	for3t3
fæl	fEl
færøysk	fErEysk
fòr	for
fór	fur
fôr	fur
fôre	fur3
føde	fed3
fødested	fed3sted
fødsel	fEts3l
fødselsdag	fEts3lsdog
født	fEt
føle	fel3
følelse	fel3ls3
følelsesløs	fel3ls3sles
følg	fEl
følge	fEl3
følsom	felsom
føn	fen
føne	fen3
før	fer
føre	fer3
først	fESt
første	fESt3
første etasje	fESt3EtoS3
første gir	fESt3gir
førstehjelp	fESt3yElp
førstehånds	fESt3hons
førsteklasses	fESt3klos3s
førti	fEti
føye	fEy3
føyelig	fEy3li
føyelige	fEy3li3
føyeligere	fEy3lir3
føyeligst	fEy3likst
føyeligste	fEy3likst3
gabbro	gobru
gaffel	gof3l
gagne	goNn3
gal	gol
galant	golont
gale	gol3
galleri	gol3ri
galoppere	goloper3
galskap	golskop
gamlebyen	goml3bi3n
gammel	gomol gom3l
gammeldags	gom3ldoks
gamp	gomp
gane	gon3
gang	goN
gangbru	goNbr3
gange	goN3
gangen	goN3n
ganske	gonsk3
gape	gop3
garantere	goronter3
garanti	goronti
gard	gor
garde	god3
gardere	goder3
garderobe	god3rob3
gardin	godin
gardist	godist
gasse	gos3
gassflaske	gosflosk3
gastronomisk	gostrunumisk
gate	got3
gauk	gEwk
gaule	gE3l3
gaupe	gE3p3
gav	go
gave	gov3
gavl	govl
gavmild	govmil
geboren	g3bor3n
gebrokken	g3brok3n
gebyr	gebir
gedigen	g3dig3n
gehen	ge3n
geipe	yEip3
geistlig	gEistli
geistlige	gEistli3
geistligere	gEistlir3
geistligst	gEistlikst
geistligste	gEistlikst3
geit	yEit
geita	yEito
geitost	yEitust
gelatin	SElotin
gelb	gElp
gemen	g3men
generalisere	gEn3roliser3
genere	SEner3
generell	S3n3rEl
genetisk	g3netisk
genial	g3niol
genser	gEns3r
genseren	gEnsEn
genug	g3nuk
genuin	g3n3in
genève	SEnev
geografisk	g3ugrofisk
geologisk	g3ulogisk
geometrisk	g3umetrisk
gerilja	gErilyo
gesims	gEsims
geskjeftig	g3SEfti
geskjeftige	g3SEfti3
geskjeftigere	g3SEftir3
geskjeftigst	g3SEftikst
geskjeftigste	g3SEftikst3
gestikulere	gEstik3ler3
gevinst	gevinst
gewinnen	g3vin3n
gi	yi
gi tilbake	yitilbok3
gi ut	yi3t
gidde	gid3
giddeløs	gid3les
gift	yift
gifte	yift3
gifte seg	yift3sEi
giftig	yifti
giftige	yifti3
giftigere	yiftir3
giftigst	yiftikst
giftigste	yiftikst3
gigantisk	gigontisk
giktisk	yiktisk
gild	yil
gipse	yips3
gir	gir
gire	gir3
girkasse	girkos3
giro	Siru
gisp	yisp
gispe	yisp3
gissel	gis3l
givende	yiv3n3
gjalle	yol3
gjeld	yEl
gjelde	yEl3
gjelle	yEl3
gjemme	yEm3
gjendrive	yEndriv3
gjenge	yEN3
gjengi	yEnyi
gjengjelde	yEnyEl3
gjengs	yENs
gjenkjenne	yEnSEn3
gjennom	yEnom
gjennomføre	yEnomfer3
gjennomgå	yEnomgo
gjennomgående	yEnomgo3n3
gjennomreise	yEnumrEis3
gjennomsiktig	yEnomsikti
gjennomsiktige	yEnomsikti3
gjennomsiktigere	yEnomsiktir3
gjennomsiktigst	yEnomsiktikst
gjennomsiktigste	yEnomsiktikst3
gjennomskue	yEnomsk33
gjennomsnittlig	yEnomsnitli
gjennomsnittlige	yEnomsnitli3
gjennomsnittligere	yEnomsnitlir3
gjennomsnittligst	yEnomsnitlikst
gjennomsnittligste	yEnomsnitlikst3
gjennomstekt	yEnumstekt
gjennomsøke	yEnomsek3
gjennomtrengende	yEnomtrEN3n3
gjennomvåt	yEnomvot
gjenopplive	yEnopliv3
gjenopprette	yEnoprEt3
gjenoppta	yEnopto
gjensidig	y3nsidi
gjensidige	y3nsidi3
gjensidigere	y3nsidir3
gjensidigst	y3nsidikst
gjensidigste	y3nsidikst3
gjenstand	yEnston
gjenta	yEnto
gjenvinne	yEnvin3
gjerde	yEr3
gjerne	yEn3
gjerrig	yEri
gjerrige	yEri3
gjerrigere	yErir3
gjerrigknark	yEriknork
gjerrigst	yErikst
gjerrigste	yErikst3
gjert	yEt
gjesp	yEsp
gjespe	yEsp3
gjess	yEs
gjest	yEst
gjeste	yEst3
gjestfri	yEstfri
gjestfrihet	yEstfrihet
gjete	yet3
gjetning	yEtniN
gjette	yEt3
gjev	yev
gjær	yEr
gjære	yEr3
gjø	ye
gjødsle	yEtsl3
gjør	yer
gjøre	yer3
gjøre rent	yer3rEnt
gjøre vondt	yer3vunt
gjørme	yErm3
glad	glo
glad for	glofor
glane	glon3
glass	glos
glatt	glot
glatte	glot3
glede	gled3
glede seg over	gled3sEiov3r
glede seg til	gled3sEitil
gledelig	gled3li
gledelige	gled3li3
gledeligere	gled3lir3
gledeligst	gled3likst
gledeligste	gled3likst3
gledeshyl	gled3shil
gledestrålende	gled3strol3n3
glefse	glEfs3
glemme	glEm3
glemsk	glEmsk
glemsom	glEmsom
gli	gli
glidefly	glid3fli
glimre	glimr3
glimrende	glimr3n3
glimte	glimt3
glinse	glins3
glipe	glip3
glippe	glip3
glise	glis3
glissen	glis3n
glitre	glitr3
glitrende	glitr3n3
glo	glu
global	glubol
glorete	glur3t3
glovarm	gluvorm
glup	gl3p
glupsk	gl3psk
gløde	gled3
gløgg	glEg
gløtte	glEt3
gnage	gnog3
gneldre	gnEldr3
gni	gni
gnier	gni3r
gnikke	gnik3
gnisse	gnis3
gnistre	gnistr3
gnåle	gnol3
god	gu
godarta	guoto
godartet	guoto
godgjøre	guyer3
godhjerta	guyEto
godhjertet	guyEto
godkjenne	guSEn3
godlynt	gulint
gods	gus
godslig	guSLi
godslige	guSLi3
godsligere	guSLir3
godsligst	guSLikst
godsligste	guSLikst3
godsvogn	gudsvoNn
godt	got
godta	guto
godte	got3
godteri	got3ri
godtroende	gutru3n3
golf	golf
golfklubb	golfkl3b
golfkølle	golfkEl3
golv	golv
gomle	guml3
goro	guru
gotikk	gutik
gra	gro
gradere	groder3
grafikk	grofik
grafisk	grofisk
grafse	grofs3
gram	grom
grammatikalitet	gromotikolitet
grammatikalsk	gromotikolsk
grammatikken	gromotikn
grammatisk	gromotisk
gran	gron
grann	gron
granne	gron3
granske	gronsk3
grasplen til å sole seg på	grosplentilosul3sEipo
grate	grot3
gratinert	grotinet
gratis	grotis
gratulere	grot3ler3
grav	grov
grave	grov3
gravere	grover3
graverende	grover3n3
gravid	grovid
graviditet	groviditet
gravlegge	grovlEi3
gravstein	grovstEin
gre	gre
grei	grEi
greie	grEi3
grell	grEl
gremme	grEm3
grense	grEns3
grenseløs	grEns3les
grenseovergang	grEns3ov3rgoN
grepa	grepo
gresk	gresk
gresse	grEs3
gresselig	grEs3li
gresselige	grEs3li3
gresseligere	grEs3lir3
gresseligst	grEs3likst
gresseligste	grEs3likst3
gresskar	grEskor
gretten	grEt3n
greve	grev3
grill	gril
grille	gril3
grillet	gril3t
grilltenner	griltEn3r
grim	grim
grimme	grim3
grine	grin3
grinete	grin3t3
gripende	grip3n3
gris	gris
grisen	grisn
grisete	gris3t3
grisk	grisk
gro	gru
grom	grum
grotesk	grutEsk
grotte	grot3
grov	grov
grovt	groft
gruble	gr3bl3
grue	gr33
grufull	gr3f3l
grums	grums
grumsete	grums3t3
grundig	gr3ni
grundige	gr3ni3
grundigere	gr3nir3
grundigst	gr3nikst
grundigste	gr3nikst3
grunn	gr3n
grunne	gr3n3
grunngi	gr3nyi
grunnlag	gr3nlog
grunnlegge	gr3nlEi3
grunnleggende	gr3nlEi3n3
grunnløs	gr3nles
gruppe	gr3p3
gruppere	gr3per3
grusom	gr3som
gry	gri
grynte	grint3
grytestekt	grit3stekt
grå	gro
grådig	grodi
grådige	grodi3
grådigere	grodir3
grådigst	grodikst
grådigste	grodikst3
gråne	gron3
gråte	grot3
grått	grot
grønlandsk	grEnlonsk
grønn	grEn
grønne bønner	grEn3bEn3r
grønnlig	grEnli
grønnsak	grEnsok
grønske	grEnsk3
grønt forsikringskort	grEnt foSikriNs kot
grønt kort	grEnt kot
grøsse	grEs3
grøtete	gret3t3
guano	g3wonu
gubbe	g3b3
gud	g3d
guddommelig	g3dom3li
guddommelige	g3dom3li3
guddommeligere	g3dom3lir3
guddommeligst	g3dom3likst
guddommeligste	g3dom3likst3
guffen	g3fn g3f3n
guide	goid
gul	g3l
gull	g3l
gulpe	g3lp3
gulrot	g3lrut
gult	g3t
gulv	g3lv
gunstig	g3nsti
gunstige	g3nsti3
gunstigere	g3nstir3
gunstigst	g3nstikst
gunstigste	g3nstikst3
gurgle	g3rgl3
gusten	g3st3n
gut	gut
gutt	g3t
gylden	yiln
gyldig	yildi
gyldige	yildi3
gyldigere	yildir3
gyldigst	yildikst
gyldigste	yildikst3
gyllen	yil3n
gymnastikk	gimnostik
gynekologisk	gin3kulogisk
gynge	yiN3
gyse	yis3
gyselig	yis3li
gyselige	yis3li3
gyseligere	yis3lir3
gyseligst	yis3likst
gyseligste	yis3likst3
gyte	yit3
gyve	yiv3
gå	go
gå over	goov3r
gå på ski	gopoSi
gå seg vill	gosEivil
gå vekk	govEk
gåen	go3n
gågate	gugot3
gård	gor
gås	gos
gåtefull	got3f3l
gæren	gEEn
gørr	gEr
gøtt	gEt
gøy	gEy
gøyal	gEyol
ha	ho
ha det travelt	hodEtrov3lt
habil	hobil
hage	hog3
hagle	hogl3
hai	hEi
haike	hEik3
hake	hok3
hakke	hok3
hakket	hok3t
hale	hol3
hall	hol
hallusinere	hol3siner3
hals	hols
halsbetennelse	holsbEtEnEls3
halsbrann	holsbron
halsbrekkende	holsbrEk3n3
halt	holt
halte	holt3
halv	hol
halvdel	holdel
halvere	holver3
halvpensjon	holpoNSun
halvtørr	holtEr
halvår	holor
halvøy	holEy
hamle	homl3
hammer	hom3r
hamre	homr3
hamster	homst3r
hamstre	homstr3
han	hon
handfast	honfost
handgripelig	hongrip3li
handgripelige	hongrip3li3
handgripeligere	hongrip3lir3
handgripeligst	hongrip3likst
handgripeligste	hongrip3likst3
handheve	honhev3
handhilse	honhils3
handlaga	honlog3t
handlaget	honlog3t
handle	honl3
handling	hondliN
handtere	honter3
hangle	hoNl3
hanlig	honli
hanlige	honli3
hanligere	honlir3
hanligst	honlikst
hanligste	honlikst3
hann	hon
hannkjønn	honSEn
hans	hons
hanske	honsk3
hanskes	honsk3s
har	hor
harald	horol
hard	hor
hardbarka	horborko
hardbarket	horbork3t
hardhendt	horhEnt
hardnakka	honoko
hardnakket	honok3t
harke	hork3
harm	horm
harme	horm3
harmløs	hormles
harmonere	hormuner3
harmonisere	hormuniser3
harmonisk	hormunisk
harpe	horp3
harry	hori
harselere	hoS3ler3
harsk	hoSk
hasardiøs	hosodies
hassel	hos3l
hasselnøtt	hos3lnEt
haste	host3
hastig	hosti
hastverk	hostvErk
hat	hot
hate	hot3
hatsk	hotsk
hatt	hot
hatten	hotn
haug	hE3
hauk	hEwk
hausse	hE3s3
hav	hov
havarere	hovorer3
havfrue	hovfr33
havn	hovn
havne	hovn3
havre	hovr3
havregryn	hovr3grin
hebraisk	h3broisk
hedensk	hed3nsk
heder	hed3r
hederlig	hed3Li
hederlige	hed3Li3
hederligere	hed3Lir3
hederligst	hed3Likst
hederligste	hed3Likst3
hedre	hedr3
hefte	hEft3
hei	hEi
heidundrende	hEid3ndr3n3
heie	hEi3
heis	hEis
heise	hEis3
hekk	hEk
hekle	hEkl3
hekseskudd	hEks3sk3d
hekte	hEkt3
hektisk	hEktisk
hel	hel
helbrede	h3lbred3
heldig	hEldi
heldige	hEldi3
heldigere	hEldir3
heldigst	hEldikst
heldigste	hEldikst3
helg	hElg
helgardere	helgoder3
helgepris	hElg3pris
helikopter	h3likopt3r
helle	hEl3
heller ikke	hEl3rik3
hellig	hEli
hellige	hEli3
helligere	hElir3
helligst	hElikst
helligste	hElikst3
helmer	hElm3r
helpensjon	helpoNSun
helse	hEls3
helseskadelig	hEls3skodli
helseskadelige	hEls3skodli3
helseskadeligere	hEls3skodlir3
helseskadeligst	hEls3skodlikst
helseskadeligste	hEls3skodlikst3
helst	hElst
helt	helt
heltemodig	hElt3mudi
heltemodige	hElt3mudi3
heltemodigere	hElt3mudir3
heltemodigst	hElt3mudikst
heltemodigste	hElt3mudikst3
helvete	hElv3t3
helvetes	hElv3t3s
hemme	hEm3
hemmelig	hEm3li
hemmelige	hEm3li3
hemmeligere	hEm3lir3
hemmelighetsfull	hEm3lihetsf3l
hemmeligholde	hEm3lihol3
hemmeligst	hEm3likst
hemmeligste	hEm3likst3
hemningsløs	hEmniNsles
hende	hEn3
hendelig	hEn3li
hendelige	hEn3li3
hendeligere	hEn3lir3
hendeligst	hEn3likst
hendeligste	hEn3likst3
hendig	hEni
hendige	hEni3
hendigere	hEnir3
hendigst	hEnikst
hendigste	hEnikst3
henføre	hEnfer3
henge	hEN3
hengi	hEnyi
hengslete	hENSL3t3
henlede	hEnled3
henlegge	hEnlEi3
henne	hEn3
hennes	hEn3s
henrette	hEnrEt3
henrik	hEnrik
henrykke	hEnrik3
hensiktsmessig	hEnsiktsmEsi
hensiktsmessige	hEnsiktsmEsi3
hensiktsmessigere	hEnsiktsmEsir3
hensiktsmessigst	hEnsiktsmEsikst
hensiktsmessigste	hEnsiktsmEsikst3
henstille	hEnstil3
hensynsfull	hEnsinsf3l
hensynsløs	hEnsinsles
hente	hEnt3
hentyde	hEntid3
henvende	hEnvEn3
henvise	hEnvis3
her	hEr
herberge	hErbErg3
herde	hEd3
herje	hEry3
herlig	hELi
herlige	hELi3
herligere	hELir3
herligst	hELikst
herligste	hELikst3
herme	hErm3
hermetikk	h3rmEtik
hermetisere	hErm3tiser3
hermetisk	hErmetisk
herre	hEr3
herreløs	hEr3les
herrer	hEr3r
herse	hES3
herskapelig	hESkop3li
herskapelige	hESkop3li3
herskapeligere	hESkop3lir3
herskapeligst	hESkop3likst
herskapeligste	hESkop3likst3
herske	hESk3
hes	hes
heseblesende	hes3bles3n3
hesje	hES3
hest	hEst
hesten	hEst3n
hestesko	hEst3sku
het	het
hete	het3
heteroseksuell	het3rus3ks3El
hetse	hEts3
hevd	hEvd
hevde	hEvd3
heve	hev3
hevelse	hevEls3
hevn	hEvn
hevne	hEvn3
hevngjerrig	hEvnyEri
hevngjerrige	hEvnyEri3
hevngjerrigere	hEvnyErir3
hevngjerrigst	hEvnyErikst
hevngjerrigste	hEvnyErikst3
hierarkisk	hi3rorkisk
hige	hig3
hikke	hik3
hikste	hikst3
hilse	hils3
hilse på	hils3po
hilsen	hilsn
himle	himl3
himmel	him3l
himmelfallen	him3lfol3n
himmelsk	him3lsk
hindre	hindr3
hinduistisk	hin3istisk
hinke	hiNk3
hipp	hip
hisse	his3
hissig	hisi
hissige	hisi3
hissigere	hisir3
hissigst	hisikst
hissigste	hisikst3
historie	histuri3
historisk	histurisk
hittil	hitil
hive	hiv3
hjelm	yElm
hjelp	yElp
hjelpe	yElp3
hjelpe noen	yElp3nu3n
hjelpeløs	yElp3les
hjelpesenter	yElp3sEnt3r
hjelpsom	yElpsom
hjem	yEm
hjemland	yEmlon
hjemlig	yEmli
hjemlige	yEmli3
hjemligere	yEmlir3
hjemligst	yEmlikst
hjemligste	yEmlikst3
hjemløs	yEmles
hjemme	yEm3
hjemmefra	yEm3fro
hjemmelaget	yEm3log3t
hjemreise	yEmrEis3
hjemsted	yEmste yEmsted
hjerne	yEn3
hjernerystelse	yEn3rist3ls3
hjerneslag	yEn3SLog
hjernevaske	yEn3vosk3
hjerte	yEt3
hjerteanfall	yEt3onfol
hjertelig	yEt3li
hjertelige	yEt3li3
hjerteligere	yEt3lir3
hjerteligst	yEt3likst
hjerteligste	yEt3likst3
hjerteløs	yEt3les
hjertens	yEt3ns
hjerteskjærende	yEt3SEr3n3
hjul	y3l
hjulbent	yulbent
hjørne	yen3
hode	hud3
hodepine	hud3pin3
hodepute	hud3p3t3
hodesett	hud3sEt
hofte	hoft3
hogge	hog3
hoie	huy3
holdbar	holbor
holde	hol3
holden	hold3n
holdning	holdniN
homofil	humufil
homofili	humufili
honning	honiN
honningmelon	honiNmElun
honorere	hunurer3
hope	hup3
hoppe	hop3
hore	hur3
horisontal	horisontol
hormonell	hurmunEl
horn	hun
horribel	horib3l
hos	hus
hoste	hust3
hostesaft	hust3soft
hotellgarasje	hutElgoroS3
hovedgate	huv3dgot3
hovedrett	huv3drEt
hovedrolle	huvEdrol3
hovedsakelig	huv3dsokli
hovedsakelige	huv3dsokli3
hovedsakeligere	huv3dsoklir3
hovedsakeligst	huv3dsoklikst
hovedsakeligste	huv3dsoklikst3
hovedstad	huv3dstod
hoven	hov3n
hovere	hover3
hovmodig	hovmudi
hovmodige	hovmudi3
hovmodigere	hovmudir3
hovmodigst	hovmudikst
hovmodigste	hovmudikst3
hovne	hovn3
hubro	h3bru
hud	h3d
hudflette	h3dflEt3
huie	h3y3
huke	h3k3
hukommelse	h3kom3ls3
hul	h3l
hule	h3l3
hulke	h3lk3
hull	h3l
hullete	h3l3t3
human	h3mon
humanitær	h3monitEr
humle	huml3
humoristisk	h3muristisk
humpe	hump3
humpete	hump3t3
humre	humr3
hun	h3n
hund	h3n
hundre	h3ndr3
hundreogen	h3ndr3oen
hundreår	h3ndr3or
hundse	h3ns3
hungre	huNr3
hunn	h3n
hurpe	h3rp3
hurtig	h3ti
hurtige	h3ti3
hurtigere	h3tir3
hurtigst	h3tikst
hurtigste	h3tikst3
hus	h3s
husdyr	h3sdir
huse	h3s3
huseier	h3sEi3r
huset	h3s3
husholdningsartikler	h3sholdniNsotikl3r
huske	h3sk3
husly	h3sli
husnummer	h3snum3r
hutre	h3tr3
hva	vo
hva for ei	voforEi
hva for en	voforen
hval	vol
hvass	kvos
hvelve	vElv3
hver	vEr
hver dag	vEdog
hver time	vEtim3
hver uke	vEr3k3
hverdagslig	vEdokSLi
hverdagslige	vEdokSLi3
hverdagsligere	vEdokSLir3
hverdagsligst	vEdokSLikst
hverdagsligste	vEdokSLikst3
hvese	ves3
hvete	vet3
hvile	vil3
hvile ut	vil33t
hvis	vis
hviske	visk3
hvit	vit
hvitløk	vitlek
hvitmaling	vitmoliN
hvitt	vit
hvitvin	vitvin
hvordan	vudon
hygge	hig3
hyggelig	hig3li
hyggelige	hig3li3
hyggeligere	hig3lir3
hyggeligst	hig3likst
hyggeligste	hig3likst3
hygienisk	higienisk
hyklersk	hikl3Sk
hyl	hil
hyle	hil3
hylle	hil3
hylster	hilst3r
hylt	hilt
hylte	hilt3
hyperaktiv	hip3roktiv
hypermoderne	hip3rmudEn3
hypnotisere	hipnutiser3
hypokonder	hipukon3r
hypotetisk	hiputetisk
hyppig	hipi
hyppige	hipi3
hyppigere	hipir3
hyppigst	hipikst
hyppigste	hipikst3
hyre	hir3
hysje	hiS3
hysterisk	histerisk
hytta	hito
hytte	hit3
håkon	hokon
hålke	holk3
hånd	hon
håndball	honbol
håndfast	honfost
håndgripelig	hongrip3li
håndgripelige	hongrip3li3
håndgripeligere	hongrip3lir3
håndgripeligst	hongrip3likst
håndgripeligste	hongrip3likst3
håndheve	honhev3
håndhilse	honhils3
håndkle	hoNkle
håndkrem	honkrEm
håndlaga	honlog3t
håndlaget	honlog3t
håndlist	honlist
håndtak	hontok
håndtere	honter3
håne	hon3
hånflire	honflir3
hånlig	honli
hånlige	honli3
hånligere	honlir3
hånligst	honlikst
hånligste	honlikst3
håp	hop
håpe	hop3
håpefull	hop3f3l
håpløs	hoples
hår	hor
hårete	hor3t3
hårfin	horfin
hårgele	hoSEle
hårreisende	horEis3n3
håve	hov3
hæl	hel
hær	hEr
høflig	hEfli
høflige	hEfli3
høfligere	hEflir3
høfligst	hEflikst
høfligste	hEflikst3
hølje	hEly3
høre	her3
høre på en	her3poen
hørsel	hES3l
hørselskadet	hES3lskod3t
hørt	hEt
hørte	hEt3
høst	hEst
høste	hEst3
høve	hev3
høvel	hEv3l
høvelig	hev3li
høvelige	hev3li3
høveligere	hev3lir3
høveligst	hev3likst
høveligste	hev3likst3
høy	hEy
høyde	hEyd3
høydeformat	hEid3fumot
høydepunkt	hEid3punkt
høylytt	hEylit
høyne	hEyn3
høyre	hEyr3
høyrehendt	hEyr3hEnt
høyskole	hEyskul3
høyspenning	hEisp3niN
høyst	hEyst
høytidelig	hEytid3li
høytidelige	hEytid3li3
høytideligere	hEytid3lir3
høytideligst	hEytid3likst
høytideligste	hEytid3likst3
høyttaler	hEytol3r
i	i
i blant	iblont
i dag	idog
i det minste	idEminst3
i går	igor
i helgen	ihElg3n
i kveld	ikvEl
i morgen kveld	imonkvEl
i morgen tidlig	imontidli
i overmorgen	iov3rmo3n
i rett tid	irEt ti
i slekt	iSLEkt
i stedet for	isted3for
i stykker	istik3r
i tillegg	itilEg
iaktta	iokto
iberegne	ib3rEin3
iblant	iblont
ideal	id3ol
idealisere	id3oliser3
idealistisk	id3olistisk
ideell	id3El
identifisere	id3ntifiser3
identisk	idEntisk
ideologisk	id3ulogisk
idiomatisk	idiumotisk
idiotisk	idiutisk
idrettskvinne	idrEtskvin3
idrettsmann	idrEtsmon
idrettsplass	idrEtsplos
idyllisk	idilisk
idé	ide
ifølge	ifElg3
igjen	iyEn
igle	igl3
ignorere	ignurer3
iherdig	ihEdi
iherdige	ihEdi3
iherdigere	ihEdir3
iherdigst	ihEdikst
iherdigste	ihEdikst3
ikke	ik3
ikke-røykere	ik3rek3r3
ild	il
ile	il3
ilegge	ilEi3
ille	il3
illegal	il3gol
illojal	iluyol
illustrere	il3strer3
ilter	ilt3r
imaginær	imoginEr
imitere	imiter3
immatrikulere	imotrik3ler3
immigrere	imigrer3
immun	im3n
imperativ	impErotiv
imperium	imperi3m
implisere	impliser3
imponere	impuner3
importere	impoter3
impregnere	impr3gner3
impresjonisme	imprESunism3
improvisere	impruviser3
impulsiv	imp3lsiv
imøtegå	imet3go
imøtekomme	imet3kom3
inderlig	in3Li
inderlige	in3Li3
inderligere	in3Lir3
inderligst	in3Likst
inderligste	in3Likst3
indignert	inignet
indikere	iniker3
indirekte	inirEkt3
indisk	inisk
individuell	inivid3El
indoktrinere	inoktriner3
indre	indr3
industriell	in3striEl
ineffektiv	inEf3ktiv
infam	infom
infeksjon	infEkSun
inferno	infEnu
infiltrere	infiltrer3
infisere	infiser3
informasjon	informoSun
informativ	informotiv
informere	informer3
informere seg	infomEr3sEi
informieren	informir3n
infusjon	inf3Sun
ingen	iN3n
ingen steder	iN3nsted3r
ingeniør	inS3nyer
ingenting	iN3ntiN
inhabil	inhobil
inhalere	inholer3
initiere	initsier3
injisere	inyiser3
inkludere	inkl3der3
inkludert	inkl3dEt
inklusiv	inkl3siv
inkompatibel	inkumpotib3l
inkompetent	inkump3tEnt
inkonsekvent	inkuns3kvEnt
innadvendt	inodvEnt
innarbeide	inorbEid3
innbakt	inbokt
innbefatte	inb3fot3
innbille	inbil3
innbilning	imbilniN imbilniN
innbilsk	inbilsk
innbitt	inbit
innbringende	inbriN3n3
innby	inbi
innbydende	inbid3n3
innbygger	inbig3r
innbyrdes	inbid3s
innbytter	imbit3r
inne	in3
innebære	in3bEr3
inneha	in3ho
inneholde	in3hol3
innen	in3n
innendørs	in3neS
innenfor	in3nfor
innenriks	in3nriks
innenriksfly	in3nriksfli
innertak	in3tok
inneslutta	in3SL3t3t
innesluttet	in3SL3t3t
inneværende	in3vEr3n3
innfinne	infin3
innflytelse	inflit3ls3
innflytelsesrik	inflit3ls3srik
innfløkt	inflEkt
innfore	infer3
innfri	infri
innfødt	infEt
innføre	infer3
innføring	imferiN
innførsel	imfES3l
inngang	ingoN
inngangsbillett	ingoNsbilEt
inngangspenger	ingoNspEN3r
inngripen	iNgripn
inngå	ingo
inngående	ingo3n3
innhegne	inhEin3
innhente	inhEnt3
innhold	inhol
innholdsløs	inholsles
innholdsrik	inholsrik
innkalle	inkol3
innkassere	inkoser3
innkjørsel	inSES3l
innkvartere	inkvoter3
innlate	inlot3
innlede	inled3
innlegg	inlEi
innlemme	inlEm3
innlevelse	inlev3ls3
innlysende	inlis3n3
innmari	inmori
innordne	inodn3
innpakning	inpokniN
innprente	inprEnt3
innpåsliten	inpoSLit3n
innrede	inred3
innreise	inrEis3
innrette	inrEt3
innrømme	inrEm3
innse	inse
innsjekking	inSEkiN
innsjø	inSe
innskjerpe	inSErp3
innskrenke	inskrEnk3
innskrift	inskrift
innsmigre	insmigr3
innstendig	instEni
innstendige	instEni3
innstendigere	instEnir3
innstendigst	instEnikst
innstendigste	instEnikst3
innstille	instil3
innta	into
inntil	intil
inntrykk	intrik
inntrykksfull	intriksf3lt
innvende	invEn3
innvendig	invEni
innvendige	invEni3
innvendigere	invEnir3
innvendigst	invEnikst
innvendigste	invEnikst3
innvie	invi3
innvikla	inviklo
innvilge	invilg3
innvirke	invirk3
innvortes	invot3s
innynde	inin3
insekt	insEkt
insinuere	insin3er3
insistere	insister3
insolvent	insolvEnt
inspirere	inspirer3
inspisere	inspiser3
installere	instoler3
instinktiv	instiNktiv instiNtiv
instruere	instr3er3
instruktiv	instr3ktiv
instrumental	instr3m3ntol
intakt	intokt
integrere	int3grer3
intellektuell	int3l3kt3El
intelligent	int3ligEnt
intens	intEns
intensiv	int3nsiv
intensivere	int3nsiver3
interaktiv	int3roktiv
interessant	int3r3soN
interessere	int3r3ser3
interessere seg for	int3rEser3sEifor
interessieren	int3rEsir3n
interiør	int3rier
intern	intEn
internasjonal	int3noSunol
internasjonalisere	int3noSunoliser3
interrail	int3rEil
intervenere	int3rv3ner3
intervjue	int3rvy33
intetsigende	int3tsig3n3
intim	intim
intolerant	intol3roN
intrikat	intrikot
introdusere	intrud3ser3
intuitiv	int3itiv
invadere	invoder3
invalid	involid
investere	inv3ster3
invitasjon	invitoSun
invitere	inviter3
involvere	involver3
irakisk	irokisk
iransk	ironsk
ire	ir3
irettesette	irEt3sEt3
ironisk	irunisk
irrasjonell	iroSun3l
irre	ir3
irrelevant	ir3l3vont
irritabel	iritob3l
irritere	iriter3
irsk	iSk
is	is
iscenesette	isen3sEt3
iscenesettelse	isen3sEtEls3
ishockey	ishoki
iskald	iskol
iskrem	iskrem
islamsk	islomsk
islandsk	islonsk
isolere	isuler3
israelsk	isroelsk
italiener	itolyen3r
italiensk	itolyensk
ivareta	ivor3to
iverksette	ivErksEt3
ivre	ivr3
ivrig	ivri
ivrige	ivri3
ivrigere	ivrir3
ivrigst	ivrikst
ivrigste	ivrikst3
iøynefallende	iEyn3fol3n3
ja	yo
jage	yog3
jakke	yok3
jakte	yokt3
jamføre	yomfer3
jamre	yomr3
januar	yon3or
japansk	yoponsk
jarl	yoL
jatte	yot3
jazz	yos
jeg	yEi
jeger	yeg3r
jekke	yEk3
jenke	yENk3
jenta	yEnto
jente	yEnt3
jernbanestasjon	yEnbon3stoSun
jevn	yEvn
jevne	yEvn3
jevnføre	yomfer3
jevngammel	yEvngom3l
jevngod	yEvngu
jo	yu
jobb	yob
jobbe	yob3
jod	yod
jogg	yog
jogge	yog3
joggesko	yog3sku
joike	yoyk3
jord	yur
jordbær	yurbEr
jorde	yur3
jordisk	yudisk
jordnær	yunEr
jorte	yot3
journalføre	Sunolfer3
journalist	Sunolist
jovial	yuviol
jubel	y3b3l
jubilere	y3biler3
juble	y3bl3
jukse	yuks3
jul	y3l
julaften	y3loft3n
julestjerne	y3l3styEn3
juli	y3li
jung	yoN
juni	y3ni
junior	y3niur
juridisk	y3ridisk
jurist	y3rist
justerbar	y3sterbor
justere	y3ster3
juveler	y3v3ler
jåle	yol3
jålete	yol3t3
jævlig	yEvli
jævlige	yEvli3
jævligere	yEvlir3
jævligst	yEvlikst
jævligste	yEvlikst3
jødisk	yedisk
kabaret	kobore
kabaretscene	koboresen3
kafe	kofe
kaffe	kof3
kaffepause	kof3pE3s3
kaffetrakter	kof3trokt3r
kafé	kofe
kai	kEi
kajakk	koyok
kake	kok3
kakle	kokl3
kald	kol
kaldblodig	kolbludi
kaldblodige	kolbludi3
kaldblodigere	kolbludir3
kaldblodigst	kolbludikst
kaldblodigste	kolbludikst3
kaldsvette	kolsvEt3
kaldt	kolt
kaldt vann	koltvon
kaliber	kolibr
kalibrere	kolibrer3
kalk	kork kolk
kalkulere	kolk3ler3
kalle	kol3
kalosje	koloS3
kalv	kolv
kalvbent	kolvbent
kalve	kolv3
kam	kom
kamel	komel
kamerat	kom3rot
kameratslig	kom3rotSLi
kameratslige	kom3rotSLi3
kameratsligere	kom3rotSLir3
kameratsligst	kom3rotSLikst
kameratsligste	kom3rotSLikst3
kamfer	komf3r
kamillete	komil3te
kamme	kom3
kammer	kom3r
kamp	komp
kamuflere	kom3fler3
kanadisk	konodisk
kanal	konol
kanalisere	konoliser3
kanin	konin
kano	konu
kanon	konon
kanonisk	konunisk
kansellere	kons3ler3
kanskje	konS3
kant	kont
kantre	kontr3
kaotisk	koutisk
kapabel	kopob3l
kapell	kopEl
kapital	kopitol
kapitalistisk	kopitolistisk
kapitulere	kopit3ler3
kappe	kop3
kappes	kop3s
kappkjøre	kopSer3
kappløp	koplep
kapre	kopr3
kapsel	kops3l
kaptein	koptEin
kaputt	kop3t
kar	kor
karaffel	korof3l
karakterisere	korokt3riser3
karakteristisk	korokt3ristisk
karikere	koriker3
karismatisk	korismotisk
karneval	kon3vol
karrig	kori
karrige	kori3
karrigere	korir3
karrigst	korikst
karrigste	korikst3
kart	kot
kartlegge	kotlEi3
karve	korv3
kasse	kos3
kassere	koser3
kasserer	koser3r
kassett	kos3t
kassettspiller	kosEtspil3r
kaste	kost3
kaster	kost3r
kastet	kost3t
kastrere	kostrer3
katalogisere	kotologiser3
katastrofal	kotostrufol
katedral	kot3drol
kategorisk	kot3gurisk
katolsk	kotulsk
katt	kot
katte	kot3
kausjonere	kE3Suner3
kave	kov3
keiser	kEis3r
keiserinne	SEis3rin3
keitet	SEit3t
keitete	SEit3t3
keivhendt	SEivhEnt
kelner	kEln3r
kennel	kEn3l
kennen	k3n3n
keramikk	SEromik
kibbutz	kib3ts
kidnappe	kidnop3
kikert	SikEt
kikhoste	Sikhust3
kikke	Sik3
kikke på	Sik3po
kilde	Sild3
kile	Sil3
kilen	Sil3n
kilometer	Silumet3r
kime	Sim3
kimære	kimEr3
kinesisk	Sinesisk
kinkig	SiNki
kinkige	SiNki3
kinkigere	SiNkir3
kinkigst	SiNkikst
kinkigste	SiNkikst3
kinn	Sin
kinnskjegg	SinSEg
kino	Sinu
kirke	Sirk3
kirkegård	Sirk3gor
kirketårn	Sirk3ton
kirsebær	SiS3bEr
kirurg	Sir3rg
kirurgisk	Sir3rgisk
kiste	Sist3
kives	Siv3s
kjake	Sok3
kjapp	Sop
kjappe	Sop3
kje	Se
kjede	Sed3
kjedelig	Sed3li
kjedelige	Sed3li3
kjedeligere	Sed3lir3
kjedeligst	Sed3likst
kjedeligste	Sed3likst3
kjeft	SEft
kjefte	SEft3
kjei	SEi
kjekk	SEk
kjekke	SEk3
kjekle	SEkl3
kjeks	SEks
kjelke	SElk3
kjeller	SEl3r
kjemiker	Semik3r
kjemme	SEm3
kjempe	SEmp3
kjendis	SEnis
kjenne	SEn3
kjennemerke	SEn3mErk3
kjennetegne	SEn3tEin3
kjent	SEnt
kjerne	SEn3
kjernemelk	SEn3mElk
kjernemjølk	SEn3myElk
kjernesunn	SEn3s3n
kjeve	Sev3
kjevle	SEvl3
kjip	Sip
kjole	Sul3
kjæle	SEl3
kjælenavn	SEl3novn
kjær	SE
kjære	SEr3
kjæreste	SEr3st3
kjærkommen	SErkom3n
kjærlig	SELi
kjærlige	SELi3
kjærligere	SELir3
kjærlighet	SELihet
kjærligst	SELikst
kjærligste	SELikst3
kjødelig	Sed3li
kjødelige	Sed3li3
kjødeligere	Sed3lir3
kjødeligst	Sed3likst
kjødeligste	Sed3likst3
kjøkken	SEkn SEk3n
kjøkkenkrok	SEk3nkruk
kjøle	Sel3
kjøleelement	Sel3ElEmEnt
kjøler	Sel3r
kjøleskap	Sel3skop
kjølig	Seli
kjølige	Seli3
kjøligere	Selir3
kjøligst	Selikst
kjøligste	Selikst3
kjønnsmoden	SEnsmud3n
kjøpe	Sep3
kjøpmann	Sepmon
kjøpslå	SepSLo
kjøre	Ser3
kjøre forbi	Ser3forbi
kjører	Ser3r
kjørsel	SES3l
kjøtt	SEt
kjøttdeig	SEtdEi
kladde	klod3
klaffe	klof3
klage	klog3
klam	klom
klamme	klom3
klamre	klomr3
klandre	klondr3
klappe	klop3
klapper	klop3r
klapre	klopr3
klar	klor
klare	klor3
klargjøre	kloryer3
klase	klos3
klaske	klosk3
klasse	klos3
klassifisere	klosifiser3
klassiker	klosik3r
klassisisme	klosisism3
klassisk	klosisk
klatre	klotr3
klatrer	klotr3r
klauv	klEwv
kle	kle
kle seg om	klesEium
klebe	kleb3
klebrig	klebri
klebrige	klebri3
klebrigere	klebrir3
klebrigst	klebrikst
klebrigste	klebrikst3
kledelig	kled3li
kledelige	kled3li3
kledeligere	kled3lir3
kledeligst	kled3likst
kledeligste	kled3likst3
klekke	klEk3
klekkelig	klEk3li
klekkelige	klEk3li3
klekkeligere	klEk3lir3
klekkeligst	klEk3likst
klekkeligste	klEk3likst3
klem	klEm
klemme	klEm3
klenge	klEN3
kleptoman	kl3ptumon
kleshenger	kleshEN3r
klikke	klik3
klima	klimo
klimaanlegg	klimoonlEg3
klimatisk	klimotisk
klimpre	klimpr3
kline	klin3
klinge	kliN3
klinisk	klinisk
klippe	klip3
klirre	klir3
klissete	klis3t3
klissvåt	klisvot
klistre	klistr3
klo	klu
kloakk	kluok
klok	kluk
klokke	klok3
klone	klun3
klore	klur3
kloss	klos
klossete	klos3t3
kloster	klost3r
klubbe	kl3b3
klubbhus	sik3l
kludre	kl3dr3
klug	kluk
klukke	kluk3
klumpe	klump3
klunke	kluNk3
klusse	kl3s3
klynge	kliN3
klynke	kliNk3
klype	klip3
klyse	klis3
klå	klo
klåfingret	klofiNr3t
klær	klEr
klø	kle
kløe	kle3
kløft	klEft
kløne	klen3
klønete	klen3t3
kløyve	klEyv3
kna	kno
knabbe	knob3
knake	knok3
knapp	knop
knappe	knop3
knapt	knopt
knas	knos
knaske	knosk3
kne	kne
kneble	knebl3
knegge	knEi3
knekke	knEk3
knele	knel3
knepen	knep3n
knipe	knip3
knipen	knip3n
knippe	knip3
knipse	knips3
knirke	knirk3
knirkefri	knirk3fri
knise	knis3
knitre	knitr3
kniv	kniv
knive	kniv3
knokkelbrudd	knok3lbr3d
knudrete	kn3dr3t3
knuge	kn3g3
knurre	kn3r3
knuse	kn3s3
knute	kn3t3
knytte	knit3
knær	knEr
koala	kuwolo
koble	kobl3
kode	kud3
koffeinfri	kof3infri
koffert	kuf3t
kognitiv	kognitiv
koke	kuk3
kokebok	kuk3buk
kokett	kukEt
kokk	kok
kokke	kok3
kokkelere	kok3ler3
kokos	kukus
kokt	kukt
kolera	kul3ro
kolerisk	kulerisk
kolikk	kulik
kollapse	kulops3
kolle	kEl3
kollega	kulEgo
kollektiv	kol3ktiv
koloni	kuluni
kolonisere	kuluniser3
kolossal	kulusol
kom inn	komin
kombinere	kumbiner3
komedie	kumedi3
komfort	komfor
komfortabel	komfotob3l
komfyr	kumfir
komiker	kumik3r
komisk	kumisk
kommandere	kumonder3
kommando	kumondu
komme	kom3
komme igjen	kom3iyEn
komme inn	kom3in
komme til krefter	kom3tilkrEft3r
komme til skade	kom3tilskod3
kommen	kom3n
kommentere	kum3nter3
kommer	kom3r
kommersiell	kumESiEl
kommunal	kum3nol
kommunisere	kum3niser3
kompakt	kumpokt
komparativ	kumporotiv
kompass	kumpos
kompatibel	kumpotib3l
kompensere	kump3nser3
kompetent	kump3tEnt
kompleks	kumplEks
komplett	kumplEt
komplettere	kumpl3ter3
komplisere	kumpliser3
komponere	kumpuner3
komponist	kumpunist
komprimere	kumprimer3
kondensere	kun3nser3
konditori	kunituri
kondolere	kunuler3
kondom	kundum
kone	kun3
konferere	kunf3rer3
konfidensiell	kunfid3nsiyEl
konfigurere	kunfig3rer3
konfirmere	kunfirme3
konfiskere	kunfisker3
konform	kunform
konfrontere	kunfronter3
konge	koN3
kongelig	koN3li
kongelige	koN3li3
kongeligere	koN3lir3
kongeligst	koN3likst
kongeligste	koN3likst3
kongle	koNl3
kongruere	koNgr3er3
konj før	fer
konk	kunk
konkav	konkov
konkludere	kunkl3der3
konkret	kuNkret
konkretisere	kuNkr3tiser3
konkurranse	kuNk3roNS3 kuNk3roNs3
konkurransedyktig	kunk3roNs3dikti
konkurransedyktige	kunk3roNs3dikti3
konkurransedyktigere	kunk3roNs3diktir3
konkurransedyktigst	kunk3roNs3diktikst
konkurransedyktigste	kunk3roNs3diktikst3
konkurs	kuNk3S
konrad	konrod
konsekvent	kuns3kvEnt
konsentrere	kuns3ntrer3
konsert	kunsEt
konservativ	kunsErvotiv
konservere	kunsErver3
konsis	kunsis
konsolidere	kunsulider3
konstant	kunstont
konstatere	kunstoter3
konstituere	kunstit3er3
konstitusjonell	kunstit3SunEl
konstruere	kunstr3er3
konstruktiv	kunstr3ktiv
konsulat	kuns3lot
konsultere	kuns3lter3
konsumere	kuns3mer3
kontakt	kuntokt
kontakte	kuntokt3
kontant	kuntont
kontanter	kuntont3r
kontingent	kuntiNgEnt
kontinuerlig	kuntin3eLi
kontinuerlige	kuntin3eLi3
kontinuerligere	kuntin3eLir3
kontinuerligst	kuntin3eLikst
kontinuerligste	kuntin3eLikst3
konto	kontu
kontor	kuntur
kontortid	kuntuti
kontra	kontro
kontrakt	kuntrokt
kontrollere	kuntroler3
kontrollieren	kontrolir3n
kontrollør	kuntruler
kontroversiell	kuntruvESiyEl
konveks	konvEks
konvensjonell	konv3nSunEl
konversere	kunvESer3
konvertere	kunvEter3
konvolutt	konvol3t
koordinere	kuodiner3
kopi	kupi
kopiere	kupier3
kople	kobl3
kopp	kop
kor	kur
koreansk	kur3onsk
kork	kork
korketrekker	kork3trEk3r
korpulent	korp3lEnt
korrekt	kurEkt
korrigere	kuriger3
korrupt	kur3pt
kors	koS
korsfeste	koSfEst3
korsgang	koSgoN
kort	kot
korte	kot3
korterma	kotErm3t
kortermet	kotErm3t
kortfatta	kotfot3t
kortfattet	kotfot3t
kortfilm	kotfilm
kortslutning	kutSL3tniN
korttenkt	kottENt kottENkt
kortvarig	kotvori
kortvarige	kotvori3
kortvarigere	kotvorir3
kortvarigst	kotvorikst
kortvarigste	kotvorikst3
kortvokst	kotvokst
kos	kus
kose	kus3
koselig	kuSLi
koselige	kuSLi3
koseligere	kuSLir3
koseligst	kuSLikst
koseligste	kuSLikst3
kosmetisk	kusmetisk
kost	kost
kostbar	kostbor
koste	kost3
kostelig	kost3li
kostelige	kost3li3
kosteligere	kost3lir3
kosteligst	kost3likst
kosteligste	kost3likst3
kosthold	kosthol
kostnad	kostnod
kostnadsfri	kostnodsfri
kotelett	kut3lEt
krabbe	krob3
krafse	krofs3
kraft	kroft
kraftig	krofti
kraftige	krofti3
kraftigere	kroftir3
kraftigst	kroftikst
kraftigste	kroftikst3
kraftuttrykk	kroft3trik
krage	krog3
krake	krok3
krakilsk	krokilsk
kram	krom
krampe	kromp3
krangel	kroN3l
krangle	kroNl3
kranglete	kroNl3t3
krapp	krop
krasje	krES3
krass	kros
kravle	krovl3
kravstor	krovstur
kreativ	kreotiv
kreditere	kr3diter3
kredittkort	krEditkot
kreere	kr3er3
kreft	krEft
krefter	krEft3r
krem	krem
kremere	kr3mer3
kremfløte	krEmflet3
kremte	krEmt3
krenke	krENk3
kreol	krEul
kreosot	krEusut
krepere	kr3per3
kreps	krEps
kresen	kres3n
kretse	krEts3
kretsløp	krEtslep
kreve	krev3
krible	kribl3
krige	krig3
kriger	krig3r
kriminalroman	kriminolrumon
kriminell	kriminEl
kringkaste	kriNkost3
kristelig	krist3li
kristelige	krist3li3
kristeligere	krist3lir3
kristeligst	krist3likst
kristeligste	krist3likst3
kristen	krist3n
kristendom	krist3num
kristin	kristin
kristoffer	kristof3r
kritikkverdig	kritikvEdi
kritikkverdige	kritikvEdi3
kritikkverdigere	kritikvEdir3
kritikkverdigst	kritikvEdikst
kritikkverdigste	kritikvEdikst3
kritisere	kritiser3
kritisk	kritisk
kro	kru
kroatisk	kruotisk
krok	kruk
kroke	krek3
krone	krun3
kronologisk	krunulogisk
kronprins	krunprins
kropp	krop
kroppsbygging	kropsbigiN
kroppslig	kropSLi
kroppslige	kropSLi3
kroppsligere	kropSLir3
kroppsligst	kropSLikst
kroppsligste	kropSLikst3
krum	krum
kry	kri
krydder	krid3r
krydre	kridr3
krykke	krik3
krympe	krimp3
krype	krip3
krypt	kript
kryptisk	kriptisk
kryss	kris
krysse	kris3
krystall	kristol
kryste	krist3
kråle	krol3
krøke	krek3
krølle	krEl3
ku	k3
kubbe	k3b3
kube	k3b3
kue	k33
kul	k3l
kule	k3l3
kulepenn	k3l3pEn
kulinarisk	k3linorisk
kulminere	k3lminer3
kultivere	k3ltiver3
kultur	k3lt3r
kulturell	k3lt3rEl
kulturminnevern	fredniNovk3lt3rminEsmErk3r
kulørt	k3let
kummerlig	kum3Li
kummerlige	kum3Li3
kummerligere	kum3Lir3
kummerligst	kum3Likst
kummerligste	kum3Likst3
kunde	k3nd3
kunne	k3n3
kunngjøre	k3nyer3
kunst	k3nst
kunsthandler	k3nsthonl3r
kunsthåndverk	k3nsthonvErk
kunstig	k3nsti
kunstige	k3nsti3
kunstigere	k3nstir3
kunstigst	k3nstikst
kunstigste	k3nstikst3
kunstnerisk	k3nstn3risk
kupert	k3pet
kuppel	k3p3l
kupé	k3pe
kupé for ikke-røkere	k3peforik3rek3r3
kurant	k3ront
kurere	k3rer3
kuriøs	k3ries
kurs	k3S
kursiv	k3Siv
kurtisere	k3tiser3
kurv	k3rv
kurve	k3rv3
kusine	k3sin3
kusma	k3smo
kutt	k3t
kutte	k3t3
kuvert	k3vEt
kvadratisk	kvodrotisk
kvadratmeter	kvodrotmet3r
kvae	kvo3
kvalifisere	kvolifiser3
kvalitativ	kvolitotiv
kvalitet	kvolitet
kvalm	kvolm
kvalme	kvolm3
kvann	kfon
kvantitativ	kvontitotiv
kvark	kvork
kvart	kvot
kvass	kvos
kveile	kvEil3
kvekke	kvEk3
kveld	kvEl
kveldsskole	kvElskul3
kvele	kvel3
kveppe	kvEp3
kverke	kvErk3
kverne	kvEn3
kverulere	kvEr3ler3
kvesse	kvEs3
kveste	kvEst3
kvie	kvi3
kvikk	kvik
kvinne	kvin3
kvinnelig	kvin3li
kvinnelige	kvin3li3
kvinneligere	kvin3lir3
kvinneligst	kvin3likst
kvinneligste	kvin3likst3
kvitre	kvitr3
kvitt	kvit
kvitte	kvit3
kvittere	kviter3
kvittering	kviteriN
kvotere	kvuter3
kyle	Sil3
kylling	SiliN
kyndig	Sini
kyndige	Sini3
kyndigere	Sinir3
kyndigst	Sinikst
kyndigste	Sinikst3
kynisk	Sinisk
kyr	Sir
kysk	Sisk
kyss	Sis
kysse	Sis3
kyst	Sist
kål	kol
kåpe	kop3
kåre	kor3
kåsere	koser3
kø	ke
københavn	SEbnhovn
køln	kEln
køye	kEy3
la	lo
labb	lob
labbe	lob3
laber	lob3r
labil	lobil
lade	lod3
lader	lodEr
lafte	loft3
lag	log
lage	log3
lage mat	log3mot
lagelig	log3li
lagelige	log3li3
lageligere	log3lir3
lageligst	log3likst
lageligste	log3likst3
lagre	logr3
lagsarbeid	logsorbEi
lake	lok3
laken	lokn
lakke	lok3
lakkere	loker3
lakonisk	lokunisk
laks	loks
laksen	loksn
laksene	loksn3
lakser	loks3r
lam	lom
lamme	lom3
lammelse	lomEls3
lampe	lomp3
land	lon
lande	lon3
landeveg	lon3vEi
landevei	lon3vEi
landing	loniN
landlig	lonli
landlige	lonli3
landligere	lonlir3
landligst	lonlikst
landligste	lonlikst3
landsby	lonsbi
landskap	lonskop
lang	loN
lange	loN3
langfingra	loNfiNr3t
langfingret	loNfiNr3t
langfredag	loNfredog
langhåra	loNhor3t
langhåret	loNhor3t
langsiktig	loNsikti
langsiktige	loNsikti3
langsiktigere	loNsiktir3
langsiktigst	loNsiktikst
langsiktigste	loNsiktikst3
langsom	loNsom
langsynt	loNsint
langtekkelig	loNtEk3li
langtekkelige	loNtEk3li3
langtekkeligere	loNtEk3lir3
langtekkeligst	loNtEk3likst
langtekkeligste	loNtEk3likst3
langvarig	loNvori
langvarige	loNvori3
langvarigere	loNvorir3
langvarigst	loNvorikst
langvarigste	loNvorikst3
lansere	loNser3
lapp	lop
lappe	lop3
larm	lorm
lase	los3
laser	los3r
laste	lost3
lat	lot
late	lot3
late seg	lot3sEi
latent	lotEnt
latinsk	lotinsk
latter	lot3r
latterlig	lot3Li
latterlige	lot3Li3
latterligere	lot3Lir3
latterliggjøre	lot3Liyer3
latterligst	lot3Likst
latterligste	lot3Likst3
lattermild	lot3rmil
laud	lEwd
lav	lov
lave	lov3
lavendel	lovEnd3l
lavmælt	lovmelt
le	le
lealaus	leolE3s
ledd	lEd
lede	led3
leder	led3r
ledig	ledi
ledige	ledi3
ledigere	ledir3
ledigst	ledikst
ledigste	ledikst3
ledning	ledniN
ledsage	ledsog3
ledsager	ledsog3r
lee	le3
leg	lek
legal	l3gol
legalisere	l3goliser3
lege	leg3
legeme	leg3m3
legemlig	legEmli
legge	lEi3
legge bort	lEg3but
legge merke til	lEg3mErk3til
legge til	lEg3til
leggings	lEgiNs
legitim	l3gitim
legitimere	l3gitimer3
lei	lEi
leie	lEi3
leie ut	lEi33t
leier	lEi3r
leilighet	lEilihet
leir	lEir
leire	lEir3
lek	lek
leke	lek3
leken	lek3n lekn
leker	lek3r
leketøy	lek3tEy
lekk	lEk
lekkasje	l3koS3
lekke	lEk3
lekker	lEk3r
lekse	lEks3
lemleste	lEmlEst3
lempe	lEmp3
lende	lEn3
lenestol	lenEstul
lengde	lENd3
lenge	lEN3
lengst	lENst
lengte	lENt3
lenke	lENk3
lens	lEns
leppe	lEp3
lepra	lepro
lernen	lEn3n
lesbisk	lEsbisk
lese	les3
leselig	les3li
leselige	les3li3
leseligere	les3lir3
leseligst	les3likst
leseligste	les3likst3
leske	lEsk3
lespe	lEsp3
lesse	lEs3
lete	let3
letne	lEtn3
lett	lEt
lette	lEt3
lettfattelig	l3tfot3li
lettfattelige	l3tfot3li3
lettfatteligere	l3tfot3lir3
lettfatteligst	l3tfot3likst
lettfatteligste	l3tfot3likst3
lettmelk	lEtmElk lEtmyElk
lettrørt	lEtret
lettsindig	l3tsini
lettsindige	l3tsini3
lettsindigere	l3tsinir3
lettsindigst	l3tsinikst
lettsindigste	l3tsinikst3
lettvint	lEtvint
leve	lev3
leven	levn
levende	lev3n3
lever	lEv3r
levere	lEver3
leverpostei	lev3rpustEi
levne	lEvn3
li	li
liberal	lib3rol
liberalisere	lib3roliser3
liberalistisk	lib3rolistisk
lide	lid3
lidenskapelig	lid3nskop3li
lidenskapelige	lid3nskop3li3
lidenskapeligere	lid3nskop3lir3
lidenskapeligst	lid3nskop3likst
lidenskapeligste	lid3nskop3likst3
lieb	lip
liechtensteinsk	liSt3nStEinsk
ligge	lig3
liggevogn	lig3voN
ligne	liNn3
lignende	liNn3n3
lik	lik
like	lik3
likedan	lik3don
likefrem	lik3fr3m
likeglad	lik3glo
likegyldig	lik3yildi
likegyldige	lik3yildi3
likegyldigere	lik3yildir3
likegyldigst	lik3yildikst
likegyldigste	lik3yildikst3
likevel	lik3vEl
liknende	liNn3n3
liksom	liksom
likvidere	likvider3
lilla	lilo
lille	lit3n
lillebror	lil3brur
lillesøster	lil3sEst3r
lim	lim
limbånd	limbon
lime	lim3
limet	lim3
limfarge	limforg3
limkrukke	limkruk3
limtube	limt3b3
lin	lin
lindre	lindr3
linje	liny3
links	liNks
linoleumen	linuliy3m3n
linse	lins3
lirke	lirk3
lise	lis3
lisse	lis3
liste	list3
listig	listi
listige	listi3
listigere	listir3
listigst	listikst
listigste	listikst3
litauisk	litE3isk
lite	lit3
liten	lit3n litn
liter	lit3r
litt	lit
litteratur	lit3rot3r
litterær	lit3rEr
liv	liv
livaktig	livokti
livaktige	livokti3
livaktigere	livoktir3
livaktigst	livoktikst
livaktigste	livoktikst3
live	liv3
livlig	livli
livlige	livli3
livligere	livlir3
livligst	livlikst
livligste	livlikst3
livredd	livrEd
livserfaring	lifsEforiN
livsfarlig	lifsfoLi
livsfarlige	lifsfoLi3
livsfarligere	lifsfoLir3
livsfarligst	lifsfoLikst
livsfarligste	lifsfoLikst3
livsglad	lifsglo
livstruende	lifstr33n3
livsviktig	lifsvikti
livsviktige	lifsvikti3
livsviktigere	lifsviktir3
livsviktigst	lifsviktikst
livsviktigste	lifsviktikst3
livvakt	livokt
ljome	yum3
lo	lu
lodde	lod3
lodden	lod3n
loddrett	lodrEt
loe	lu3
loff	luf
logisk	lugisk
logn	lEyn
logre	logr3
lojal	loyol
lokal	lukol
lokalisere	lukoliser3
lokalsamtale	lukolsomtol3
lokaltog	lukoltog
lokke	lok3
lomme	lom3 lume
lommekjent	lum3SEnt
loppe	lop3
loppemarked	lop3morkEd
lose	lus3
losje	luS3
loslitt	luSLit
losse	los3
louis	l3is
lov	lov
love	lov3
lovende	lov3n3
lovfeste	lovfEst3
lovlig	lovli
lovlige	lovli3
lovligere	lovlir3
lovligst	lovlikst
lovligste	lovlikst3
lovlydig	lovlidi
lovlydige	lovlidi3
lovlydigere	lovlidir3
lovlydigst	lovlidikst
lovlydigste	lovlidikst3
lovstridig	lovstridi
lovstridige	lovstridi3
lovstridigere	lovstridir3
lovstridigst	lovstridikst
lovstridigste	lovstridikst3
lubben	l3bn l3b3n
lue	l33
luft	l3ft
luft i magen	l3ftimog3n
lufte	l3ft3
luftforurensning	l3ftfor3rEnsniN
lugar	l3gor
lugge	l3g3
luguber	l3g3b3r
luke	l3k3
lukke	luk3
lukrativ	l3krotiv
luksuriøs	l3ks3ries
lukt	l3kt
lukte	lukt3
lummer	lum3r
lummert	lum3t
lumpen	lump3n
lumsk	lumsk
lun	l3n
lunde	l3nd3
lune	l3n3
lunefull	l3n3f3l
lunge	luN3
lungebetennelse	luN3bEtEnEls3
lunken	luNk3n
lunsj	lEnS
lunte	l3nt3
lur	l3r
lure	l3r3
lurvete	l3rv3t3
luse	l3s3
lusen	l3s3n
luske	l3sk3
lut	l3t
lute	l3t3
lutrygga	l3trig3t
lutrygget	l3trig3t
luxembourgsk	l3ks3mb3rksk
ly	li
lyd	lid
lyde	lid3
lydig	lidi
lydige	lidi3
lydigere	lidir3
lydigst	lidikst
lydigste	lidikst3
lydløs	lidles
lykke	lik3
lykkelig	lik3li
lykkelige	lik3li3
lykkeligere	lik3lir3
lykkeligst	lik3likst
lykkeligste	lik3likst3
lykkes	lik3s
lykkeønskning	likEnskniN
lyn	lin
lyne	lin3
lyngen	liNn
lynsje	linS3
lys	lis
lysbryter	lisbrit3r
lyse	lis3
lyseblå	lis3
lyskaster	liskost3r
lyske	lisk3
lyskebrokk	lisk3brok
lysmåler	lismol3r
lyspære	lispEr3
lyssky	lisSi
lyst	list
lystbetont	listb3tunt
lysten	list3n
lystig	listi
lystige	listi3
lystigere	listir3
lystigst	listikst
lystigste	listikst3
lystre	listr3
lytte	lit3
lytter	lit3r
lyve	liv3
låg	log
låne	lon3
lår	lor
låse	los3
låt	lot
låte	lot3
lærd	lEd
lære	lEr3
lærer	lEr3r
lærerik	lEr3rik
lærevillig	lEr3vili
lærevillige	lEr3vili3
lærevilligere	lEr3vilir3
lærevilligst	lEr3vilikst
lærevilligste	lEr3vilikst3
løfte	lEft3
løgn	lEyn
løk	lek
lønn	lEn
lønne	lEn3
lønnsom	lEnsom
løp	lep
løpe	lep3
løpende	lepn3
løpsk	lEpsk
lørdag	ledog
lørdager	ledog3r
løs	les
løse	les3
løslate	leslot3
løsrive	lesriv3
løssluppen	lesSLup3n
løstenner	lesthEn3r
løye	lEy3
løype	lEyp3
løyve	lEyv3
madrass	modros
mage	mog3
mager	mog3r
magisk	mogisk
magister	mogist3r
mai	moi
mais	mois
majestetisk	moy3stetisk
majones	moyunes
makaber	mokob3r
make	mok3
makelig	mok3li
makelige	mok3li3
makeligere	mok3lir3
makeligst	mok3likst
makeligste	mok3likst3
makeløs	mok3les
maken	mok3n
makrell	mokrEl
maksimal	moksimol
makt	mokt
makte	mokt3
maktesløs	mokt3sles
maktpåliggende	moktpolig3n3
makulere	mok3ler3
male	mol3
malen	mol3n
malene	mol3n3
maler	mol3r
maleri	mol3ri
malm	molm
malplassert	molploset
mamma	momo
man	mon
mandag	mondog
mandarin	mondorin
mandel	mond3l
mandelbetennelse	mon3lbEtEnEls3
mandig	moni
mandige	moni3
mandigere	monir3
mandigst	monikst
mandigste	monikst3
mane	mon3
manen	mon
manene	mon3
mange	moN3
mangesidig	moN3sidi
mangesidige	moN3sidi3
mangesidigere	moN3sidir3
mangesidigst	moN3sidikst
mangesidigste	moN3sidikst3
mangfoldig	moNfoldi
mangfoldige	moNfoldi3
mangfoldigere	moNfoldir3
mangfoldigst	moNfoldikst
mangfoldigste	moNfoldikst3
mangle	moNl3
mangslungen	moNSLuN3n
manifest	monifEst
manipulere	monip3ler3
mann	mon
mannen	mon
mannlig	monli
mannlige	monli3
mannligere	monlir3
mannligst	monlikst
mannligste	monlikst3
mannskap	monskop
mannsterk	monstErk
manuell	mon3El
manøvrere	monEvrer3
marg	morg
margarin	morgorin
marit	morit
maritim	moritim
mark	mork
markant	morkont
marked	morkEd
markedsføre	mork3dsfer3
markedsføring	mork3dsferiN
markere	morker3
markert	morket
marokkansk	morukonsk
mars	moS
marsjere	moSer3
mas	mos
masasje	mosoS3
mascara	moskoro
mase	mos3
masete	mos3t3
maske	mosk3
maskin	moSin
maskinell	moSinEl
maskingevær	moSing3vEr
maskulin	mosk3lin
massakrere	mosokrer3
masse	mos3
masseprodusere	mos3prud3ser3
massere	moser3
massiv	mosiv
mat	mot
matbit	motbit
mate	mot3
matematiker	mot3motik3r
matematisk	mot3motisk
materiale	mot3riol3
materialistisk	mot3riolistisk
materie	moteri3
materiell	mot3riEl
matforgiftning	motforyiftniN
matt	mot
matte	mot3
maule	mE3l3
maur	mEwr mEv3r
med	me
meddele	medel3
medfødt	medfEt mefEt
medgi	medyi
medgjørlig	m3dyeLi
medgjørlige	m3dyeLi3
medgjørligere	m3dyeLir3
medgjørligst	m3dyeLikst
medgjørligste	m3dyeLikst3
medikament	mEdikomEnt
medisin	m3disin
medisin for blodomløpet	mEdisinforbluumlep3
medisinsk	m3disinsk
meditere	m3diter3
medium	medi3m
medlem	medl3m
medlemskap	medl3mskop
medskyldig	medSildi
medskyldige	medSildi3
medskyldigere	medSildir3
medskyldigst	medSildikst
medskyldigste	medSildikst3
medvirke	medvirk3
meg	mEi
megle	mEgl3
megler	mEgl3r
megling	mEgliN
meie	mEi3
mekanisk	m3konisk
mekre	mEkr3
meksikansk	m3ksikonsk
mektig	mEkti
mektige	mEkti3
mektigere	mEktir3
mektigst	mEktikst
mektigste	mEktikst3
mel	mel
melankolsk	m3lonkulsk
melding	mEliN
melert	m3let
melk	mElk
melke	mElk3
mellom	mElom
mellomlanding	mElomloniN
melon	mElun
men	men
mene	men3
mening	meniN
menn	mEn
mennene	mEn3n3
menneske	mEnsk3 mEn3sk3
menneskelig	mEn3sk3li
menneskelige	mEn3sk3li3
menneskeligere	mEn3sk3lir3
menneskeligst	mEn3sk3likst
menneskeligste	mEn3sk3likst3
mens	mEns
menstruasjon	mEnstr3oSun
mental	m3ntol
meny	mEni
mer	mer
mer enn	merEn
merkantil	mErkontil
merkbar	mErkbor
merke	mErk3
merkelig	mErk3li
merkelige	mErk3li3
merkeligere	mErk3lir3
merkeligst	mErk3likst
merkeligste	mErk3likst3
merkverdig	mErkvEdi
merkverdige	mErkvEdi3
merkverdigere	mErkvEdir3
merkverdigst	mErkvEdikst
merkverdigste	mErkvEdikst3
merr	mEr
mesenat	mEsnnot
messe	mEs3
mester	mEst3r
mestre	mEstr3
mesén	mEsen
metafysisk	m3tofisisk
meteorolog	m3t3urulog
meteorologisk	m3t3urulogisk
meter	met3r
mett	mEt
midd	mid
middag	midog
middel	mid3l
middelalder	mid3lold3r
middelaldrende	mid3loldr3n3
middelmådig	mid3lmodi
middelmådige	mid3lmodi3
middelmådigere	mid3lmodir3
middelmådigst	mid3lmodikst
middelmådigste	mid3lmodikst3
middels	mid3ls
midje	midy3
midlertidig	midl3tidi
midlertidige	midl3tidi3
midlertidigere	midl3tidir3
midlertidigst	midl3tidikst
midlertidigste	midl3tidikst3
midnatt	midnot
midte	mit3
migrene	migren3
mikroskopisk	mikruskupisk
mikse	miks3
mild	mil
miljø	milye
miljøvennlig	milyevEnli
miljøvennlige	milyevEnli3
miljøvennligere	milyevEnlir3
miljøvennligst	milyevEnlikst
miljøvennligste	milyevEnlikst3
millimeter	milimet3r
mime	mim3
min	min
mindreverdig	mindr3vEdi
mindreverdige	mindr3vEdi3
mindreverdigere	mindr3vEdir3
mindreverdigst	mindr3vEdikst
mindreverdigste	mindr3vEdikst3
mindreårig	mindr3ori
mindreårige	mindr3ori3
mindreårigere	mindr3orir3
mindreårigst	mindr3orikst
mindreårigste	mindr3orikst3
mine	min3
mineralvann	min3rolvon
minibank	pEN3E3tumot
minibar	minibor
minigolf	minigolf
minimal	minimol
minister	minist3r
minke	miNk3
minne	min3
minne en om noe	min3enumnu3
minnes	min3s
minnesmerke	minEsmErk3
minnested	min3sted
minneverdig	min3vEdi
minneverdige	min3vEdi3
minneverdigere	min3vEdir3
minneverdigst	min3vEdikst
minneverdigste	min3vEdikst3
minske	minsk3
minst	minst
minutt	min3t
mirakuløs	mirok3les
misbruke	misbr3k3
misfornøyd	misfonEyd
misforstå	misfoSto
mishandle	mishonl3
mislike	mislik3
mislykka	misliko
mislykkes	mislik3s
mislykket	mislik3t
miste	mist3
mistenke	mistENk3
mistenksom	mistENksom
mistrives	mistriv3s
misunne	mis3n3
misunnelig	mis3n3li
misunnelige	mis3n3li3
misunneligere	mis3n3lir3
misunneligst	mis3n3likst
misunneligste	mis3n3likst3
misunnelse	mis3n3ls3
mit	mit
mitt	mit
mjaue	myEw3
mjød	myed
mjøl	myEr
mjølk	myErk
mo	mu
mobbe	mob3
mobil	mubil
mobilisere	mubiliser3
modell	mudEl
modellere	mud3ler3
moden	mud3n
moderat	mud3rot
moderere	mud3rer3
modern	modEn
moderne	mudEn3
modernisere	mudEniser3
modifisere	mudifiser3
modig	mudi
modige	mudi3
modigere	mudir3
modigst	mudikst
modigste	mudikst3
modne	mudn3
molefonken	mul3fuNk3n
molo	mulu
momentan	mum3nton
moms	mums
monne	mon3
montere	monter3
mor	mur
mor'n	mon
moralisere	muroliser3
moralsk	murolsk
mord	mud
morder	mud3r
more	mur3
more seg	mur3sEi
morgen	moon
morken	mork3n
moro	muru
morsk	muSk
morsom	muSom
mose	mus3
mosjonere	muSuner3
mot	mut
motarbeide	mutorbEid3
motbevise	mutb3vis3
motbydelig	mutbid3li
motbydelige	mutbid3li3
motbydeligere	mutbid3lir3
motbydeligst	mutbid3likst
motbydeligste	mutbid3likst3
mote	mut3
motell	mutEl
moteriktig	mut3rikti
moteriktige	mut3rikti3
moteriktigere	mut3riktir3
moteriktigst	mut3riktikst
moteriktigste	mut3riktikst3
motesmykke	mut3smik3
motivere	mutiver3
motløs	mutles
motor	mutur mutur
motoren	mutun mutuun
motorsykkel	mutuSik3l
motorvei	muturvEi
motorvei klasse b	muturvEiklos3be
motsatt	mutsot
motsetning	mutsEtniN
motsette	mutsEt3
motsi	mutsi
motstand	mutston
motstandsdyktig	mutstonsdikti
motstandsdyktige	mutstonsdikti3
motstandsdyktigere	mutstonsdiktir3
motstandsdyktigst	mutstonsdiktikst
motstandsdyktigste	mutstonsdiktikst3
motstå	mutsto
motta	muto
mottagelig	mutok3li
mottaker	mutok3r
motvillig	mutvili
motvillige	mutvili3
motvilligere	mutvilir3
motvilligst	mutvilikst
motvilligste	mutvilikst3
mugge	m3g3
muggen	m3g3n
mule	m3l3
mulig	m3li
mulige	m3li3
muligere	m3lir3
muliggjøre	m3liyer3
mulighet	m3lihet
muligst	m3likst
muligste	m3likst3
mulkt	m3lkt m3lt
multiplisere	m3ltipliser3
mumle	muml3
munn	m3n
munne	m3n3
munning	m3niN
munter	m3nt3r
muntlig	m3ntli
muntlige	m3ntli3
muntligere	m3ntlir3
muntligst	m3ntlikst
muntligste	m3ntlikst3
murre	m3r3
museum	m3se3m
musical	my3sik3l
musikalsk	m3sikolsk
musiker	m3sik3r
musikk	m3sik
musikkforretning	m3sikfor3tniN
muskel	m3sk3l
muskulær	m3sk3lEr
muskuløs	m3sk3les
musli	m3sli
muslimsk	m3slimsk
musling	m3SLiN
mye	mi3
mygg	mig
myk	mik
myke	mik3
mykost	mikust
myldre	mildr3
myndig	mini
myndige	mini3
myndigere	minir3
myndighet	minihet
myndigst	minikst
myndigste	minikst3
mynt	mint
mynte	mint3
myntvaskeri	mintvosk3ri
myr	mir
myrde	mid3
myse	mis3
mystisk	mistisk
myte	mit3
mytologisk	mitulogisk
måke	mok3
mål	mol
målbevisst	molb3vist
måle	mol3
målene	mol3n3
målet	mol3
målmann	molmon
målrettet	molrEt3t
måltid	moltid
måne	mon3
måned	mon3d
månedlig	mon3dli
månedlige	mon3dli3
månedligere	mon3dlir3
månedligst	mon3dlikst
månedligste	mon3dlikst3
måpe	mop3
måse	mos3
måte	mot3
måteholden	mot3hol3n
måtte	mot3
møbel	meb3l
møblere	mEbler3
møkk	mEk
møkkete	mEk3t3
møne	men3
mønje	mEny3
mønster	mEnst3r
mør	mer
mørk	mErk
mørke	mErk3
mørkeblå	mErk3
mørklegge	mErklEi3
mørkt brød	mErktbre
møte	met3
møtt	mEt
møysommelig	mEysom3li
møysommelige	mEysom3li3
møysommeligere	mEysom3lir3
møysommeligst	mEysom3likst
møysommeligste	mEysom3likst3
nabo	nobu
nagle	nogl3
naiv	noiv
naken	nok3n nokn
nakent	noknt
nakke	nok3
nakne	nokn3
naknere	nokn3r3
naknest	nokn3st
nappe	nop3
narkoman	norkumon
narkose	norkus3
narr	nor
narre	nor3
narren	non
nasjonal	noSunol
nasjonalitet	noSunolitet
nasjonalitetstegn	noSunolitetstEin
nasjonalpark	noSunolpork
naske	nosk3
natt	not
nattbord	notbur
nattklubb	notkl3b
natur	not3r
naturkostbutikk	not3rkostb3tik
naturlig	not3Li
naturlige	not3Li3
naturligere	not3Lir3
naturligst	not3Likst
naturligste	not3Likst3
naturligvis	not3Livis
naturvitenskap	not3rvit3nskop
naust	nEwst
naut	nEvt nEwt
nautisk	nE3tisk
navigere	noviger3
navle	novl3
navlebeskuende	novl3b3sk33n3
navn	novn
navngi	novnyi
nazistisk	nosistisk
ned	ned
nedbrutt	nedbr3t
nede	ned3
nedenfor	ned3nfor
nederlandsk	ned3Lonsk
nedlate	nedlot3
nedlatende	nedlot3n3
nedsette	nedsEt3
nedsettende	nedsEt3n3
nedslående	nedSLo3n3
nedstemme	nedstEm3
nedstemt	nedstEmt
nedtrykt	nedtrikt
nedverdige	nedvEdig3
negativ	negotiv
neglisjere	n3gliSer3
nei	nEi
neie	nEi3
nekte	nEkt3
nemnd	nEmd
neppe	nEp3
nerve	nErv3
nervepirrende	nErv3pir3n3
nervøs	nErves
nese	nes3
nesebor	nes3bur
nesevis	nes3vis
neshorn	neshun
neste	nEst3
neste år	nEst3or
nesten	nEst3n
nestsiste	nEstsist3
nett	nEt
nettopp	nEtop
nettside	nEtsid3
nevenyttig	nev3niti
nevenyttige	nev3niti3
nevenyttigere	nev3nitir3
nevenyttigst	nev3nitikst
nevenyttigste	nev3nitikst3
nevne	nEvn3
ni	ni
nifs	nifs
nikke	nik3
nippe	nip3
nisse	nis3
nitten	nit3n
nitti	niti
nivå	nivo
noe	nu3
noen	nu3n
nok	nok
nominere	numiner3
nordisk	nudisk
nordlig	nuLi
nordmann	nurmon
noreg	noreg
normal	nurmol
normalisere	nurmoliser3
normalt	nurmolt
normere	normer3
norrøn	nurEn
norsk	noSk
nostalgisk	nustolgisk
notere	nuter3
notorisk	nuturisk
november	nuvEmb3r
nudiststrand	n3diststron
nulle	n3l3
nummer	num3r
nummerere	num3rer3
nummerskilt	num3Silt
ny	ni
nyansere	nioNser3
nybakt	nibokt
nydelig	nid3li
nydelige	nid3li3
nydeligere	nid3lir3
nydeligst	nid3likst
nydeligste	nid3likst3
nye	ni3
nyhet	nihet
nylig	nili
nylige	nili3
nyligere	nilir3
nyligst	nilikst
nyligste	nilikst3
nynne	nin3
nynorsk	ninoSk
nype	nip3
nyre	nir3
nyrebelte	nir3bElt3
nyrebetennelse	nir3bEtEnEls3
nyrestein	nir3stEin
nyse	nis3
nysgjerrig	niSEri
nysgjerrige	niSEri3
nysgjerrigere	niSErir3
nysgjerrigst	niSErikst
nysgjerrigste	niSErikst3
nyss	nis
nyte	nit3
nytte	nit3
nyttig	niti
nyttige	niti3
nyttigere	nitir3
nyttigst	nitikst
nyttigste	nitikst3
nyttår	nitor
nå	no
nåde	nod3
nådeløs	nod3les
nål	nol
når	nor
nåværende	novEr3n3
nær	nEr
nærgående	nErgo3n3
nærhet	nErhet
næring	nEriN
næringsrik	nEriNsrik
nærliggende	nELig3n3
nærme	nErm3
nærsynt	nESint
nærtagende	nEtog3n3
nødsfall	nedsfol
nødt	nEt
nødvendig	nEdvEni
nødvendige	nEdvEni3
nødvendigere	nEdvEnir3
nødvendigst	nEdvEnikst
nødvendigste	nEdvEnikst3
nøkkel	nEk3l
nøklene	nEkl3n3
nøktern	nEktEn
nøle	nel3
nøste	nEst3
nøtt	nEt
nøyaktig	nEyokti
nøyaktige	nEyokti3
nøyaktigere	nEyoktir3
nøyaktigst	nEyoktikst
nøyaktigste	nEyoktikst3
nøye	nEy3
nøytral	nEytrol
obdusere	ubd3ser3
objektiv	ubyEktiv
obligatorisk	ubligoturisk
observant	opsErvoN
observere	opsErver3
obskur	opsk3r
obskøn	opsken
odde	od3
offensiv	ofoNsiv
offentlig	ofEntli
offentlige	of3ntli3
offentligere	of3ntlir3
offentliggjøre	of3ntliyer3
offentlighet	of3ntlihet
offentligst	of3ntlikst
offentligste	of3ntlikst3
offer	of3r
offisielt	ofisi3lt
offside	ofsoid
ofre	ofr3
oft	oft
ofte	oft3
og	o o
også	oso
ohne	on3
okkupere	ok3per3
oktober	oktob3r
olaf	ulof
oliven	uliv3n
olje	oly3
oljemaleri	oly3mol3ri
olympisk	ulimpisk
om	om
om dagen	omdog3n
om ei uke	omEi3k3
om formiddagen	omformidog3n
om kvelden	omkvEl3n
om morgenen	ommon3n
ombestemme	omb3stEm3
ombestille	ombEstil3
omfang	omfoN
omfangsrik	omfoNsrik
omfatte	omfot3
omfattende	omfot3n3
omfavne	omfovn3
omgi	omyi
omgivelser	omyivEls3r
omgjengelig	omyEN3li
omgjengelige	omyEN3li3
omgjengeligere	omyEN3lir3
omgjengeligst	omyEN3likst
omgjengeligste	omyEN3likst3
omgå	omgo
omgående	omgo3n3
omhyggelig	omhig3li
omhyggelige	omhig3li3
omhyggeligere	omhig3lir3
omhyggeligst	omhig3likst
omhyggeligste	omhig3likst3
omkomme	omkom3
omkostninger	omkostniN3r
omkring	omkriN
omringe	omriN3
område	omrod3
omsette	omsEt3
omstendelig	omstEn3li
omstendelige	omstEn3li3
omstendeligere	omstEn3lir3
omstendeligst	omstEn3likst
omstendeligste	omstEn3likst3
omstendighet	omstEnihet
omstridt	omstrit
omtale	omtol3
omtenksom	omtENksom
omtrent	omtrEnt
omveg	omvEi
omvei	omvEi
omvende	omvEn3
omvendt	omv3nt
omverden	umvEd3n
omvisning	omvisniN
onanere	unoner3
ond	un
ondskapsfull	unskopsf3l
onkel	uNk3l
onsdag	unsdog
opera	up3ro
operasjon	up3roSun
operativ	op3rotiv
operere	op3rer3
operette	up3rEt3
opp	op
oppbevare	opbEvor3 op3vor3
oppbyggelig	opbig3li
oppbyggelige	opbig3li3
oppbyggeligere	opbig3lir3
oppbyggeligst	opbig3likst
oppbyggeligste	opbig3likst3
oppdage	opdog3
oppdatere	opdoter3
oppdikta	opdikt3t
oppdiktet	opdikt3t
oppdra	opdro
oppe	op3
oppfatte	opfot3
oppfinne	opfin3
oppfordre	opfodr3
oppfostre	opfustr3
oppfylle	opfil3
oppfølger	opfEl3r
oppføre	opfer3
oppførelse	opferEls3
oppgi	opyi
oppgitt	opyit
oppgradere	opgroder3
oppheve	ophev3
opphold	ophol
oppholde	ophol3
oppholde seg	ophol3sEi
oppholdsrom	opholsrum
opphøre	opher3
oppklare	opklor3
opplagt	oplokt
oppland	oplon
oppleve	oplev3
opplevelse	oplev3ls3
opplyse	oplis3
opplysning	oplisniN
opplyst	oplist
oppmerksom	opmErksom
oppmerksomhet	opmErksomhet
oppmuntre	opm3ntr3
oppnå	opno
oppofrende	opofr3n3
oppover	opov3r
oppreist	oprEist
opprette	oprEt3
opprettholde	opr3thol3
oppriktig	oprikti
oppriktige	oprikti3
oppriktigere	opriktir3
oppriktigst	opriktikst
oppriktigste	opriktikst3
opprinnelig	oprin3li
opprinnelige	oprin3li3
opprinneligere	oprin3lir3
opprinneligst	oprin3likst
opprinneligste	oprin3likst3
opprøre	oprer3
oppsummere	ops3mer3
oppsvulmet	opsv3lm3t
oppta	opto
opptatt	optot
opptre	optre
oppvakt	opvokt
oppvarte	opvot3
oppvaskbørste	opvoskbESt3
oppvaskklut	opvoskl3t
oppvaskkum	opvoskum
oppvaskmiddel	opvoskmid3l
optiker	optik3r
optimal	optimol
optimistisk	optimistisk
optisk	optisk
orange	oroNS3
oransje	uronS
ord	ur
ordbok	urbuk
orden	odn
ordenen	odn
ordener	odn3r
ordentlig	ontli
ordentlige	ontli3
ordentligere	ontlir3
ordentligst	ontlikst
ordentligste	ontlikst3
ordinær	odinEr
ordklasse	urklos3
ordlegge	uLEi3
ordne	on3 odn3
ordre	odr3
organisere	orgoniser3
organisk	orgonisk
orgel	org3l
orientere	ori3nter3
original	originol
originalversjon	originolvESun
orke	ork3
orkester	orkEst3r
orm	orm
ortodoks	otudoks
ose	us3
oslo	uSLu
oss	os
ost	ust
oval	uvol
over	ov3r
overalt	ov3rolt
overanstrenge	ov3ronstrEN3
overbevise	ov3rb3vis3
overbærende	ov3rbEr3n3
overdrive	ov3driv3
overdådig	ov3dodi
overdådige	ov3dodi3
overdådigere	ov3dodir3
overdådigst	ov3dodikst
overdådigste	ov3dodikst3
overdøve	ov3dev3
overfall	ov3rfol
overfalle	ov3rfol3
overfladisk	ov3rflodisk
overfor	ov3rfor
overfore	ov3rfer3
overføre	ov3rfer3
overføring	ov3rferiN
overført	ov3rfet
overgang	ov3rgoN
overgrep	ov3rgrep
overgå	ov3rgo
overholde	ov3rhol3
overhøre	ov3rher3
overkjøre	ov3rSer3
overkommelig	ov3rkom3li
overkommelige	ov3rkom3li3
overkommeligere	ov3rkom3lir3
overkommeligst	ov3rkom3likst
overkommeligste	ov3rkom3likst3
overlappe	ov3Lop3
overlate	ov3Lot3
overlegen	ov3Leg3n
overleve	ov3Lev3
overlevere	ov3L3ver3
overmanne	ov3rmon3
overnatte	ov3not3
overnatting	ov3notiN
overnattingssted	ov3notiNstEd ov3notiNste
overnaturlig	ov3not3Li
overnaturlige	ov3not3Li3
overnaturligere	ov3not3Lir3
overnaturligst	ov3not3Likst
overnaturligste	ov3not3Likst3
overraske	ov3rosk3
overrasket	ov3rosk3t
overrekke	ov3rEk3
overrumple	ov3rumpl3
overse	ov3Se
oversette	ov3SEt3
oversettelse	ov3SEt3ls3
oversiktlig	ov3Siktli
oversiktlige	ov3Siktli3
oversiktligere	ov3Siktlir3
oversiktligst	ov3Siktlikst
oversiktligste	ov3Siktlikst3
overskride	ov3Skrid3
overskrift	ov3Skrift
overskuelig	ov3Sk33li
overskuelige	ov3Sk33li3
overskueligere	ov3Sk33lir3
overskueligst	ov3Sk33likst
overskueligste	ov3Sk33likst3
overskyet	ov3Si3t
overstige	ov3Stig3
overta	ov3to
overtale	ov3tol3
overtre	ov3tre
overtroisk	ov3truisk
overveie	ov3rvEi3
overveiende	ov3rvEi3n3
overvektig	ov3rvEkti
overvektige	ov3rvEkti3
overvektigere	ov3rvEktir3
overvektigst	ov3rvEktikst
overvektigste	ov3rvEktikst3
overvelde	ov3rvEld3
overvinne	ov3rvin3
overvurdere	ov3rv3der3
overvåke	ov3rvok3
overvære	ov3rvEr3
overøse	ov3res3
p-pille	pepil3
pacemaker	pEismEik3r
padde	pod3
paddle	podl3
padle	podl3
paff	pof
pai	pEi
pakistansk	pokistonsk
pakke	pok3
pakke inn	pok3in
palass	polos
pale	pol3
palme	polm3
pannekake	pon3kok3
pannelugg	pon3l3g
pannerett	pon3rEt
panser	pons3r
pant	pont
pante	pont3
pantsette	pontsEt3
papir	popir
papirhandel	popirhon3l
pappa	popo
paprika	popriko
par	por
parade	porod3
paradere	poroder3
paradoksal	porodoksol
parallell	porolEl
parallellitet	porolElitet
paralysere	poroliser3
paraply	poropli
parat	porot
pare	por3
parere	porer3
parfyme	porfim3
parfymeri	porfim3ri
park	pork
parkere	porker3
parkeringslys	porkeriNslis
parkeringsplass	porkeriNsplos
parkeringsplass for funksjonshemmede	porkeriNsplos for f3NkSunshEm3d3
parkett	porkEt
parkometer	porkumet3r
parodiere	porudier3
partere	poter3
partisk	potisk
parykk	porik
pasient	posiEnt
pass	pos
passasjer	posoSer
passe	pos3
passe på	pos3po
passelig	pos3li
passelige	pos3li3
passeligere	pos3lir3
passeligst	pos3likst
passeligste	pos3likst3
passende	pos3n3
passere	poser3
passiv	posiv
passkontroll	poskuntrol
passé	pose
patent	potEnt
patetisk	potetisk
patruljere	potr3lyer3
patte	pot3
pause	pE3s3
pedagogisk	p3dogugisk
pedantisk	p3dontisk
peke	pek3
pen	pen
pendle	pEnl3
pengeanvisning	pEN3onvisniN
pengepung	pEN3puN
penger	pEN3r
pengeseddel	pEN3sEd3l
penn	pEn
pensjonat	poNSunot
pensle	pEnsl3
pepper	pEp3r
pepre	pEpr3
per	per
perfekt	pErfEkt
perle	pEL3
permanent	pErmonEnt
permittere	pErmiter3
perpleks	pErplEks
perrong	pEroN
persille	pESil3
persisk	pESisk
person	pESun
personalia	pESonolio
personlig	pESunli
personlige	pESunli3
personligere	pESunlir3
personligst	pESunlikst
personligste	pESunlikst3
pertentlig	pEtEntli
pertentlige	pEtEntli3
pertentligere	pEtEntlir3
pertentligst	pEtEntlikst
pertentligste	pEtEntlikst3
pervers	pErvES
pese	pes3
pessimistisk	p3simistisk
pianist	pionist
piano	piyonu
piffe	pif3
pigg	pig
pikant	pikont
pil	pil
pile	pil3
pille	pil3
pine	pin3
pinlig	pinli
pinlige	pinli3
pinligere	pinlir3
pinligst	pinlikst
pinligste	pinlikst3
pinne	pin3
pinse	pins3
pinsett	pinsEt
pipe	pip3
piple	pipl3
pirke	pirk3
pirre	pir3
piske	pisk3
pissoar	pisuor
pjokk	pSok
pjusk	py3sk
plage	plog3
plagiere	plogier3
plagsom	ploksom
plakat	plokot
plan	plon
planke	ploNk3
planlegge	plonlEi3
planlegging	plonlEyiN
plante	plont3
plaske	plosk3
plass	plos
plassbillett	plosbilEt
plassere	ploser3
plast	plost
plaster	plost3r
plastfolie	plostfuli3
plastisk	plostisk
plastpose	plostpus3
plate	plot3
platt	plot
plattfot	plotfut
plausibel	plE3sib3l
pleie	plEi3
pleietrengende	plEi3trEN3n3
plen	plen
plikt	plikt
pliktig	plikti
pliktige	plikti3
pliktigere	pliktir3
pliktigst	pliktikst
pliktigste	pliktikst3
plomme	plum3
pludre	pl3dr3
plukke	pluk3
plump	plump
plumpe	plump3
plutselig	pl3ts3li
plutselige	pl3ts3li3
plutseligere	pl3ts3lir3
plutseligst	pl3ts3likst
plutseligste	pl3ts3likst3
plyndre	plindr3
plystre	plistr3
pløsete	ples3t3
pløye	plEy3
pneumatisk	pnEwmotisk
poeng	poEN
poengtere	po3Nter3
poet	puet
polar	pulor
polere	puler3
poliomyelitt	puliumi3lit
politi	puliti
politibil	pulitibil
politiker	pulitik3r
politikk	pulitik
politimann	pulitimon
politisk	pulitisk
pollen	poln
polsk	pulsk
pompøs	pumpes
pop	pop
poppel	pop3l
populær	pup3lEr
porselen	puS3len
porsjon	puSun
porsjonere	puSuner3
port	put
portal	putol
portier	putier
porto	putu
portrett	putrEt
portugisisk	put3gisisk
porøs	pures
pose	pus3
posere	puser3
positiv	pusitiv
poste	post3
poste restante	post3rEstont3
postkasse	postkos3
postkontor	postkuntur
postkort	postkot
postlegge	postlEi3
postnummer	postnum3r
postsparebankbok	postspor3boNkbuk
potensial	put3nsiol
potensiell	put3nsiEl
potet	putet
potte	pot3
pragmatisk	progmotisk
praktfull	proktf3l
praktisere	proktiser3
praktisk	proktisk
prange	proN3
prate	prot3
pratsom	protsom
prege	preg3
preke	prek3
prektig	prEkti
prektige	prEkti3
prektigere	prEktir3
prektigst	prEktikst
prektigste	prEktikst3
prekær	pr3kEr
prelle	prEl3
premie	premi3
premiere	pr3miEr3
preposisjon	pr3pusiSun
presang	pr3soN
presentabel	pr3soNtob3l
presentasjon	prEsoNtoSun
presentere	pr3soNter3
presentere noen for noen	prEsoNter3nu3nfonu3n
presis	prEsis
presisere	pr3siser3
presse	prEs3
presserende	prEser3n3
prest	prEst
prestere	pr3ster3
prestisjefylt	pr3stiS3filt
pretensiøs	pr3toNsies
prevensjon	prev3nSun
preventiv	prEvoNtiv
prikke	prik3
prima	primo
primitiv	primitiv
primær	primEr
prinsipiell	prinsipiEl
printe	print3
prioritere	priuriter3
prippen	prip3n
pris	pris
prise	pris3
privat	privot
privatisere	privotiser3
prn jeg	yEi
problem	prublem
problematisk	prubl3motisk
problemer med blodomløpet	prublem3rmebluumlep3
produksjon	prud3kSun
produkt	prud3kt
produktiv	prud3ktiv
produsere	prud3ser3
profesjonell	pruf3SunEl
proff	pruf
profittere	prufiter3
program	prugrom
programhefte	prugromhEft3
programmere	prugromer3
progressiv	prugr3siv
proklamere	pruklomer3
promille	prumil3
prominent	pruminEnt
promotere	prumuter3
prompe	prump3
proporsjonal	prupuSunol
proppe	prop3
prosaisk	prusoisk
prosent	prusEnt
prosesjon	prus3Sun
prosess	prusEs
prosjektere	pruSEkter3
prospektkort	pruspEktkut
prost	prust
prostituere	prustit3er3
protese	prutes3
protest	prutEst
protestantisk	prut3stontisk
protestere	prut3ster3
prove	prev3
provisorisk	pruvisurisk
provosere	pruvuser3
prute	pr3t3
pryde	prid3
pryle	pril3
prøve	prev3
pseudonym	s3vdunim ps3vdunim
psyke	psik3 sik3
psykiatrisk	sikiotrisk psikiotrisk
psykisk	psikisk sikisk
publisere	p3bliser3
pudder	p3d3r
pudre	p3dr3
pugge	p3g3
pukkel	puk3l
pulk	p3rk
puls	p3ls
pulsere	p3lser3
pult	p3lt
pulver	p3lv3r
pumpe	pump3
punkt	puNt
punktere	puNter3 puNkter3
punktert	puNtEt
punktlig	p3Ntli p3Nktli
punktlige	p3Ntli3 p3Nktli3
punktligere	p3Nktlir3 p3Ntlir3
punktligst	p3Nktlikst p3Ntlikst
punktligste	p3Nktlikst3 p3Ntlikst3
pupp	p3p
purke	p3rk3
purre	p3r3
pusle	p3SL3
pussa	p3so
pusse	p3s3
pussig	p3si
pussige	p3si3
pussigere	p3sir3
pussigst	p3sikst
pussigste	p3sikst3
puste	p3st3
putre	p3tr3
putte	p3t3
pynte	pint3
pysete	pis3t3
på	po
på bakkenivå	pobok3nivo
på baksiden	poboksid3n
på denne tiden	podEn3tid3n
på forhånd	poforhon
på hverdager	povEdog3r
på norsk	ponoSk
påberope	pob3rup3
påbud	pob3d
påby	pobi
pådra	podro
påfallende	pofol3n3
påfølgende	pofElg3n3
pågripe	pogrip3
pågå	pogo
pågående	pogo3n3
påholden	pohol3n
påkledning	pokledniN
pålegg	polEg
pålitelig	politli
pålitelige	politli3
påliteligere	politlir3
påliteligst	politlikst
påliteligste	politlikst3
påpasselig	popos3li
påpasselige	popos3li3
påpasseligere	popos3lir3
påpasseligst	popos3likst
påpasseligste	popos3likst3
påpeke	popek3
påske	posk3
påskynde	poSin3 poSind3
påstand	poston
påstigningshjelp	postigniNsyElp
påstå	posto
påståelig	posto3li
påståelige	posto3li3
påståeligere	posto3lir3
påståeligst	posto3likst
påståeligste	posto3likst3
påtatt	potot
påvirke	povirk3
påvise	povis3
pære	pEr3
pølse	pEls3
pønske	pEnsk3
rabatt	robot
rable	robl3
racersykkel	rEsESik3l
racket	rEk3t
rade	rod3
radering	roderiN
radikal	rodikol
radio	rodiu
raffinert	rofinet
rage	rog3
rak	rok
rake	rok3
rakett	rokEt
rakke	rok3
rakle	rokL3
rakne	rokn3
ramle	roml3
ramme	rom3
rampete	romp3t3
ramponere	rompuner3
rane	ron3
rang	roN
rangel	roN3l
rangere	roNSer3
rangle	roNr3
ransake	ronsok3
rapp	rEp
rappe	rop3
rapportere	ropoter3
rar	ror
rase	ros3
rasende	ros3n3
rasere	roser3
rasistisk	rosistisk
rasjonell	roSunEl
rask	rosk
raskt	roskt
rasle	roSL3
raspe	rosp3
rastløs	rostles
raus	rE3s
raute	rE3t3
re	re
reagere	r3oger3
reaksjon	r3okSun
real	reol
realisere	r3oliser3
realistisk	r3olist
redd	rEd
redde	rEd3
rede	red3
redegjøre	red3yer3
redelig	red3li
redelige	red3li3
redeligere	red3lir3
redeligst	red3likst
redeligste	red3likst3
redigere	r3diger3
redningsbåt	rEdniNsbot
redningsvest	rEdniNsvEst
redsel	rEts3l
redusere	r3d3ser3
reell	r3El
referere	r3f3rer3
refleksiv	rEfl3ksiv
reflektere	r3fl3kter3
refse	rEfs3
refundere	r3f3nder3
refusere	r3f3ser3
regel	reg3l
regelmessig	reg3lmEsi
regelmessige	reg3lmEsi3
regelmessigere	reg3lmEsir3
regelmessigst	reg3lmEsikst
regelmessigste	reg3lmEsikst3
regi	rESi
regional	r3giunol
registrere	r3gistrer3
regjere	r3yer3
regjering	rEyeriN
regn	rEin
regne	rEin3r rEin3
regnfrakk	rEinfrok
regnfullt	rEinf3lt
regning	rEiniN
regnskur	rEinsk3r
regulere	r3g3ler3
regulær	r3g3lEr
reim	rEim
rein	rEin
reise	rEis3
reise bort	rEis3but
reise fra	rEis3fro
reise til	rEis3til
reisebyrå	rEis3biro
reisehåndbok	rEis3honbuk
reiseselskap	rEis3sElskop
reisesjekk	rEis3SEk
reiseveske	rEis3vEsk3
reke	rek3
reker	rEk3r
rekke	rEk3
reklamere	rEklomer3
rekonstruere	rEkunstr3er3
rekruttere	rEkr3ter3
relativ	rElotiv
relevant	rEl3vont
religion	rEligiun
religiøs	rEligies
ren	ren
renessanse	renesons3
rengjøre	renyer3
renne	rEn3
renovere	r3nuver3
rense	rEns3
renseri	rEnseri
renske	r3nsk3
renslig	renSLi
renslige	renSLi3
rensligere	renSLir3
rensligst	renSLikst
rensligste	renSLikst3
reparere	rEporer3
repetere	r3p3ter3
representativ	r3pr3sEntotiv
representere	r3pr3s3nter3
reprodusere	r3prud3ser3
resepsjon	rEsEpSun
resept	rEsEpt
reserve	rEsErv3
reservere	rEsErver3
reservering	rEsErveriN
reservert	rEsErvet
residere	rEsider3
resignere	rEsigner3
resirkulere	rEsirk3ler3
resolutt	rEsul3t
resonnere	rEsuner3
respekt	rEspEkt
respektabel	rEspEktob3l
respektere	rEspEkter3
respektiv	rEsp3ktiv
respektløs	rEspEktles
ressurs	rEs3S
ressurssterk	rEs3SstErk
ressurssvak	rEs3Ssvok
rest	rEst
restaurant	rEst3roN
restaurantvogn	rEsto3roNvoNn
restaurere	rEstE3rer3
resultat	rEs3ltot
resultere	rEs3lter3
retning	rEtniN
retningsnummer	rEtniNsnum3r
rett	rEt
rett fram	rEt from
rette	rEt3
rettferdig	rEtfEdi
rettferdige	rEtfEdi3
rettferdigere	rEtfEdir3
rettferdigst	rEtfEdikst
rettferdigste	rEtfEdikst3
rettssak	rEtsok
returbillett	rEt3rbilEt
returnere	r3t3ner3
revers	rEvES
revidere	r3vider3
revne	rEvn3
revolusjon	r3vul3Sun
revolusjonere	r3vul3Suner3
revy	revi
rheumatisme	rE3motism3
ri	ri
ribbe	rib3
ride	rid3
rideskole	ridEskul3
ridetur	rid3t3r
rifle	rifl3
rik	rik
rike	rik3
rikelig	rik3li
rikelige	rik3li3
rikeligere	rik3lir3
rikeligst	rik3likst
rikeligste	rik3likst3
rikke	rik3
riktig	rikti
riktige	rikti3
riktigere	riktir3
riktigst	riktikst
riktigste	riktikst3
rime	rim3
rimelig	rimli rim3li
rimelige	rim3li3
rimeligere	rim3lir3
rimeligst	rim3likst
rimeligste	rim3likst3
ring	riN
ringe	riN3
ripe	rip3
rips	rips
ris	ris
risikabel	risikob3l
risikere	risiker3
risiko	risiku
riste	rist3
ristet	rist3t
rive	riv3
ro	ru
robust	rub3st
robåt	rubot
rodd	rud
rodde	rud3
roe	ruw3 ru3
roer	ruw3r
roh	ro
rolig	ruli
rolige	ruli3
roligere	rulir3
roligst	rulikst
roligste	rulikst3
rolle	rol3
rom	rum
roman	rumon
romantisk	rumontisk
rombe	rumb3
romfart	rumfot
romme	rum3
romskip	rumSip
romslig	rumSLi
romslige	rumSLi3
romsligere	rumSLir3
romsligst	rumSLikst
romsligste	rumSLikst3
rope	rup3
roper	rup3r
ror	rur
ros	rus
rosa	ruso
rose	rus3
rosmarin	rusmorin
rot	rot
rote	rut3
rotere	ruter3
rotete	rut3t3
rotte	rot3
rovdyr	rovdir
ru	r3
rug	r3g
ruge	r3g3
ruglete	r3gl3t3
ruin	r3in
ruinere	r3iner3
rulle	r3l3
rullestol	r3l3stul
rumensk	r3mensk
rumpe	rump3
rund	r3n
runde	r3n3
rundhanda	r3nhon3t
rundhandet	r3nhon3t
rundhånda	r3nhon3t
rundhåndet	r3nhon3t
rundstykker med pålegg	r3nstik3rmEpolEg
rundt	r3nt
rundtur	r3nt3r
rundtur til øyer	r3nt3tilEy3r
rune	r3n3
runge	ruN3
ruse	r3s3
rusk	r3sk
rusle	r3SL3
russisk	r3sisk
rust	r3st
ruste	r3st3
rusten	r3st3n
rute	r3t3
rutebilstasjon	r3t3bilstoSun
ruteplan	r3t3plon
rutete	r3t3t3
rutine	r3tin3
ry	ri
rydde	rid3
ryddig	ridi
ryddige	ridi3
ryddigere	ridir3
ryddigst	ridikst
ryddigste	ridikst3
rygg	rig
rygge	rig3
ryggrad	rigrod
ryggsekk	riksEk
ryke	rik3
rykke	rik3
rynke	riNk3
ryste	rist3
rystende	rist3ne
rytme	ritm3
rå	ro
råd	ro
råde	rod3
rådføre	rodfer3
rådhus	rodh3s
råkjøre	roSer3
råtne	rotn3
råtten	rot3n
røa	rewo
rød	re
røde hunder	re3h3n3r
rødkål	rekol
rødme	rEdm3
rødstrupe	restr3p3
rødt	rEt
rødvin	revin
røff	rEf
røke	rek3
røkt	rekt
røkte	rEkt3
rømme	rEm3
røntgen	rEntk3n
røntgenbilde	rEntk3nbild3
røpe	rep3
røre	rer3
røslig	rESLi
røslige	rESLi3
røsligere	rESLir3
røsligst	rESLikst
røsligste	rESLikst3
røyk	rEyk
røyke	rEyk3
røyker	rEyk3r
røyte	rEyt3
sabla	soblo
sabotere	sobuter3
safe	sEif
safran	sofron
saft	soft
saftig	softi
saftige	softi3
saftigere	softir3
saftigst	softikst
saftigste	softikst3
sage	sog3
sagn	soNn
sak	sok
sakkyndig	sokSini
sakkyndige	sokSini3
sakkyndigere	sokSinir3
sakkyndigst	sokSinikst
sakkyndigste	sokSinikst3
saklig	sokli
saklige	sokli3
sakligere	soklir3
sakligst	soklikst
sakligste	soklikst3
saks	soks
sakse	soks3
saksøke	soksek3
sakte	sokt3
sal	sol
salami	solomi
salat	solot
salg	solg
salomonisk	solumunisk
salt	solt
salte	solt3
salve	solv3
salvie	solvi3
samarbeid	somorbEid
samarbeide	somorbEid3
samfunn	somf3n
samisk	somisk
samle	soml3
samling	somliN
samme	som3
sammen	som3n
sammenfatte	som3nfot3
sammenheng	som3nhEN
sammenlagt	som3nlokt
sammenligne	som3nliNn3
sammensatt	som3nsot
sammenstøt	som3nstet
samordne	somodn3
samt	somt
samtale	somtol3
samtidig	somtidi
samtidige	somtidi3
samtidigere	somtidir3
samtidigst	somtidikst
samtidigste	somtidikst3
samtykke	somtik3
samvittighetsfull	somvitihetsf3l
sand	son
sandal	sondol3r
sandkasse	sonkos3
sang	soN
sangbok	soNbuk
sanger	soN3r
sangerinne	soN3rin3
sangfugl	soNf3l
sangkor	soNkur
sangstemme	soNstEm3
sangvinsk	soNvinsk
sangværelse	soNvELs3
sanitetsbind	sonitetsbin
sanitær	sonitEr
sanke	soNk3
sann	son
sannsynlig	sonsinli
sannsynlige	sonsinli3
sannsynligere	sonsinlir3
sannsynlighet	sonsinlihet
sannsynligst	sonsinlikst
sannsynligste	sonsinlikst3
sannsynligvis	sonsinlivis
sans	sons
sanse	sons3
sansebedrag	sons3b3drog
sarkastisk	sorkostisk
sart	sot
satirisk	sotirisk
sats	sots
satse	sots3
satt	sot
sau	sEw
saueost	sE33ust
saumfare	sE3mfor3
saus	sE3s
savn	sovn
savne	sovn3
schæfer	Sef3r
scooter	sk3t3r
score	skor
se	se
se opp	se op
se på	sepo
seddel	sEd3l
sees	se3s
seg	sEi
segne	sEin3
seier	sEi3r
seig	sEig
seige	sEi3
seigere	sEy3r3
seigst	sEikst
seigste	sEikst3
seil	sEil
seilbåt	sEilbot
seile	sEil3
seiltur	sEilt3r
seire	sEir3
sekk	sEk
seks	sEks
seksten	sEist3n
seksti	sEksti
seksuell	s3ks3El
sekund	sEk3n
sel	sel
sele	sel3
seleksjon	sElEkSun
selektiv	sElEktiv
selg	sEl
selge	sEl3
selleri	sEl3ri
selskap	sElskop
selsom	selsom
selv	sEl
selvbetjening	sElbEtyeniN
selvforskyldt	sElfoSilt
selvfølgelig	s3lfElg3li
selvfølgelige	s3lfElg3li3
selvfølgeligere	s3lfElg3lir3
selvfølgeligst	s3lfElg3likst
selvfølgeligste	s3lfElg3likst3
selvgod	sElgu
selvhjulpen	sElyulp3n
selvisk	sElvisk
selvmord	sElmud
selvsagt	sElsokt
selvsikker	sElsik3r
selvskreven	sElskrev3n
selvstendig	s3lstEni
selvstendige	s3lstEni3
selvstendigere	s3lstEnir3
selvstendigst	s3lstEnikst
selvstendigste	s3lstEnikst3
selvtillit	sEltilit
selvutløser	sEl3tles3r
sen	sen
send	sEn
sende	sEn3
senere	senEr3
seng	sEN
sengeteppe	sEN3tEp3
sengetøy	sEN3tEy
senil	s3nil
senior	seniur
senke	sENk3
sennep	sEnEp
sensasjonell	s3nsoSunEl
sensitiv	sEnsitiv
sensuell	s3ns3El
sensurere	s3ns3rer3
sent	sent
sentimental	sEntimEntol
sentral	sEntrol
sentralisere	s3ntroliser3
sentralstasjon	sEntrolstoSun
sentralvarme	sEntrolvorm3
sentrere	s3ntrer3
sentrisk	sEntrisk
sentrum	sEntr3m
separat	s3porot
september	s3ptEmb3r
septer	sEpt3r
ser	ser
serbisk	sErbisk
seriøs	sEries
serv	SErv
servere	sErver3
service	sErvis
serviett	sErviyEt
servitør	sErviter
ses	se3s
sesjon	sESun
sesong	sEsoN
setning	sEtniN
sette	sEt3
sette på	sEt3po
sexy	sEksi
sherry	SEri
shorts	Sots
show	Sou
si	si
si ja	siyo
siameser	siyomes3r
side	sid3
sidegate	sid3got3
siden	sid3n sidn
sigar	sigor
sigarett	sigorEt
sigarillo	sigorilu
signalisere	siNnoliser3
signe	siNn3
signere	siNner3
sikker	sik3r
sikkerhet	sik3rhet
sikkerhetskontroll	sik3rhetskuntrol
sikkerhetsnål	sik3rhetsnol
sikkert	sik3t
sikle	sikl3
sikori	sikuri
sikre	sikr3
sikring	sikriN
sikte	sikt3
sil	sil
sild	sil
sildre	sildr3
sile	sil3
silke	silk3
silkemaleri	silk3molEri
simpel	simp3l
simulere	sim3ler3
sin	sin
sindig	sini
sindige	sini3
sindigere	sinir3
sindigst	sinikst
sindigste	sinikst3
singel	siN3l
sinn	sin
sinna	sino
sinnssyk	sinsik
sint	sint
sirkle	sirkl3
sirkulere	sirk3ler3
sirkus	sirk3s
sirlig	siLi
sirlige	siLi3
sirligere	siLir3
sirligst	siLikst
sirligste	siLikst3
sist	sist
siste	sist3
sitere	siter3
sitron	sitrun
sitte	sit3
sitteplass	sit3plos
situasjon	sit3oSun
sive	siv3
sjal	Sol
sjalu	Sol3
sjampanje	Sompony3
sjampinjong	SompinyoN
sjampo	Sompu
sjanse	SoNs3
sjarmere	Sormer3
sjarmerende	Sormer3n3
sjef	Sef
sjekk	SEk
sjekke	SEk3
sjekke inn	SEk3in
sjel	Sel
sjelden	SEld3n
sjenere	S3ner3
sjenert	S3net
sjenerøs	S3n3res
sjikanere	Sikoner3
sjokkere	Soker3
sjokolade	Sukulod3
sjonglere	SoNler3
sjuk	S3k
sjukdom	S3kdum
sjuskete	S3sk3t3
sjåfør	Sofer
sjø	Se
sjøgang	SegoN
sjøl	Sel
sjøsette	SesEt3
sjøsyk	Sesik
skade	skod3
skadede	skod3d3
skadelig	skod3li
skadelige	skod3li3
skadeligere	skod3lir3
skadeligst	skod3likst
skadeligste	skod3likst3
skaffe	skof3
skake	skok3
skakke	skok3
skalla	skol3t
skalle	skol3
skallet	skol3t
skamme	skom3
skammelig	skom3li
skammelige	skom3li3
skammeligere	skom3lir3
skammeligst	skom3likst
skammeligste	skom3likst3
skandaløs	skonoles
skandinavisk	skoninovisk
skanne	skEn3
skap	skop
skape	skop3
skapende	skop3n3
skare	skor3
skarp	skorp
skarpt	skot skorpt
skarre	skor3
skateboard	skEitbod
skatt	skot
skeie	SEi3
skeptisk	skEptisk
ski	Si
skibinding	SibiniN
skift	Sift3
skifte ut	Skift33t
skiftende	Sift3n3
skiinstruktør	Siinstr3ktEr
skikka	Siko
skikke	Sik3
skikkelig	Sik3li
skikkelige	Sik3li3
skikkeligere	Sik3lir3
skikkeligst	Sik3likst
skikkeligste	Sik3likst3
skikket	Sik3t
skildre	Sildr3
skill	Sil
skille	Sil3
skilt	Silt
skilte	Silt3
skiløper	Silep3r
skimte	Simt3
skinke	SiNk3
skinn	Sin
skinne	Sin3
skinnebein	SinbEin
skinnhellig	SinhEli
skinnhellige	SinhEli3
skinnhelligere	SinhElir3
skinnhelligst	SinhElikst
skinnhelligste	SinhElikst3
skinnvarer	Sinvor3r
skissere	Siser3
skistav	Sistov
skitrekk	SitrEk
skitt	Sit
skitten	Sit3n
skive	Siv3
skje	Se
skjebne	Sebn3
skjebnesvanger	Sebn3svoN3r
skjegg	SEg
skjeggete	SEi3t3
skjele	Sel3
skjelett	S3lEt
skjell	SEl
skjelle	SEl3
skjellig	SEli
skjellige	SEli3
skjelligere	SElir3
skjelligst	SElikst
skjelligste	SElikst3
skjellsettende	SElsEt3n3
skjelmsk	SElmskt
skjelne	SEln3
skjelve	SElv3
skjelven	SElv3n
skjeløyd	SelEyd
skjematisk	S3motisk
skjemme	SEm3
skjemmes	SEm3s
skjende	SEn3
skjene	Sen3
skjenke	SEnk3
skjenne	SEn3
skjerf	SErf
skjerm	SErm
skjerme	SErm3
skjerpe	SErp3
skjev	Sev
skjoldete	Sol3t3
skjorte	Sut3
skjule	S3l3
skjær	SEr
skjære	SEr3
skjærtorsdag	SEtoSdog
skjødesløs	Sed3sles
skjønn	SEn
skjønne	SEn3
skjønt	SEnt
skjør	Ser
skjørt	SEt
skjøt	Set
skjøteledning	Set3lEdniN
skjøtte	SEt3
skli	skLi
sko	sku
skobutikk	skub3tik
skoene	skun3
skog	skug
skogsarbeid	skuksorbEi
skokrem	skukrem
skole	skul3
skolebarn	skul3bon
skolisse	skulis3
skomaker	skumok3r
skorpe	skorp3
skotsk	skotsk
skotte	skot3
skral	skrol
skrale	skrol3
skralle	skrol3
skrangle	skroNl3
skrante	skront3
skrape	skrop3
skratte	skrot3
skravle	skrovl3
skredder	skrEd3r
skrekkelig	skrEk3li
skrekkelige	skrEk3li3
skrekkeligere	skrEk3lir3
skrekkeligst	skrEk3likst
skrekkeligste	skrEk3likst3
skrekkslagen	skrEkSLog3n
skrelle	skrEl3
skremme	skrEm3
skrible	skribl3
skrift	skrift
skriftlig	skriftli
skriftlige	skriftli3
skriftligere	skriftlir3
skriftligst	skriftlikst
skriftligste	skriftlikst3
skrike	skrik3
skrinlegge	skrinlEi3
skrinn	skrin
skrive	skriv3
skrive opp	skriv3op
skrive ut	skriv33t
skrivesaker	skriv3sok3r
skrot	skrut
skru	skr3
skrubbe	skr3b3
skrubbsulten	skr3bs3lt3n
skrue	skr33
skrukkete	skruk3t3
skruppelløs	skr3p3les
skryt	skrit
skryte	skrit3
skrå	skro
skråle	skrol3
skråne	skron3
skrøne	skren3
skrøpelig	skrep3li
skrøpelige	skrep3li3
skrøpeligere	skrep3lir3
skrøpeligst	skrep3likst
skrøpeligste	skrep3likst3
skubbe	sk3b3
skue	sk33
skuespiller	sk33spil3r sk3w3spil3r
skuespillerinne	sk3spil3rin3 sk33spil3rin3
skuffet	sk3f3t
skulder	sk3ld3r
skulderveske	sk3ld3rvEsk3
skule	sk3l3
skulke	sk3lk3
skulle	sk3l3
skulptur	sk3lpt3r
skuls	sk3ls
skum	skum
skumlese	skumles3
skumme	skum3
skummel	sk3m3l
skumpe	skump3
skumre	skumr3
skumring	skumriN
skur	sk3r
skure	sk3r3
skurk	sk3rk
skurre	sk3r3
skute	sk3t3
skutt	sk3t
skvette	skvEt3
skvetten	skvEt3n
skvise	skvis3
skvulpe	skv3lp3
skvære	skvEr3
sky	Si
skyet	Si3t
skyfri	Sifri
skygge	Sig3
skyld	Sil
skylde	Sil3
skyldig	Sildi
skyldige	Sildi3
skyldigere	Sildir3
skyldigst	Sildikst
skyldigste	Sildikst3
skylle	Sil3
skynde	Sin3
skynde seg	Sin3sEi
skysse	Sis3
skyte	Sit3
skyve	Siv3
skål	skol
skålde	skol3
skåle	skol3
skåne	skon3
skånsom	skonsom
skøye	skEy3
skøyte	SEyt3
skøytebane	SEyt3bon3
sladder	SLod3r
sladre	SLodr3
slafse	SLofs3
slag	SLog
slaganfall	SLogonfol
slak	SLok
slakk	SLok
slakte	SLokt3
slakter	SLokt3r
slange	SLoN3
slank	SLoNk
slanke	SLoNk3
slapp	SLop
slappe	SLop3
slede	SLed3
slegge	SLEg3
sleip	SLEip
sleivete	SLEiv3t3
slekte	SLEkt3
slem	SLEm
slenge	SLEN3
slepe	SLep3
slepphendt	SLEphEnt
slett	SLEt
slette	SLEt3
slibrig	SLibri
slibrige	SLibri3
slibrigere	SLibrir3
slibrigst	SLibrikst
slibrigste	SLibrikst3
slik	SLik
slikke	SLik3
slipe	SLip3
slippe	SLip3
slips	slips
slite	SLit3
sliten	SLit3n
slitesterk	SLit3stErk
slitsom	SLitsom
slott	SLot
slovakisk	SLuvokisk
slovensk	SLuvensk
slu	SL3
sludde	SL3d3
sluke	SL3k3
slukke	SLuk3
slum	SL3m
slumre	SL3mr3
slumse	SLums3
sluntre	SL3ntr3
slurpe	SL3rp3
slurve	SL3rv3
sluse	SL3s3
slutt	SL3t
slutte	SL3t3
slynge	SLiN3
slå	SLo
slå på	SLopo
slående	SLo3n3
slåmaskin	SLomoSin
slåss	SLos
sløse	SLes3
sløv	SLev
sløve	SLev3
sløyd	SLEyd
sløyfe	SLEyf3
smadre	smodr3
smak	smok
smake	smok3
smakfull	smokf3l
smakløs	smokles
smal	smol
smart	smot
smatte	smot3
smekke	smEk3
smelle	smEl3
smelte	smElt3
smerte	smEt3
smi	smi
smibar	smibor
smidig	smidi
smidige	smidi3
smidigere	smidir3
smidigst	smidikst
smidigste	smidikst3
smigre	smigr3
smile	smil3
sminke	smiNk3
smiske	smisk3
smitte	smit3
smittsom	smitsom
smokk	smok
smug	sm3g
smugle	sm3gl3
smugling	sm3gliN
smuldre	sm3ldr3
smule	sm3l3
smyge	smig3
smykke	smik3
smågutt	smog3t
smågutter	smog3t3r
smålig	smoli
smålige	smoli3
småligere	smolir3
småligst	smolikst
småligste	smolikst3
småpike	smopik3
småting	smotiN
smør	smer
smørbrød	smErbre
smøre	smer3
snakke	snok3
snakkesalig	snok3soli
snakkesalige	snok3soli3
snakkesaligere	snok3solir3
snakkesaligst	snok3solikst
snakkesaligste	snok3solikst3
snappe	snop3
snar	snor
snare	snor3
snarrådig	snorodi
snarrådige	snorodi3
snarrådigere	snorodir3
snarrådigst	snorodikst
snarrådigste	snorodikst3
snart	snot
snarvei	snorvEi
snau	snE3
snegle	snEil3
sneie	snEi3
snekker	snEk3r
snekre	snEkr3
snelle	snEl3
snerpete	snErp3t3
snerre	snEr3
snerten	snEt3n
snever	snev3r
sneversynt	snev3Sint
snike	snik3
snill	snil
snitte	snit3
sno	snu
snodig	snudi
snodige	snudi3
snodigere	snudir3
snodigst	snudikst
snodigste	snudikst3
snorke	snork3
snorkel	snork3l
snu	sn3
snuble	sn3bl3
snue	sn33
snufse	sn3fs3
snurre	sn3r3
snus	sn3s
snuse	sn3s3
snylte	snilt3
snyte	snit3
snål	snol
snø	sne
snøbrett	snebrEt
snøre	sner3
snørrete	snEr3t3
snøvle	snEvl3
sofa	sufo
sofaen	sufon
sofaene	sufon3
sogne	soNn3
sokk	sok
sokkene	sokn3 sok3n3
sol	sul
sola	suro
solarium	sulori3m
solbeskyttelse	sulbESitEls3
solbrent	sulbrEnt
solbrenthet	sulbrEnthet
soldag	suldog
sole	sul3
soleklar	sul3klor
solhatt	sulhot
solid	sulid
solidarisk	sulidorisk
solist	sulist
solkrem	sulkrem
sololje	suloly3
solppgang	sulopgoN
solrikt	sulrikt
solskinn	sulSin
solstikk	sulstik
som	som
somle	suml3
sommer	som3r
sommerferie	som3rferi3
sommernatt	som3not
sommervarme	som3rvorm3
sone	sun3
sope	sup3
sopp	sop
sorg	sorg
sort	sot
sortere	suter3
sosial	susiol
sosialistisk	susiolistisk
sove	sov3
soverom	sov3rum
sovetablett	sov3toblEt
sovne	sovn3
spa	spo
spadd	spod
spadde	spod3
spak	spok
spalte	spolt3
spandabel	spondob3l
spandere	sponder3
spane	spon3
spansk	sponsk
spare	spor3
sparke	spork3
sparsom	spoSom
sparsommelighet	spoSomlihet
spartansk	spotonsk
spas	spos
spasere	sposer3
spasertur	sposet3r
spatel	spot3l
spe	spe
sped	spe
speil	spEil
speile	spEil3
speilvende	spEilvEn3
spekke	spEk3
spektakulær	sp3ktok3lEr
spekulativ	spEk3lotiv
spekulere	sp3k3ler3
spenne	spEn3
spennende	spEn3n3
spenning	spEniN
spenningsfilm	spEniNsfilm
spenstig	spEnsti
spenstige	spEnsti3
spenstigere	spEnstir3
spenstigst	spEnstikst
spenstigste	spEnstikst3
spent	spEnt
sperre	spEr3
spesialisere	sp3sioliser3
spesialist	spEsiolist
spesialitet	spEsiolitet
spesiell	sp3siEl
spesielt	spEsiElt
spesifikk	sp3sifik
spesifisere	sp3sifiser3
spielen	Spil3n
spiker	spik3r
spikke	spik3
spikre	spikr3
spill	spil
spille	spil3
spinat	spinot
spinkel	spiNk3l
spinne	spin3
spionere	spiuner3
spire	spir3
spirituell	spirit3El
spise	spis3
spisekart	spis3kot
spiselig	spis3li
spiselige	spis3li3
spiseligere	spis3lir3
spiseligst	spis3likst
spiseligste	spis3likst3
spiserør	spis3rer
spisesal	spis3sol
spiss	spis
spisse	spis3
spist	spist
spiste	spist3
spjære	spyEr3
spleis	splEis
spleise	splEis3
splitte	split3
spolere	spuler3
sponse	spons3
spontan	spunton
spor	spur
sporadisk	spurodisk
spore	spur3
sport	spot
sporte	spot3
sportslig	spotSLi
sportslige	spotSLi3
sportsligere	spotSLir3
sportsligst	spotSLikst
sportsligste	spotSLikst3
sporty	spoti
spotte	spot3
spraglete	sprogl3t3
sprake	sprok3
spraye	sproy3
spre	spre
spredt	sprEt
sprek	sprek
sprekk	sprEk
sprekke	sprEk3
sprelle	sprEl3
sprelsk	sprElsk
sprenge	sprEN3
sprette	sprEt3
spretten	sprEt3n
sprike	sprik3
springe	spriN3
sprinte	sprint3
sprudle	spr3dl3
sprute	spr3t3
språk	sprok
språklig	sprokli
språklige	sprokli3
språkligere	sproklir3
språkligst	sproklikst
språkligste	sproklikst3
sprø	spre
sprøyte	sprEyt3
spurte	sp3t3
spy	spi
spyd	spid
spydig	spidi
spydige	spidi3
spydigere	spidir3
spydigst	spidikst
spydigste	spidikst3
spyle	spil3
spytte	spit3
spå	spo
spøk	spek
spøke	spek3
spørre	spEr3
spørsmål	spESmol
sta	sto
stabbe	stob3
stabil	stobil
stabilisere	stobiliser3
stable	stobl3
stadig	stodi
stadige	stodi3
stadigere	stodir3
stadigst	stodikst
stadigste	stodikst3
stadion	stodiun
stagge	stog3
stagnere	stogner3
stakkars	stokoS
stakkarslig	stokoSLi
stakkarslige	stokoSLi3
stakkarsligere	stokoSLir3
stakkarsligst	stokoSLikst
stakkarsligste	stokoSLikst3
stamgjest	stomyEst
stamme	stom3
stampe	stomp3
stamvei	stomvEi
standard	stonor
standardisere	stonoriser3
standhaftig	stonhofti
standhaftige	stonhofti3
standhaftigere	stonhoftir3
standhaftigst	stonhoftikst
standhaftigste	stonhoftikst3
stange	stoN3
stanse	stons3
stappe	stop3
starte	stot3
startkabel	stotkob3l
startmotor	stotmutur
staselig	stos3li
staselige	stos3li3
staseligere	stos3lir3
staseligst	stos3likst
staseligste	stos3likst3
stasjon	stoSun
stasjonere	stoSuner3
stasjonær	stoSunEr
stat	stot
statisk	stotisk
statistisk	stotistisk
stativ	stotiv
statlig	stotli
statlige	stotli3
statligere	stotlir3
statligst	stotlikst
statligste	stotlikst3
statsminister	stotsminist3r
statue	stot33
statuere	stot3er3
staup	stEwp
staut	stE3t
stave	stov3
stavkirke	stovSirk3
stearinlys	stEorinlis
sted	sted
stehlen	Stel3n
steil	stEil
steile	stEil3
stein	stEin
steinete	stEin3t3
stekt	stekt
stelle	stEl3
stellebord	stEl3bur
stemme	stEm3
stemning	stEmniN
stempel	stEmp3l
stemple	stEmpl3
stempler	stEmp3l3r
stemplet	stEmp3l3
stenge	stEN3
stengt	stENt
stenografere	stEnugrofer3
steppe	stEp3
steril	st3ril
sterilisere	stEriliser3
sterk	stErk
sterkt	stEt stErkt
stevne	stEvn3
steward	sty33t
sti	sti
stien	stiyn
stier	stiy3r
stifte	stift3
stige	stig3
stige av	stig3ov
stige på	stig3po
stigmatisere	stigmotiser3
stigning	stigniN
stikke	stik3
stikkontakt	stikuntokt
stikkpille	stikpil3
stil	stil
stilig	stili
stilige	stili3
stiligere	stilir3
stiligst	stilikst
stiligste	stilikst3
stilistisk	stilistisk
stilk	stiLk
stille	stil3
stilleben	stileb3n
stillferdig	stilfEdi
stillferdige	stilfEdi3
stillferdigere	stilfEdir3
stillferdigst	stilfEdikst
stillferdigste	stilfEdikst3
stilne	stiln3
stilongs	stiloNs
stime	stim3
stimulere	stim3ler3
stinke	stiNk3
stinn	stin
stirre	stir3
stiv	stiv
stive	stiv3
stivere	stiv3r3
stivest	stiv3st
stivne	stivn3
stivt	stift
stjele	styel3
stjerne	styEn3
stoff	stof
stokke	stok3
stol	stul
stole	stul3
stolheis	stulhEis
stolpe	stolp3
stolt	stolt
stopp	stop
stoppe	stop3
stoppested	stop3sted
stor	stur
storarta	sturoto
storartet	sturoto
storm	storm
storme	storm3
stotre	stotr3
strabasiøs	strobosies
straff	strof
straffbar	strofbor
straffe	strof3
strak	strok
straks	stroks
stram	strom
stramme	strom3
strand	stron
strandsko	stronsku
strategisk	strotegisk
streife	strEif3
streike	strEik3
strekke	strEk3
strekker	strEk3r
strender	strEn3r
streng	strEN
streve	strev3
strevsom	strevsom
stri	stri
strid	strid
strigle	strigl3
strigråte	strigrot3
strikke	strik3
strikkejakke	strik3yok3
strikkhopping	strikhopiN
striks	striks
stripe	strip3
striper	strip3r
stripete	strip3t3
strippe	strip3
striregne	strirEin3
stritte	strit3
strofe	struf3
stromuttak	strEm3tok
struktur	str3kt3r
strukturere	str3kt3rer3
strupe	str3p3
struts	str3ts
strutte	str3t3
stryke	strik3
strå	stro
stråle	strol3
strø	stre
strøm	strEm
strømavgift	strEmovyift
strømme	strEm3
strømning	strEmniN
strømpe	strEmp3
strømspenning	strEmspEniN
stubbe	st3b3
student	st3dEnt
studere	st3der3
stue	st33
stum	st3m
stump	stump
stund	st3n
stupe	st3p3
stupid	st3pid
sture	st3r3
stuss	st3s
stusse	st3s3
stusslig	st3sli
stusslige	st3sli3
stussligere	st3slir3
stussligst	st3slikst
stussligste	st3slikst3
stygg	stig
stykke	stik3
styre	stir3
styrke	stirk3
styrmann	stirmon
styrte	stit3
stå	sto
stå i kø	stoike
stø	ste
stødig	stedi
stødige	stedi3
stødigere	stedir3
stødigst	stedikst
stødigste	stedikst3
støl	stel
stønne	stEn3
støpe	step3
størkne	stErkn3
størrelse	stEr3ls3
støte	stet3
støtfanger	stetfoN3r
støtte	stEt3
støv	stev
støvel	stEvl stEv3l
støvete	stev3t3
støy	stEy
subbe	s3b3
subjektiv	s3byiktiv
subsidiere	s3bsidier3
substantiv	s3bstontiv
substituere	s3pstit3er3
subtil	s3btil
subtrahere	s3btroher3
suge	s3g3
suggerere	s3g3rer3
sukke	s3k3
sukker	suk3r
sukre	sukr3
sulte	s3lt3
sulten	s3lt3n
sum	s3m
summe	s3m3
summere	s3mer3
sund	s3n
sunn	s3n
super	s3p3r
superb	s3pErb
suppe	s3p3
supplere	s3pler3
sur	s3r
surfe	sErf3
surfing	sErfiN
surkle	s3rkl3
surmule	s3rm3l3
surne	s3n3
surre	s3r3
surt	s3t
suse	s3s3
susete	s3s3t3
suspekt	s3spEkt
suspendere	s3spoNder3
sutre	s3tr3
sutrete	s3tr3t3
sutt	s3t
suveren	s3v3ren
suverenitet	s3v3rEnitet
svai	svEi
svaie	svoy3
svak	svok
sval	svol
svale	svol3
svane	svon3
svangerskap	svoN3Skop
svar	svor
svare	svor3
svare på	svor3po
svarer	svor3r
svart	svot
svartne	svotn3
sveipe	svEip3
sveis	svEis
sveise	svEis3
sveisen	svEis3n
sveitser	svEits3r
sveitsisk	svEitsisk
sveitsiske francs	svEitsisk3froN
sveive	svEiv3
svekke	svEk3
svekling	svEkliN
svelge	svElg3
svelle	svEl3
svensk	svEnsk
svenske	svEnsk3
sverd	svEd
sverge	svErg3
sverme	svErm3
sverte	svEt3
svett	svEt
svette	svEt3
sveve	svev3
svevende	svev3n3
svi	svi
svigerinne	svig3rin3
svike	svik3
svikefull	svik3f3l
svikte	svikt3
svime	svim3
svimle	sviml3
svimmel	svim3l
svimmelhet	svim3lhet
svindle	svinl3
svinekjøtt	svin3SEt
sving	sviN
svinge	sviN3
svinne	svin3
svinse	svins3
svippe	svip3
svir	svir
svirre	svir3
svoger	svog3r
svulme	sv3lm3
svulst	sv3lst
svulstig	sv3lsti
svulstige	sv3lsti3
svulstigere	sv3lstir3
svulstigst	sv3lstikst
svulstigste	sv3lstikst3
svær	svEr
svært	svEt
svømme	svEm3
svømmedyktig	svEm3dikti
svømmedyktige	svEm3dikti3
svømmedyktigere	svEm3diktir3
svømmedyktigst	svEm3diktikst
svømmedyktigste	svEm3diktikst3
svømmer	svEm3r
svøpe	svep3
sy	si
sydame	sidom3
sydd	sid
sydde	sid3
syde	sid3
sydlig	sidli
sydlige	sidli3
sydligere	sidlir3
sydligst	sidlikst
sydligste	sidlikst3
syk	sik
sykeattest	sik3otEst
sykehus	sik3h3s
sykekasse	sik3kos3
sykelig	sik3li
sykelige	sik3li3
sykeligere	sik3lir3
sykeligst	sik3likst
sykeligste	sik3likst3
sykepleier	sik3plEi3r
sykkel	sik3l
sykkelhjelm	sik3lyElm
sykkelsti	sik3lsti
sykkeltur	sik3lt3r
sykle	sikl3
sykt	sikt
sylindrisk	silindrisk
sylskarp	silskorp
sylte	silt3
symbol	simbul
symbolisere	simbuliser3
symbolsk	simbulsk
symfonisk	simfunisk
symmetrisk	simetrisk
sympatisere	simpotiser3
sympatisk	simpotisk
synd	sin
synde	sin3
syndig	sini
syndige	sini3
syndigere	sinir3
syndigst	sinikst
syndigste	sinikst3
syne	sin
synes	sin3s
synge	siN3
synger	siN3r
synke	siNk3
synkron	siNkrun
synkronisere	siNkruniser3
synlig	sinli
synlige	sinli3
synligere	sinlir3
synligst	sinlikst
synligste	sinlikst3
synonym	sinunim
synshemmet	sinshEm3t
synsk	sinsk
synspunkt	sinspuNt
syntetisk	sintetisk
syre	sir3
syrlig	siLi
syrlige	siLi3
syrligere	siLir3
syrligst	siLikst
syrligste	siLikst3
sysle	sisl3
sysselsette	sis3lsEt3
systematisere	sist3motiser3
systematisk	sist3motisk
syte	sit3
sytråd	sitro
sytten	sEt3nsit3n
sytti	siti sEti
syv	siv
så	so
så synd	sosin
såkalt	sokolt
såle	sol3
sånn	son
såpe	sop3
såpeopera	sop3up3ro
sår	sor
sårbar	sorbor
såre	sor3
såte	sot3
sær	sEr
særlig	sELi
særlige	sELi3
særligere	sELir3
særligst	sELikst
særligste	sELikst3
særprege	sErpreg3
særskilt	sErSilt
søke	sek3
søker	sek3r
søkkvåt	sEkvot
søknad	seknod
søkt	sekt
søle	sel3
sølete	sel3t3
sølv	sEl
sømme	sEm3
sømmelig	sEm3li
sømmelige	sEm3li3
sømmeligere	sEm3lir3
sømmeligst	sEm3likst
sømmeligste	sEm3likst3
søndag	sEndog
søndager	sEndog3r
sønderknust	sEn3rkn3st
sønn	sEn
søppel	sEp3l
søppelkasse	sEp3lkos3
søppeltønne	sEp3ltEn3
sør for	serfor
sørge	sErg3
sørgelig	sErg3li
sørgelige	sErg3li3
sørgeligere	sErg3lir3
sørgeligst	sErg3likst
sørgeligste	sErg3likst3
sørgmodig	sErgmudi
sørgmodige	sErgmudi3
sørgmodigere	sErgmudir3
sørgmodigst	sErgmudikst
sørgmodigste	sErgmudikst3
sørlig	seLi
sørlige	seLi3
sørligere	seLir3
sørligst	seLikst
sørligste	seLikst3
sørpe	sErp3
søster	sEst3r
søt	set
søtningsmiddel	setniNsmid3l
søvnig	sEvni
søvnige	sEvni3
søvnigere	sEvnir3
søvnigst	sEvnikst
søvnigste	sEvnikst3
søvnløshet	sEvnleshet
t-bane	tebon3
t-skjorte	teSut3
ta	to
ta avskjed	toovSed
ta bort	tobut
ta hensyn til	tohEnsintil
ta imot	toimut
ta med	tome
ta på	topo
ta på seg	toposEi
ta seg av	tosEiov
tabbe	tob3
tablett	toblEt
tak	tok
taka	toko
taket	tok3
takk	tok
takke	tok3
takknemlig	toknEmli
takknemlige	toknEmli3
takknemligere	toknEmlir3
takknemligst	toknEmlikst
takknemligste	toknEmlikst3
takle	tokl3
takluke	tokl3k3
taksere	tokser3
takst	tokst
takt	tokt
taktfast	toktfost
taktfull	toktf3l
taktisk	toktisk
taktløs	toktles
tale	tol3
talgkjertel	tolgSEt3l
talglys	tolglis
tall	tol
tallerken	tolErk3n
tallrik	tolrik
tam	tom
tander	ton3r
tang	toN
tange	toN3
tangere	toNger3
tango	toNgu
tank	toNk
tanke	toNk3
tanke opp	toNk3op
tankefull	toNk3f3l
tankeløs	toNk3les
tann	ton
tannbørste	tonbESt3 tombESt3
tannhjul	tony3l
tannkjøtt	tonSEt
tannkrem	tonkrem toNkrem
tannpirker	tonpirk3r
tanntråd	tontro
tannverk	tonvErk tomvErk
tante	tont3
tap	top
tape	tEip
tapetsere	top3tser3
tappe	top3
tapper	top3r
tarm	torm
tarvelig	torv3li
tarvelige	torv3li3
tarveligere	torv3lir3
tarveligst	torv3likst
tarveligste	torv3likst3
taske	tosk3
tasse	tos3
tatovere	totuver3
tau	tE3
taubane	tE3bon3
taue	tE33
taus	tEws
taushet	tE3shet
te	te
teater	tEotr tEot3r
teaterstykke	tEot3Stik3
teatralsk	tEotrolsk
tegn	tEin
tegne	tEin3
tegnefilm	tEin3film
tegneserie	tEin3seri3
tegning	tEiniN
tegnspråk	tEinsprok
teig	tEig
teit	tEit
tekkelig	tEk3li
tekkelige	tEk3li3
tekkeligere	tEk3lir3
tekkeligst	tEk3likst
tekkeligste	tEk3likst3
tekkes	tEk3s
tekniker	tEknik3r
teknisk	tEknisk
teknologi	t3knulugi
teknologisk	t3knulogisk
tekst	tEkst
tekste	tEkst3
tekstil	t3kstil
tele	tel3
telefaks	telEfoks
telefon	tElEfun
telefonere	tElEfuner3
telefonieren	tElEfonir3n
telefonkiosk	tElEfunSosk
telefonkort	tElEfunkot
telefonnummer	tElEfunum3r
telefonrør	tElEfunrer
telefonsvarer	tElEfunsvor3r
telegrafisk overføring	tElEgrofisk ov3rferiN
telegram	tElEgrom
teleks	telEks
telenor	tE3lnur te3lnur
teleobjektiv	telEubyEktiv
telepatisk	t3l3potisk
telle	tEl3
telt	tElt
telte	tElt3
temme	tEm3
temmelig	tEm3lig tEm3li
tempel	t3mp3l
temperatur	tEmp3rot3r
tempo	tEmpu
tenke	tENk3
tenke på	tENk3po
tenkte	tENt3 tENkt3
tenne	tEn3
tenning	tEniN
tennis	tEnis
tennisracket	tEnisrEk3t
tenåring	tEnoriN
teolog	t3ulog
teologisk	t3ulogisk
teoretisk	t3uretisk
tepose	tepus3
teppe	tEp3
terge	tErg3
terminal	tErminol
terpe	tErp3
terrasse	tEros3 tEros3
terrassere	tEroser3
terreng	terEN
terrengsykkel	tErEsik3l
terrorisere	tEruriser3
terroristisk	tEruristisk
terskel	tESk3l
tese	tes3
teskje	teSe
tess	tEs
teste	tEst3
tett	tEt
tette	tEt3
ti	ti
tid	tid
tidfeste	tidfEst3
tidlig	tili
tidlige	tili3
tidligere	tilir3
tidligst	tilikst
tidligste	tilikst3
tidsriktig	titsrikti
tidsriktige	titsrikti3
tidsriktigere	titsriktir3
tidsriktigst	titsriktikst
tidsriktigste	titsriktikst3
tidsskrift	titskrift
tie	ti3
tief	tif
tigge	tig3
tikke	tik3
til	til
til høyre	tilhEyr3
til sist	tilsist
til tross for	tiltrosfor
til venstre	tilvEnstr3
tilbake	tilbok3
tilbakeholden	tilbok3hol3n
tilbakelegge	tilbok3lEi3
tilbakereise	tilbok3rEise
tilbe	tilbe
tilberede	tilb3red3 tilbEred3
tilbringe	tilbriN3
tilbud	tilb3d
tilby	tilbi
tilbørlig	tilbeLi
tilbørlige	tilbeLi3
tilbørligere	tilbeLir3
tilbørligst	tilbeLikst
tilbørligste	tilbeLikst3
tilbøyelig	tilbEy3li
tilbøyelige	tilbEy3li3
tilbøyeligere	tilbEy3lir3
tilbøyeligst	tilbEy3likst
tilbøyeligste	tilbEy3likst3
tildele	tildel3
tilegne	tilEin3
tilfalle	tilfol3
tilfeldig	tilfEldi
tilfeldige	tilfEldi3
tilfeldigere	tilfEldir3
tilfeldighet	tilfEldihet
tilfeldigst	tilfEldikst
tilfeldigste	tilfEldikst3
tilfreds	tilfrEts
tilfredsstille	tilfr3tstil3
tilføre	tilfer3
tilføye	tilfEy3
tilgi	tilyi
tilgjengelig	tilyEN3li
tilgjengelige	tilyEN3li3
tilgjengeligere	tilyEN3lir3
tilgjengelighet	tilyEN3lihet
tilgjengeligst	tilyEN3likst
tilgjengeligste	tilyEN3likst3
tilgjort	tilyut
tilhenger	tilhEN3r
tilhøre	tilher3
tilhører	tilher3r
tilintetgjøre	tilint3tyer3
tilkalle	tilkol3
tilkjenne	tilSEn3
tilkjennegi	tilSEn3yi
tilkommende	tilkom3n3
tillate	tilot3
tillatelig	tilot3li
tillegg	tilEg
tillit	tilit
tillitsfull	tilitsf3l
tilnærmet	tilnErm3t
tilpasse	tilpos3
tilregnelig	tilrEin3li
tilregnelige	tilrEin3li3
tilregneligere	tilrEin3lir3
tilregneligst	tilrEin3likst
tilregneligste	tilrEin3likst3
tilråde	tilrod3
tilrådelig	tilrodli tilrod3li
tilrådelige	tilrod3li3
tilrådeligere	tilrod3lir3
tilrådeligst	tilrod3likst
tilrådeligste	tilrod3likst3
tilsette	tilsEt3
tilsi	tilsi
tilskuer	tilsk33r
tilstrekkelig	tilstrEk3li
tilstrekkelige	tilstrEk3li3
tilstrekkeligere	tilstrEk3lir3
tilstrekkeligst	tilstrEk3likst
tilstrekkeligste	tilstrEk3likst3
tilstå	tilsto
tilstøte	tilstet3
tilsvare	tilsvor3
tilsynelatende	tilsin3lot3n3
tilta	tilto
tiltale	tiltol3
tiltre	tiltre
tiltrekke	tiltrEk3
tiltro	tiltru
tiltru	tiltr3
tilvirke	tilvirk3
tilårskommen	tiloSkom3n
time	tim3
timian	timion
tindre	tindr3
tine	tin3
ting	tiN
tinge	tiN3
tinglyse	tiNlis3
tippe	tip3
tips	tips
tirre	tir3
tirsdag	tiSdog
tispe	tisp3
tistel	tist3l
titte	tit3
titulere	tit3ler3
tivoli	tivuli
tjafsete	Sofs3t3
tjene	tyen3
tjener	tyen3r
tjenerinne	tyen3rrin3
tjeneste	tyen3st3
tjue	S33
tjueen	S33En
tjuefem	S33fEm
tjueni	S33ni
tjueto	S33tu
tjuetre	S33tre
tjukk	S3k
tjære	SEr3
to	tu
toalett	tuolEt
toast	toust
tobakk	tubok
tobakksforretning	tuboksorEtniN
tog	tog
toget	tog3
togtjeneste	tugSenEst3
tohundre	tuh3ndr3
tolerant	tol3roN
tolerere	tol3rer3
tolke	tolk3
toll	tol
tollavgift	tolovyift
tolldeklarasjon	toldEkloroSun
tollfri	tolfri
tolv	tol
tom	tom
tomat	tumot
tomgang	tumgoN
tomhendt	tumhEnt
tomsete	tums3t3
tomsing	tumsiN
tomt	tomt
tone	tun3
toneangivende	tun3onyiv3n3
tonløs	tunles
topp	top
toppe	top3
tordenvær	t3dnvEr
tordne	tudn3
tordner	tudn3r
tore	tur3
torg	torg
tornete	tun3t3
toro	turu
torsdag	tuSdog
torturere	tut3rer3
tosk	tosk
total	tutol
totalitær	tutolitEr
tradisjonell	trodiSunEl
trafikk	trofik
trafikkere	trofiker3
trafikklys	trofiklitros
tragedie	trogedi3
tragisk	trogisk
trakassere	trokoser3
trakke	trok3
trakt	trokt
trakte	trokt3
tralle	trol3
trampe	tromp3
trang	troN
trangsynt	troNsint
transformere	tronsformer3
transparent	tronsporoN
transplantere	tronsplonter3
transportabel	tronspotob3l
transportere	tronspoter3
transseksuell	tronsEks33l
trapp	trop
trase	trose
traske	trosk3
trassig	trosi
trassige	trosi3
trassigere	trosir3
trassigst	trosikst
trassigste	trosikst3
traust	trE3st
trave	trov3
travel	trov3l
tre	tre
tredje	tredy3
tredve	trEdv3
treffe	trEf3
treffende	trEf3n3
treg	treg
trehundre	treh3ndr3
trekant	trekont
trekanta	trekont3t
trekantet	trekont3t
trekke	trEk3
trene	tren3
trener	tren3r
trenge	trEN3
trening	treniN
tresnitt	tresnit
trette	trEt3
tretten	trEt3n
trettende	trEt3n3
trettendedagen	trEt3n3dog3n
tretti	trEti
trettien	trEtien
trettito	trEtitu
trevl	trEvl
trikk	trik
trille	tril3
trillebår	tril3bor
trimme	trim3
trinn	trin
trio	triyu
trippe	trip3
trist	trist
triumfere	tri3mfer3
trivelig	triv3li
trivelige	triv3li3
triveligere	triv3lir3
triveligst	triv3likst
triveligste	triv3likst3
trives	triv3s
triviell	triviyEl
trivsel	trifs3l
tro	tru
troende	tru3n3
trofast	trufost
trolig	truli
trolige	truli3
troligere	trulir3
troligst	trulikst
troligste	trulikst3
trolle	trol3
trolsk	trolsk
troløs	trules
tromme	trum3
trommehinne	trum3hin3
trone	trun3
tropisk	trupisk
troskyldig	truSildi
troskyldige	truSildi3
troskyldigere	truSildir3
troskyldigst	truSildikst
troskyldigste	truSildikst3
trosse	tros3
troverdig	truvEdi
troverdige	truvEdi3
troverdigere	truvEdir3
troverdigst	truvEdikst
troverdigste	truvEdikst3
tru	tr3
true	tr33 tr3w3
trumf	trumf
truse	tr3s3
truseinnlegg	tr3s3inlEg
trussel	t3r3s3l
trygg	trig
trygge	trig3
trygle	trigl3
trykk	trik
trykke	trik3
trylle	tril3
tryne	trin3
trå	tro
tråd	tro
tråden	troon
tråder	troor
tråkke	trok3
tråkle	trokl3
trær	trEr
trøste	trEst3
trøtt	trEt
trøttende	trEt3n3
tufs	t3fs
tukte	t3kt3
tulle	t3l3
tullete	t3l3t3
tumle	tuml3
tun	tun
tung	tuN
tunge	tuN3
tungsindig	tuNsini
tungsindige	tuNsini3
tungsindigere	tuNsinir3
tungsindigst	tuNsinikst
tungsindigste	tuNsinikst3
tungvint	tuNvint
tunnel	t3n3l
tur	t3r
turbulent	t3rb3lEnt
turgåing	t3rgoiN
turist	t3rist
turistkontor	t3ristkuntur
turkart	t3rkot
turkis	t3rkis
turne	t3n3
turnsko	t3nsku
tursti	t3Sti
tusen	t3s3n
tusle	t3SL3
tussete	t3s3t3
tute	t3t3
tv	teve
tv-rom	teverum
tverr	tvEr
tvers gjennom	tv3Sy3num
tvetydig	tvetidi
tvetydige	tvetidi3
tvetydigere	tvetidir3
tvetydigst	tvetidikst
tvetydigste	tvetidikst3
tvile	tfil3 tvil3
tvilsom	tvilsom
tvinge	tviN3
tvinne	tvin3
tvungen	tvuN3n
tvære	tvEr3
ty	ti
tyde	tid3
tydelig	tid3li
tydelige	tid3li3
tydeligere	tid3lir3
tydeligst	tid3likst
tydeligste	tid3likst3
tygge	tig3
tyggis	tigis
tykk	tik
tykne	tikn3
tynge	tiN3
tynn	tin
type	tip3
typisk	tipisk
tyrannisere	tironiser3
tyrannisk	tironisk
tyrkisk	tirkisk
tysk	tisk
tysker	tisk3r
tyskland	tisklon
tyst	tist
tyste	tist3
tyte	tit3
tyv	tiv
tyve	tiv3
tyveri	tiv3ri
tå	to
tåke	tok3
tåkete	tok3t3
tåle	tol3
tålmodig	tolmudi
tålmodige	tolmudi3
tålmodigere	tolmudir3
tålmodighet	tolmudihEt
tålmodigst	tolmudikst
tålmodigste	tolmudikst3
tåpelig	top3li
tåpelige	top3li3
tåpeligere	top3lir3
tåpeligst	top3likst
tåpeligste	top3likst3
tåre	tor3
tårn	ton
tåte	tot3
tåteflaske	tot3flosk3
tære	tEr3
tø	te
tøff	tEf
tømme	tEm3
tømming	tEmiN
tømre	tEmr3
tørke	tErk3
tørketrommel	tErk3trum3l
tørr	tEr
tørre	tEr3
tørst	tESt
tørt	tEt
tørt hår	tEt hor
tøye	tEy3
tøyle	tEyl3
tøylesløs	tEyl3sles
tøyse	tEys3
tøysete	tEys3t3
uakseptabel	3oks3ptob3l
uaktsom	3oktsom
ualminnelig	3olmin3li
ualminnelige	3olmin3li3
ualminneligere	3olmin3lir3
ualminneligst	3olmin3likst
ualminneligste	3olmin3likst3
uanfekta	3onfEkt3t
uanfektet	3onfEkt3t
uansett	3onsEt
uanstendig	3onstEni
uanstendige	3onstEni3
uanstendigere	3onstEnir3
uanstendigst	3onstEnikst
uanstendigste	3onstEnikst3
uansvarlig	3onsvoLi
uansvarlige	3onsvoLi3
uansvarligere	3onsvoLir3
uansvarligst	3onsvoLikst
uansvarligste	3onsvoLikst3
uatskillelig	3otSil3li
uatskillelige	3otSil3li3
uatskilleligere	3otSil3lir3
uatskilleligst	3otSil3likst
uatskilleligste	3otSil3likst3
uavbrutt	3ovbr3t
uavgjort	3ovyut
uavhengig	3ovhENi
uavhengige	3ovhENi3
uavhengigere	3ovhENir3
uavhengigst	3ovhENikst
uavhengigste	3ovhENikst3
uavlatelig	3ovlot3li
uavlatelige	3ovlot3li3
uavlateligere	3ovlot3lir3
uavlateligst	3ovlot3likst
uavlateligste	3ovlot3likst3
uavsluttet	3ovSL3t3t
ubalansert	3boloNset
ubarmhjertig	3bormyEti
ubarmhjertige	3bormyEti3
ubarmhjertigere	3bormyEtir3
ubarmhjertigst	3bormyEtikst
ubarmhjertigste	3bormyEtikst3
ubebodd	3b3bud
ubegava	3b3gov3t
ubegavet	3b3gov3t
ubegrensa	3b3grEns3t
ubegrenset	3b3grEns3t
ubegripelig	3b3grip3li
ubegripelige	3b3grip3li3
ubegripeligere	3b3grip3lir3
ubegripeligst	3b3grip3likst
ubegripeligste	3b3grip3likst3
ubehagelig	3b3hog3li
ubehagelige	3b3hog3li3
ubehageligere	3b3hog3lir3
ubehageligst	3b3hog3likst
ubehageligste	3b3hog3likst3
ubekvem	3b3kvEm
ubeleilig	3b3lEili
ubeleilige	3b3lEili3
ubeleiligere	3b3lEilir3
ubeleiligst	3b3lEilikst
ubeleiligste	3b3lEilikst3
uberørt	3b3ret
ubestemt	3b3stEmt
ubetenksom	3b3tENksom
ubetinget	3bEtiN3t
ubetydelig	3betid3li
ubetydelige	3betid3li3
ubetydeligere	3betid3lir3
ubetydeligst	3betid3likst
ubetydeligste	3betid3likst3
ubevegelig	3b3veg3li
ubevegelige	3b3veg3li3
ubevegeligere	3b3veg3lir3
ubevegeligst	3b3veg3likst
ubevegeligste	3b3veg3likst3
ubevisst	3b3vist
ublu	3bl3
ubotelig	3but3li
ubotelige	3but3li3
uboteligere	3but3lir3
uboteligst	3but3likst
uboteligste	3but3likst3
ubrukbar	3br3kbor
ubrukelig	3br3k3li
ubrukelige	3br3k3li3
ubrukeligere	3br3k3lir3
ubrukeligst	3br3k3likst
ubrukeligste	3br3k3likst3
ubøyelig	3bEy3li
ubøyelige	3bEy3li3
ubøyeligere	3bEy3lir3
ubøyeligst	3bEy3likst
ubøyeligste	3bEy3likst3
udanna	3don3t
udannet	3don3t
udelt	3delt
udugelig	3d3g3li
udugelige	3d3g3li3
udugeligere	3d3g3lir3
udugeligst	3d3g3likst
udugeligste	3d3g3likst3
udødelig	3ded3li
udødelige	3ded3li3
udødeligere	3ded3lir3
udødeligst	3ded3likst
udødeligste	3ded3likst3
uegennyttig	3eg3niti
uegennyttige	3eg3niti3
uegennyttigere	3eg3nitir3
uegennyttigst	3eg3nitikst
uegennyttigste	3eg3nitikst3
uegnet	3Ein3t
uekte	3Ekt3
uendelig	3En3li
uendelige	3En3li3
uendeligere	3En3lir3
uendeligst	3En3likst
uendeligste	3En3likst3
uenig	3eni
uenige	3eni3
uenigere	3enir3
uenigst	3enikst
uenigste	3enikst3
uerstattelig	3EStot3li
uerstattelige	3EStot3li3
uerstatteligere	3EStot3lir3
uerstatteligst	3EStot3likst
uerstatteligste	3EStot3likst3
ufarlig	3foLi
ufarlige	3foLi3
ufarligere	3foLir3
ufarligst	3foLikst
ufarligste	3foLikst3
ufattelig	3fot3li
ufattelige	3fot3li3
ufatteligere	3fot3lir3
ufatteligst	3fot3likst
ufatteligste	3fot3likst3
ufin	3fin
uflidd	3flid
uforanderlig	3foron3li
uforanderlige	3foron3li3
uforanderligere	3foron3lir3
uforanderligst	3foron3likst
uforanderligste	3foron3likst3
uforbederlig	3forbed3Li
uforbederlige	3forbed3Li3
uforbederligere	3forbed3Lir3
uforbederligst	3forbed3Likst
uforbederligste	3forbed3Likst3
uforbeholden	3forb3hol3n
uforberedt	3forb3r3t
ufordragelig	3fodrog3li
ufordragelige	3fodrog3li3
ufordrageligere	3fodrog3lir3
ufordrageligst	3fodrog3likst
ufordrageligste	3fodrog3likst3
uforfalska	3forfolsko
uforfalsket	3forfolsk3t
uforglemmelig	3forglEm3li
uforglemmelige	3forglEm3li3
uforglemmeligere	3forglEm3lir3
uforglemmeligst	3forglEm3likst
uforglemmeligste	3forglEm3likst3
uforklarlig	3forkloLi
uforklarlige	3forkloLi3
uforklarligere	3forkloLir3
uforklarligst	3forkloLikst
uforklarligste	3forkloLikst3
uformelig	3form3li
uformelige	3form3li3
uformeligere	3form3lir3
uformeligst	3form3likst
uformeligste	3form3likst3
uformell	3formEl
uforpliktende	3forplikt3n3
uforsiktig	3foSikti
uforsiktige	3foSikti3
uforsiktigere	3foSiktir3
uforsiktigst	3foSiktikst
uforsiktigste	3foSiktikst3
uforskamma	3foSkom3t
uforskammet	3foSkom3t
uforskyldt	3foSilt
uforstandig	3foStoni
uforstandige	3foStoni3
uforstandigere	3foStonir3
uforstandigst	3foStonikst
uforstandigste	3foStonikst3
uforståelig	3foSto3li
uforståelige	3foSto3li3
uforståeligere	3foSto3lir3
uforståeligst	3foSto3likst
uforståeligste	3foSto3likst3
uforstående	3foSto3n3
uforsvarlig	3foSvoLi
uforsvarlige	3foSvoLi3
uforsvarligere	3foSvoLir3
uforsvarligst	3foSvoLikst
uforsvarligste	3foSvoLikst3
ufortrøden	3fotred3n
uforvarende	3forvor3n3
ufravikelig	3frovik3li
ufravikelige	3frovik3li3
ufravikeligere	3frovik3lir3
ufravikeligst	3frovik3likst
ufravikeligste	3frovik3likst3
ufri	3fri
ufullendt	3f3lEnt
ufullkommen	3f3lkom3n
ufullstendig	3f3lst3ni
ufullstendige	3f3lst3ni3
ufullstendigere	3f3lst3nir3
ufullstendigst	3f3lst3nikst
ufullstendigste	3f3lst3nikst3
ufyselig	3fis3li
ufyselige	3fis3li3
ufyseligere	3fis3lir3
ufyseligst	3fis3likst
ufyseligste	3fis3likst3
ufølsom	3felsom
ufør	3fer
ugift	3yift
ugjenkallelig	3y3nkol3li
ugjenkallelige	3y3nkol3li3
ugjenkalleligere	3y3nkol3lir3
ugjenkalleligst	3y3nkol3likst
ugjenkalleligste	3y3nkol3likst3
ugjennomtrengelig	3y3nomtrEN3li
ugjennomtrengelige	3y3nomtrEN3li3
ugjennomtrengeligere	3y3nomtrEN3lir3
ugjennomtrengeligst	3y3nomtrEN3likst
ugjennomtrengeligste	3y3nomtrEN3likst3
ugle	3gl3
ugyldig	3yildi
ugyldige	3yildi3
ugyldigere	3yildir3
ugyldigst	3yildikst
ugyldigste	3yildikst3
uhandterlig	3honteLi
uhandterlige	3honteLi3
uhandterligere	3honteLir3
uhandterligst	3honteLikst
uhandterligste	3honteLikst3
uhelbredelig	3h3lbred3li
uhelbredelige	3h3lbred3li3
uhelbredeligere	3h3lbred3lir3
uhelbredeligst	3h3lbred3likst
uhelbredeligste	3h3lbred3likst3
uheldig	3hEldi
uheldige	3hEldi3
uheldigere	3hEldir3
uheldigst	3hEldikst
uheldigste	3hEldikst3
uhell	3hEl
uholdbar	3holbor
uhorvelig	3horv3li
uhorvelige	3horv3lii3
uhorveligere	3horv3liir3
uhorveligst	3horv3liikst
uhorveligste	3horv3liikst3
uhumsk	3h3msk
uhyggelig	3hig3li
uhyggelige	3hig3li3
uhyggeligere	3hig3lir3
uhyggeligst	3hig3likst
uhyggeligste	3hig3likst3
uhyre	3hir3
uhåndterlig	3honteLi
uhåndterlige	3honteLi3
uhåndterligere	3honteLir3
uhåndterligst	3honteLikst
uhåndterligste	3honteLikst3
uhøflig	3hEfli
uhøflige	3hEfli3
uhøfligere	3hEflir3
uhøfligst	3hEflikst
uhøfligste	3hEflikst3
uhørt	3het
uidentifisert	3id3ntifiset
uimotståelig	3imutsto3li
uimotståelige	3imutsto3li3
uimotståeligere	3imutsto3lir3
uimotståeligst	3imutsto3likst
uimotståeligste	3imutsto3likst3
uimottakelig	3imutok3li
uimottakelige	3imutok3li3
uimottakeligere	3imutok3lir3
uimottakeligst	3imutok3likst
uimottakeligste	3imutok3likst3
uinteressert	3int3r3set
ujevn	3yEvn
uke	3k3
ukekort	3k3kot
ukentlig	3k3ntli
ukentlige	3k3ntli3
ukentligere	3k3ntlir3
ukentligst	3k3ntlikst
ukentligste	3k3ntlikst3
ukjent	3SEnt
uklanderlig	3klon3Li
uklanderlige	3klon3Li3
uklanderligere	3klon3Lir3
uklanderligst	3klon3Likst
uklanderligste	3klon3Likst3
uklar	3klor
ukrenkelig	3krENk3li
ukrenkelige	3krENk3li3
ukrenkeligere	3krENk3lir3
ukrenkeligst	3krENk3likst
ukrenkeligste	3krENk3likst3
ukritisk	3kritisk
ukuelig	3k33li
ukuelige	3k33li3
ukueligere	3k33lir3
ukueligst	3k33likst
ukueligste	3k33likst3
ulastelig	3lost3li
ulastelige	3lost3li3
ulasteligere	3lost3lir3
ulasteligst	3lost3likst
ulasteligste	3lost3likst3
ule	3l3
uleilig	3lEili
uleilige	3lEili3
uleiligere	3lEilir3
uleiligst	3lEilikst
uleiligste	3lEilikst3
ulempe	3lEmp3
ulendt	3lEnt
uleselig	3les3li
uleselige	3les3li3
uleseligere	3les3lir3
uleseligst	3les3likst
uleseligste	3les3likst3
ulidelig	3lid3li
ulidelige	3lid3li3
ulideligere	3lid3lir3
ulideligst	3lid3likst
ulideligste	3lid3likst3
ulik	3lik
ull	3l
ullen	3l3n
ullteppe	3ltEp3
ulme	3lm3
ulogisk	3lugisk
ulovlig	3lovli
ulovlige	3lovli3
ulovligere	3lovlir3
ulovligst	3lovlikst
ulovligste	3lovlikst3
ulydig	3lidi
ulydige	3lidi3
ulydigere	3lidir3
ulydigst	3lidikst
ulydigste	3lidikst3
ulykke	3lik3
ulykkelig	3lik3li
ulykkelige	3lik3li3
ulykkeligere	3lik3lir3
ulykkeligst	3lik3likst
ulykkeligste	3lik3likst3
ulykksalig	3liksoli
ulykksalige	3liksoli3
ulykksaligere	3liksolir3
ulykksaligst	3liksolikst
ulykksaligste	3liksolikst3
umake	3mok3
umedgjørlig	3medyeLi
umedgjørlige	3medyeLi3
umedgjørligere	3medyeLir3
umedgjørligst	3medyeLikst
umedgjørligste	3medyeLikst3
umenneskelig	3mEnsk3li
umenneskelige	3mEnsk3li3
umenneskeligere	3mEnsk3lir3
umenneskeligst	3mEnsk3likst
umenneskeligste	3mEnsk3likst3
umerkelig	3mErk3li
umerkelige	3mErk3li3
umerkeligere	3mErk3lir3
umerkeligst	3mErk3likst
umerkeligste	3mErk3likst3
umettelig	3mEt3li
umettelige	3mEt3li3
umetteligere	3mEt3lir3
umetteligst	3mEt3likst
umetteligste	3mEt3likst3
umiddelbar	3mid3lbor
umiskjennelig	3misSEn3li
umiskjennelige	3misSEn3li3
umiskjenneligere	3misSEn3lir3
umiskjenneligst	3misSEn3likst
umiskjenneligste	3misSEn3likst3
umistelig	3mist3li
umistelige	3mist3li3
umisteligere	3mist3lir3
umisteligst	3mist3likst
umisteligste	3mist3likst3
umoden	3mud3n
umoderne	3mudEn3
umoralsk	3murolsk
umulig	3m3li
umulige	3m3li3
umuligere	3m3lir3
umuligst	3m3likst
umuligste	3m3likst3
umyndig	3mini
umyndige	3mini3
umyndigere	3minir3
umyndigst	3minikst
umyndigste	3minikst3
unaturlig	3not3Li
unaturlige	3not3Li3
unaturligere	3not3Lir3
unaturligst	3not3Likst
unaturligste	3not3Likst3
und	ont
under	3n3r
underbukse	3n3rbuks3
underbygge	3n3rbig3
underdanig	3n3doni
underdanige	3n3doni3
underdanigere	3n3donir3
underdanigst	3n3donikst
underdanigste	3n3donikst3
underfundig	3n3rf3ni
underfundige	3n3rf3ni3
underfundigere	3n3rf3nir3
underfundigst	3n3rf3nikst
underfundigste	3n3rf3nikst3
undergrave	3n3rgrov3
underholde	3n3rhol3
underholdning	3n3rholniN
underkaste	3n3rkost3
underkjenne	3n3rSEn3
underkue	3n3rk33
underlegen	3n3Leg3n
underlig	3n3Li
underlige	3n3Li3
underligere	3n3Lir3
underligst	3n3Likst
underligste	3n3Likst3
underliv	3n3Liv
undermåls	3n3rmols
underrette	3n3rEt3
underskrift	3n3Skrift
underskrive	3n3Skriv3
underslå	3n3SLo
understreke	3n3Strek3
understøtte	3n3StEt3
undersøke	3n3Sek3
undersøkelse	3n3SekEls3
undertegne	3n3tEin3
undertittel	3n3tit3l
undertrykke	3n3trik3
undertrøye	3n3trEy3
undertøy	3n3tEy
undervannskamera	3n3rvonskomero
underveis	3nd3rvEis 3n3rvEis
undervise	3n3rvis3
undervurdere	3n3rv3der3
undre	3ndr3
undre seg	3ndr3sEi
undre seg over	3ndr3sEiov3r
unektelig	3nEkt3li
unektelige	3nEkt3li3
unekteligere	3nEkt3lir3
unekteligst	3nEkt3likst
unekteligste	3nEkt3likst3
ung	uN
ungdom	uNdom
ungdommelig	uNdom3li
ungdommelige	uNdom3li3
ungdommeligere	uNdom3lir3
ungdommeligst	uNdom3likst
ungdommeligste	uNdom3likst3
ungjente	uNyEnt3
ungkar	uNkor
ungmøy	uNmEy
ungnaut	uNnEwt
unik	3nik
unison	3nisun
universell	3nivESEl
universitet	3nivESitet
unndra	3ndro
unne	3n3
unnfange	3nfoN3
unngjelde	3nyEl3
unngå	3ngo
unnlate	3nlot3
unnskylde	3nSil3
unnskylde seg	3nSil3sEi
unnskyldning	3nSilniN
unnta	3nto
unntatt	3ntot
unnvikende	3nvik3n3
unnvære	3nvEr3
uns	ons
unyttig	3niti
unyttige	3niti3
unyttigere	3nitir3
unyttigst	3nitikst
unyttigste	3nitikst3
unødig	3nedi
unødige	3nedi3
unødigere	3nedir3
unødigst	3nedikst
unødigste	3nedikst3
unødvendig	3nEdvEni
unødvendige	3nEdvEni3
unødvendigere	3nEdvEnir3
unødvendigst	3nEdvEnikst
unødvendigste	3nEdvEnikst3
unøyaktig	3nEyokti
unøyaktige	3nEyokti3
unøyaktigere	3nEyoktir3
unøyaktigst	3nEyoktikst
unøyaktigste	3nEyoktikst3
uomtvistelig	3omtvist3li
uomtvistelige	3omtvist3li3
uomtvisteligere	3omtvist3lir3
uomtvisteligst	3omtvist3likst
uomtvisteligste	3omtvist3likst3
uoppdragen	3opdrog3n
uovervinnelig	3ov3rvin3li
uovervinnelige	3ov3rvin3li3
uovervinneligere	3ov3rvin3lir3
uovervinneligst	3ov3rvin3likst
uovervinneligste	3ov3rvin3likst3
upassende	3pos3n3
upersonlig	3pESunli
upersonlige	3pESunli3
upersonligere	3pESunlir3
upersonligst	3pESunlikst
upersonligste	3pESunlikst3
upopulær	3pup3lEr
upraktisk	3proktisk
upåklagelig	3poklog3li
upåklagelige	3poklog3li3
upåklageligere	3poklog3lir3
upåklageligst	3poklog3likst
upåklageligste	3poklog3likst3
upålitelig	3polit3li
upålitelige	3polit3li3
upåliteligere	3polit3lir3
upåliteligst	3polit3likst
upåliteligste	3polit3likst3
upåvirkelig	3povirk3li
upåvirkelige	3povirk3li3
upåvirkeligere	3povirk3lir3
upåvirkeligst	3povirk3likst
upåvirkeligste	3povirk3likst3
ur	3r
uransakelig	3ronsok3li
uransakelige	3ronsok3li3
uransakeligere	3ronsok3lir3
uransakeligst	3ronsok3likst
uransakeligste	3ronsok3likst3
urban	3rbon
uredd	3rEd
uredelig	3red3li
uredelige	3red3li3
uredeligere	3red3lir3
uredeligst	3red3likst
uredeligste	3red3likst3
uregelmessig	3reg3lmEsi
uregelmessige	3reg3lmEsi3
uregelmessigere	3reg3lmEsir3
uregelmessigst	3reg3lmEsikst
uregelmessigste	3reg3lmEsikst3
ureglementert	3rEil3m3ntet
urenslig	3renSLi
urenslige	3renSLi3
urensligere	3renSLir3
urensligst	3renSLikst
urensligste	3renSLikst3
urett	3rEt
urettferdig	3r3tfEdi
urettferdige	3r3tfEdi3
urettferdigere	3r3tfEdir3
urettferdigst	3r3tfEdikst
urettferdigste	3r3tfEdikst3
uriktig	3rikti
uriktige	3rikti3
uriktigere	3riktir3
uriktigst	3riktikst
uriktigste	3riktikst3
urimelig	3rimli 3rim3li
urimelige	3rim3li3
urimeligere	3rim3lir3
urimeligst	3rim3likst
urimeligste	3rim3likst3
urin	3rin
urmaker	3rmok3r
uro	3ru
uroe	3ru3
urokkelig	3rok3li
urokkelige	3rok3li3
urokkeligere	3rok3lir3
urokkeligst	3rok3likst
urokkeligste	3rok3likst3
urolig	3ruli
urolige	3ruli3
uroligere	3rulir3
uroligst	3rulikst
uroligste	3rulikst3
urter	3t3r
uryddig	3ridi
uryddige	3ridi3
uryddigere	3ridir3
uryddigst	3ridikst
uryddigste	3ridikst3
urørlig	3reLi
urørlige	3reLi3
urørligere	3reLir3
urørligst	3reLikst
urørligste	3reLikst3
usaklig	3sokli
usaklige	3sokli3
usakligere	3soklir3
usakligst	3soklikst
usakligste	3soklikst3
usann	3son
usannsynlig	3sonsinli
usannsynlige	3sonsinli3
usannsynligere	3sonsinlir3
usannsynligst	3sonsinlikst
usannsynligste	3sonsinlikst3
usedvanlig	3sEdvonli
usedvanlige	3sEdvonli3
usedvanligere	3sEdvonlir3
usedvanligst	3sEdvonlikst
usedvanligste	3sEdvonlikst3
usigelig	3sig3li
usigelige	3sig3li3
usigeligere	3sig3lir3
usigeligst	3sig3likst
usigeligste	3sig3likst3
usikker	3sik3r
usjenert	3S3net
uskadelig	3skod3li
uskadelige	3skod3li3
uskadeligere	3skod3lir3
uskadeligst	3skod3likst
uskadeligste	3skod3likst3
uskarp	3skorp
uskyld	3Sil
uskyldig	3Sildi
uskyldige	3Sildi3
uskyldigere	3Sildir3
uskyldigst	3Sildikst
uskyldigste	3Sildikst3
usmakelig	3smok3li
usmakelige	3smok3li3
usmakeligere	3smok3lir3
usmakeligst	3smok3likst
usmakeligste	3smok3likst3
ussel	3s3l
ustabil	3stobil
ustadig	3stodi
ustadige	3stodi3
ustadigere	3stodir3
ustadigst	3stodikst
ustadigste	3stodikst3
ustanselig	3stons3li
ustanselige	3stons3li3
ustanseligere	3stons3lir3
ustanseligst	3stons3likst
ustanseligste	3stons3likst3
ustelt	3stElt
ustyrlig	3stiLi
ustyrlige	3stiLi3
ustyrligere	3stiLir3
ustyrligst	3stiLikst
ustyrligste	3stiLikst3
ustyrtelig	3stit3li
ustyrtelige	3stit3li3
ustyrteligere	3stit3lir3
ustyrteligst	3stit3likst
ustyrteligste	3stit3likst3
ustø	3ste
usunn	3s3n
usynlig	3sinli
usynlige	3sinli3
usynligere	3sinlir3
usynligst	3sinlikst
usynligste	3sinlikst3
usystematisk	3sist3motisk
ut	3t
utakknemlig	3toknEmli
utakknemlige	3toknEmli3
utakknemligere	3toknEmlir3
utakknemligst	3toknEmlikst
utakknemligste	3toknEmlikst3
utallig	3toli
utallige	3toli3
utalligere	3tolir3
utalligst	3tolikst
utalligste	3tolikst3
utbasunere	3tboS3ner3
utbedre	3tbedr3
utbrent	3tbrEnt
utbryte	3tbrit3
utbytte	3tbit3
utdanne	3tdon3
utdannelse	3tdonEls3
utdanning	3tdoniN
utdype	3tdip3
utdødd	3tdEd
ute	3t3
utebli	3t3bli
utelate	3t3lot3
utelukke	3t3luk3
uten	3t3n 3tn
utendørs	3t3neS
utenfor	3t3nfor
utenforstående	3t3nfoSto3n3
utenlandsk	3t3nlonsk
utenlandssamtale	3t3nlonsomtol3
utenom	3t3num
utenpå	3t3npo
utenriks	3t3nriks
utenriksfly	3t3nriksfli
utflukt	3tfl3kt
utfolde	3tfol3
utfordre	3tfodr3
utfordrende	3tfodr3n3
utfordring	3tfodriN
utfore	3tfer3
utforske	3tfoSk3
utføre	3tfer3
utførlig	3tfeLi
utførlige	3tfeLi3
utførligere	3tfeLir3
utførligst	3tfeLikst
utførligste	3tfeLikst3
utgang	3tgoN
utgave	3tgov3
utgi	3tyi
utgift	3tyift
utgjøre	3tyer3
utheve	3thev3
utholdende	3thol3n3
utilgivelig	3tilyiv3li
utilgivelige	3tilyiv3li3
utilgiveligere	3tilyiv3lir3
utilgiveligst	3tilyiv3likst
utilgiveligste	3tilyiv3likst3
utilrådelig	3tilrodli
utilstrekkelig	3tilstrEk3li
utilstrekkelige	3tilstrEk3li3
utilstrekkeligere	3tilstrEk3lir3
utilstrekkeligst	3tilstrEk3likst
utilstrekkeligste	3tilstrEk3likst3
utkast	3tkost
utkjørt	3tSet
utland	3tlon
utlending	3tlEniN
utløpe	3tlep3
utløse	3tles3
utløser	3tles3r
utmerke	3tmErk3
utmerket	3tmErk3t
utnytte	3tnit3
utopisk	3tupisk
utpreget	3tpreg3t
utrede	3tred3
utreise	3trEis3
utrette	3trEt3
utrivelig	3triv3li
utrivelige	3triv3li3
utriveligere	3triv3lir3
utriveligst	3triv3likst
utriveligste	3triv3likst3
utrolig	3truli
utrolige	3truli3
utroligere	3trulir3
utroligst	3trulikst
utroligste	3trulikst3
utrydde	3trid3
utrygg	3trig
utsalg	3tsolg
utseende	3tse3n3
utsette	3tsEt3
utsikt	3tsikt
utsiktspunkt	3tsiktsp3Nt
utslett	3tSLEt
utslette	3tSLEt3
utspekulert	3tsp3k3let
utstilling	3tstiliN
utstillingsgjenstand	3tstiliNsyEnston
utstillingsvindu	3tstiliNsvin3
utstrakt	3tstrokt
utstyre	3tstir3
utstå	3tsto
utstøte	3tstet3
utsøkt	3tsekt
uttale	3tol3
uttrykk	3trik
uttrykke	3trik3
uttrykkelig	utrik3li
uttrykksløs	3triksles
uttømmende	3tEm3n3
utuktig	3t3kti
utuktige	3t3kti3
utuktigere	3t3ktir3
utuktigst	3t3ktikst
utuktigste	3t3ktikst3
utvalg	3tvolg
utvandre	3tvondr3
utveksle	3tvEkSL3
utvetydig	3tvEtidi
utvetydige	3tvEtidi3
utvetydigere	3tvEtidir3
utvetydigst	3tvEtidikst
utvetydigste	3tvEtidikst3
utvide	3tvid3
utvikle	3tvikl3
utvikling	3tvikliN
utvilsom	3tvilsom
utvise	3tvis3
utvortes	3tvut3s
utvungen	3tvuN3n
utydelig	3tid3li
utydelige	3tid3li3
utydeligere	3tid3lir3
utydeligst	3tid3likst
utydeligste	3tid3likst3
utålelig	3tol3li
utålelige	3tol3li3
utåleligere	3tol3lir3
utåleligst	3tol3likst
utåleligste	3tol3likst3
utålmodig	3tolmudi
utålmodige	3tolmudi3
utålmodigere	3tolmudir3
utålmodigst	3tolmudikst
utålmodigste	3tolmudikst3
utøve	3tev3
uunngåelig	33ngo3li
uunngåelige	33ngo3li3
uunngåeligere	33ngo3lir3
uunngåeligst	33ngo3likst
uunngåeligste	33ngo3likst3
uunnværlig	33nvELi
uunnværlige	33nvELi3
uunnværligere	33nvELir3
uunnværligst	33nvELikst
uunnværligste	33nvELikst3
uutgrunnelig	33tgr3n3li
uutgrunnelige	33tgr3n3li3
uutgrunneligere	33tgr3n3lir3
uutgrunneligst	33tgr3n3likst
uutgrunneligste	33tgr3n3likst3
uutholdelig	33thold3li
uutholdelige	33thold3li3
uutholdeligere	33thold3lir3
uutholdeligst	33thold3likst
uutholdeligste	33thold3likst3
uutslettelig	33tSLEt3li
uutslettelige	33tSLEt3li3
uutsletteligere	33tSLEt3lir3
uutsletteligst	33tSLEt3likst
uutsletteligste	33tSLEt3likst3
uvanlig	3vonli
uvanlige	3vonli3
uvanligere	3vonlir3
uvanligst	3vonlikst
uvanligste	3vonlikst3
uvant	3vont
uvedkommende	3vedkom3n3
uvel	3vEl
uvelkommen	3v3lkom3n
uvenn	3vEn
uventa	3vEnt3t
uventet	3vEnt3t
uverdig	3vEdi
uverdige	3vEdi3
uverdigere	3vEdir3
uverdigst	3vEdikst
uverdigste	3vEdikst3
uvesentlig	3ves3ntli
uvesentlige	3ves3ntli3
uvesentligere	3ves3ntlir3
uvesentligst	3ves3ntlikst
uvesentligste	3ves3ntlikst3
uvettig	3vEti
uvettige	3vEti3
uvettigere	3vEtir3
uvettigst	3vEtikst
uvettigste	3vEtikst3
uviktig	3vikti
uvilkårlig	3vilkoLi
uvilkårlige	3vilkoLi3
uvilkårligere	3vilkoLir3
uvilkårligst	3vilkoLikst
uvilkårligste	3vilkoLikst3
uvillig	3vili
uvillige	3vili3
uvilligere	3vilir3
uvilligst	3vilikst
uvilligste	3vilikst3
uviss	3vis
uvitende	3vit3n3
uvurderlig	3v3deLi
uvurderlige	3v3deLi3
uvurderligere	3v3deLir3
uvurderligst	3v3deLikst
uvurderligste	3v3deLikst3
uærlig	3ELi
uærlige	3ELi3
uærligere	3ELir3
uærligst	3ELikst
uærligste	3ELikst3
vade	vod3
vag	vog
vagge	vog3
vaie	voy3
vake	vok3
vaken	vok3n
vakker	vok3r
vakle	vokl3
vaklevoren	vokl3vur3n
vaksinasjon	voksinoSun
vaksinasjonsattest	voksinoSunsotEst
vaksinere	voksiner3
vakt	vokt
vaktskifte	voktSift3
valen	voln vol3n
valene	voln3
valfarte	volfot3
valg	volg
valgfri	volgfri
valgte	volkt3 volt3
valp	volp
valse	vols3
valuta	vol3to
vandalisere	vonoliser3
vandel	vond3l
vandre	vondr3
vandresti	vondr3sti
vanhellige	vonhEli3
vanilje	vonily3
vanke	voNk3
vanlig	vonli
vanlige	vonli3
vanligere	vonlir3
vanligst	vonlikst
vanligste	vonlikst3
vanmakt	vonmokt
vann	von
vanne	von3
vannfarge	vonforg3 vomforg3
vannforbruk	vonforbr3k
vannkanne	vonkon3
vannkran	vonkron
vannmelon	vonmElun
vannmerke	vonmErk3 vomErk3
vannrett	vonrEt
vannski	vonSi
vannskylling	vonSiliN
vanntett	vontEt
vansire	vonsir3
vanskapt	vonskopt
vanskelig	vonsk3li
vanskelige	vonsk3li3
vanskeligere	vonsk3lir3
vanskeligst	vonsk3likst
vanskeligste	vonsk3likst3
vanskjøtte	vonSEt3
vansmekte	vonsmEkt3
vant	vont
vante	vont3
vantrives	vontriv3s
vantro	vontru
vanvittig	vonviti
vanvittige	vonviti3
vanvittigere	vonvitir3
vanvittigst	vonvitikst
vanvittigste	vonvitikst3
vanære	vonEr3
var	vor
varde	vod3
vare	vor3
varehus	vor3h3s
varetektsfengsel	vor3tEktsfENs3l
variabel	voriob3l
variere	vorier3
variete	voriEte
varig	vori
varige	vori3
varigere	vorir3
varigst	vorikst
varigste	vorikst3
varm	vorm
varme	vorm3
varmebølge	vorm3bElg3
varmt	vormt
varmt vann	vormtvon
varsellys	voSElis
varsku	voSk3
varsle	voSL3
varsom	voSom
varte	vot3
vase	vos3
vask	vosk3n
vaske	vosk3
vaskemiddel	vosk3mid3l
vaskeri	vosk3ri
vaskerom	vosk3rum
vaskeservant	vosk3sErvont
vasse	vos3
vassen	vos3n
vasstrukken	vostruk3n
vatt	vot
ved	ve ved
ved hjelp av	vEyElpov
ved siden av	vEsid3nov
vedde	vEd3
vedgå	vedgo
vedkjenne	vedSEn3
vedkomme	vedkom3
vedlikeholde	vedlik3hol3
vedrøre	vedrer3
vedstå	vedsto
vedta	veto
vedvare	vedvor3
veg	vEi
vegetabilsk	v3g3tobilsk
vegetarisk	vEgEtorisk
vegg	vEg
vegre	vegr3
vei	vEi
veik	vEik
veikart	vEikot
veikro	vEikru
veilede	vEiled3
veiskilt	vEivis3r
veive	vEiv3
vekk	vEk
vekke	vEk3
veksle	vEkSL3
vekslepenger	vEkSL3pEN3r
veksling	vEkSLiN
vekt	vEkt
vektig	vEkti
vektige	vEkti3
vektigere	vEktir3
vektigst	vEktikst
vektigste	vEktikst3
vel	vEl
veldedig	v3ldedi
veldedige	v3ldedi3
veldedigere	v3ldedir3
veldedigst	v3ldedikst
veldedigste	v3ldedikst3
veldig	vEldi
veldige	vEldi3
veldigere	vEldir3
veldigst	vEldikst
veldigste	vEldikst3
velge	vElg3
velge ut	vElg33t
velkjent	vElSEnt
velkledd	vElklEd
velkommen	vElkom3n
vellykka	vEliko
vellykket	vElik3t
veloppdragen	vElopdrog3n
veloverveid	vElov3rvEid
velprøvd	vElprEvd
velsigne	v3lsiNn3
velsmakende	vElsmok3n3
velstelt	vElstElt
velstående	vElsto3n3
veltalende	vEltol3n3
velte	vElt3
velvalgt	vElvolkt
velvillig	v3lvili
velvillige	v3lvili3
velvilligere	v3lvilir3
velvilligst	v3lvilikst
velvilligste	v3lvilikst3
vemmelig	vEm3li
vemmelige	vEm3li3
vemmeligere	vEm3lir3
vemmeligst	vEm3likst
vemmeligste	vEm3likst3
vemmes	vEm3s
vemodig	v3mudi
vemodige	v3mudi3
vemodigere	v3mudir3
vemodigst	v3mudikst
vemodigste	v3mudikst3
ven	ven
vende	vEn3
venn	vEn
venninne	vEnin3
vennlig	vEnli
vennlige	vEnli3
vennligere	vEnlir3
vennligst	vEnlikst
vennligste	vEnlikst3
vennskap	vEnskop
vennskapelig	v3nskop3li
vennskapelige	v3nskop3li3
vennskapeligere	v3nskop3lir3
vennskapeligst	v3nskop3likst
vennskapeligste	v3nskop3likst3
venstre	vEnstr3
vente	vEnt3
venterom	vEnt3rum
ventilere	v3ntiler3
veps	vEps
veranda	vErondo
verb	vErb
verbal	vErbol
verd	vEd
verden	vEdn vEd3n
verdensmester	vEdnsmEst3r
verdi	vEdi
verdiangivelse	vEdionyivEls3
verdifull	vEdif3l
verdig	vEdi
verdige	vEdi3
verdigere	vEdir3
verdigst	vEdikst
verdigste	vEdikst3
verdiløs	vEdiles
verdisaker	vEdisok3r
verdsette	vEdsEt3
verdslig	vEdsli
verdslige	vEdsli3
verdsligere	vEdslir3
verdsligst	vEdslikst
verdsligste	vEdslikst3
verdt	vEt
verge	vErg3
verifisere	vErifiser3
verk	vErk
verke	vErk3
verksted	vErkste
verktøy	vErktEy
vern	vEn
verne	vEn3
verpe	vErp3
vers	vES
versere	vESer3
versjon	vESun
vert	vEt
vertikal	vEtikol
vertinne	vEtin3
vertshus	vEtsh3s
verve	vErv3
vesentlig	ves3ntli
vesentlige	ves3ntli3
vesentligere	ves3ntlir3
vesentligst	ves3ntlikst
vesentligste	ves3ntlikst3
veske	vEsk3
vesle	vESL3
vesper	vEsp3r
vest	vEst
vestlig	vEstli
vestlige	vEstli3
vestligere	vEstlir3
vestligst	vEstlikst
vestligste	vEstlikst3
veterinær	v3trinEr
vett	vEt
vettskremt	vEtskrEmt
veve	vev3
vi	vi
vibrere	vibrer3
vid	vi
videofilm	vidEufilm
videokassett	vidEukosEt
videospiller	vidEuspil3r
vidkun	vidk3n
vidstrakt	vidstrokt
vidsynt	vidsint
vidunderlig	vid3n3Li
vidunderlige	vid3n3Li3
vidunderligere	vid3n3Lir3
vidunderligst	vid3n3Likst
vidunderligste	vid3n3Likst3
vie	vi3
vifte	vift3
vik	vik
vika	viko
vikariere	vikorier3
vikene	vikn3
viker	vik3r
vikle	vikl3
viktig	vikti
viktige	vikti3
viktigere	viktir3
viktigst	viktikst
viktigste	viktikst3
vilkårlig	vilkoLi
vilkårlige	vilkoLi3
vilkårligere	vilkoLir3
vilkårligst	vilkoLikst
vilkårligste	vilkoLikst3
vill	vil
villa	vilo
ville	vil3
ville gjerne	vil3yEn3
villede	viled3
villig	vili
villige	vili3
villigere	vilir3
villigst	vilikst
villigste	vilikst3
vilter	vilt3r
vimsete	vims3t3
vin	vin
vind	vin
vindretning	vinrEtniN
vindrue	vindr33
vindstille	vinstil3
vindstyrke	vinstirk3
vindu	vin3
vindusvisker	vin3svisk3r
vinge	viN3
vinglete	viNl3t3
vinke	viNk3
vinker	viNk3r
vinne	vin3
vinter	vint3r
vinterdekk	vint3dEk
vinterhage	vint3rhog3
vinterlig	vint3Li
vinterlige	vint3Li3
vinterligere	vint3Lir3
vinterligst	vint3Likst
vinterligste	vint3Likst3
vippe	vip3
viril	viril
virke	virk3
virkedag	virk3dog
virkelig	virk3li
virkelige	virk3li3
virkeligere	virk3lir3
virkeligst	virk3likst
virkeligste	virk3likst3
virkningsfull	virkniNsf3l
virksom	virksom
virksomhet	virksomhet
virre	vir3
virus	vir3s
virvle	virvl3
vis	vis
vise	vis3
visittid	visiti
visjonær	viSunEr
viske	visk3
visne	visn3
vispe	visp3
vissen	vis3n
vist	vist
viste	vist3
visuell	vis3El
visum	vis3m
vital	vitol
vite	vit3
vitebegjærlig	vit3b3yELi
vitebegjærlige	vit3b3yELi3
vitebegjærligere	vit3b3yELir3
vitebegjærligst	vit3b3yELikst
vitebegjærligste	vit3b3yELikst3
vitenskap	vitnskop vit3nskop
vitne	vitn3
vits	vits
vittig	viti
vittige	viti3
vittigere	vitir3
vittighet	vitihet
vittigst	vitikst
vittigste	vitikst3
vodka	vodko
vognnummer	voNnum3r
vokal	vukol
voks	voks
vokse	voks3
voksen	voks3n
vokslys	vokslis
voksne	voksn3
vokstavle	vokstovl3
vokte	vokt3
vold	vol
volde	vol3
voldelig	vold3li
voldelige	vold3li3
voldeligere	vold3lir3
voldeligst	vold3likst
voldeligste	vold3likst3
voldsom	volsom
voldta	volto
voldtekt	volt3kt
vond	vun
vordende	vod3n3
votere	vuter3
vott	vot
vrake	vrok3
vrakt	vrokt
vrakte	vrokt3
vralte	vrolt3
vrang	vroN
vrenge	vrEN3
vri	vri
vrien	vri3n
vrikke	vrik3
vrimle	vriml3
vrinske	vrinsk3
vræle	vrEl3
vrøvl	vrEvl
vrøvle	vrEvl3
vugge	v3g3
vulgær	v3lgEr
vulkan	v3lkon
vulkansk	v3lkonsk
vurdere	v3der3
vågal	vogol
våge	vog3
våken	vok3n
våkne	vokn3
våpen	vop3n vopn
vår	vor
vårdag	vodog
vårlig	vor
vårluft	voL3ft
vårnatt	vonot
vårsol	voSuL
vårtegn	votEyn
våse	vos3
våt	vot
vått	vot
væpne	vEpn3
vær	vEr
være	vEr3
være for	ovEr3for
være mot	ovEr3mut
være til overs	vEr3tilov3S
værelse	vErEls3
værmelding	vEmEliN
væromslag	vEromSLog
væske	vEsk3
væte	vet3
watt	vot
ydmyk	idmik
ydmyke	idmik3
ymse	ims3
ymte	imt3
ynde	ind3
yndig	ini
yndige	ini3
yndigere	inir3
yndigst	inikst
yndigste	inikst3
yndling	inliN
yngle	iNl3
yngre	iNr3
ynkelig	iNk3li
ynkelige	iNk3li3
ynkeligere	iNk3lir3
ynkeligst	iNk3likst
ynkeligste	iNk3likst3
yoga	yogo
yppe	ip3
ypperlig	ip3Li
ypperlige	ip3Li3
ypperligere	ip3Lir3
ypperligst	ip3Likst
ypperligste	ip3Likst3
ypperst	ip3St
yppig	ipi
yppige	ipi3
yppigere	ipir3
yppigst	ipikst
yppigste	ipikst3
yr	ir
yre	ir3
yrke	irk3
yste	ist3
ytre	itr3
ytterligere	it3Li3r3
yttertak	it3tok
zaire	soir3
zappe	sop3
å	o
åker	ok3r
ål	ol
åle	ol3
ålen	oon
åler	ol3r
ånd	on
ånde	on3
åndelig	on3li
åndelige	on3li3
åndeligere	on3lir3
åndeligst	on3likst
åndeligste	on3likst3
åndsfraværende	onsfrovEr3n3
åndsnærværende	onsnErvEr3n3
åndsverk	onsvErk
åpen	op3n
åpenbar	op3nbor
åpenbare	op3nbor3
åpenhjertig	op3nyEti
åpenhjertige	op3nyEti3
åpenhjertigere	op3nyEtir3
åpenhjertigst	op3nyEtikst
åpenhjertigste	op3nyEtikst3
åpenlys	op3nlis
åpne	opn3
åpner	opn3r
åpnet	opn3t
åpningstider	opniNstid3r
år	or
åre	or3
årlig	oLi
årlige	oLi3
årligere	oLir3
årligst	oLikst
årligste	oLikst3
årsak	oSok
årstid	oSti
årvåken	orvok3n
åtte	ot3
ære	Er3
ærekrenke	Er3krENk3
ærlig	ELi
ærlige	ELi3
ærligere	ELir3
ærligst	ELikst
ærligste	ELikst3
ærverdig	ErvEdi
ærverdige	ErvEdi3
ærverdigere	ErvEdir3
ærverdigst	ErvEdikst
ærverdigste	ErvEdikst3
én	en
øde	ed3
ødelagt	ed3lokt
ødelegge	ed3lEi3
ødsle	Etsl3
øke	ek3
økologisk	Ekulogisk
økonomi	Ekunumi
økonomisk	Ekunumisk
øl	El
øm	Em
ømfintlig	Emfintli
ømfintlige	Emfintli3
ømfintligere	Emfintlir3
ømfintligst	Emfintlikst
ømfintligste	Emfintlikst3
ønske	Ensk3
ønskelig	Ensk3li
ønskelige	Ensk3li3
ønskeligere	Ensk3lir3
ønskeligst	Ensk3likst
ønskeligste	Ensk3likst3
ør	er
øre	er3
ørebetennelse	er3bEtEnEls3
øredøvende	er3dev3n3
øremerke	er3mErk3
ørering	er3riN
ørken	Erkn Erk3n
ørliten	eLit3n
ørske	ESk3
øse	es3
østerriker	Est3rik3r
østerriksk	Est3riksk
østers	Est3S
østlig	Estli
østlige	Estli3
østligere	Estlir3
østligst	Estlikst
østligste	Estlikst3
øve	ev3
øvelse	ev3ls3
øvre stasjon	Evr3stoSun
øvrig	evri
øvrige	evri3
øvrigere	evrir3
øvrigst	evrikst
øvrigste	evrikst3
øy	Ey
øye	Ey3
øyeblikk	Ey3blik
