a da mek	adamek
a farin	afarin
a hen ina iself	aheninaiself
a konchri	akontSri
a wa mek	awamek
a yaad	ayad
aaba	aba
aad	ad
aad fi	adfi
aad iez	ad iez
aadiens	adiens
aaf	af
aafwe chrii	afwetSri
aagan	agan
aaganizieshan	aganiziESan
aaganizm	aganizm
aagas	agas
aagiment	agiment
aajentiina	adZentina
aakid	akid
aal	al
aal a dem	aladem
aal di taim	alditaim
aalmuos	almuos
aalwiez	alwiEz
aarait	arait
aaredi	aredi
aas	as
aas-riesin	asriEsin
aat	at
aata	ata
aatagrafi	atagrafi
aatiek	atiEk
aatis	atis
aawez	awez
aazwiez	azwiEz
ab	ab
abee	abe
abraad	abrad
achrakshan	atSrakSan
achribyut	atSribyut
ada	ada
adaels	adaels
adaels ieria	adaels iEria
adawaiz	adawaiz
adminischrietiv	administSriEtiv
advokiet	advokiEt
afrika	afrika
afta	afta
agen	agen
agrikolcha	agrikoltSa
agrikolcharal	agrikoltSaral
agyu	aTu
agyu se	aTuse
ahn	a*
ai	ai
ai skuul	aiskul
aida	aida
aidentifai	aidentifai
aidentifai az	aidentifaiaz
aidentifai wid	aidentifaiwid
aidentiti	aidentiti
aidie	aidie
aigl	aigl
aijrosfier	aidZrosfiEr
ail	ail
ailan	ailan
ailant	ailant
airilan	airilan
airish	airiS
airish pitieta	airiS pitiEta
ais	ais
aiskriim	aiskrim
aisoliet	aisoliEt
ait	ait
aiyan	aiyan
aizak	aizak
ajres	adZres
aki	aki
aki ahn saalfish	aki a* salfiS
akliem	akliEm
aknalij	aknalidZ
akraas	akras
aktivis	aktivis
aktuoba	aktuoba
ala	ala
alaiv	alaiv
alayans	alayans
alduo	alduo
aligeta	aligeta
aligeta pier	aligeta piEr
aligzanda	aligzanda
aliv	aliv
amfisbiinyan	amfisbi5an
amtan	amtan
an	an
ana	ana
anarebl	anarebl
anda	anda
andastan	andastan
aneda	aneda
anju	andZu
anlain	anlain
anles	anles
anmigl	anmigl
ansa	ansa
ansofistikietid	ansofistikiEtid
antiiga ahn baabyuuda	antiga a* babyuda
anuova	anuova
anuova parish	anuova pariS
apaat	apat
apaint	apaint
api	api
apier	apiEr
apl	apl
aplai	aplai
apm	apm
aprishiet	apriSiEt
apruoch	apruotS
apruuv	apruv
ar	ar
ar els	arels
aredi	aredi
arinj	arindZ
asaalt	asalt
aschranami	astSranami
aschranomi	astSranomi
aschrielia	astSriElya
askaadn	askadn
askaadn tu	askadn tu
aspital	aspital
at	at
atlantik uoshan	atlantik uoSan
atletix	atletiks
atmosfier	atmosfiEr
aul	aul
avielobl	aviElobl
ax	aks
axep	aksep
axtiel	akstiEl
aya	aya
azwel	azwel
baaba	baba
baabiedoz	babiEdoz
baagin	bagin
baal	bal
baan	ban
baara	bara
baas	bas
baaskitbaal	baskitbal
baat	bat
baazli	bazli
bad	bad
bada	bada
badarieshan	badariESan
badi	badi
badman	badman
bai	bai
baik	baik
bailoji	bailodZi
bait	bait
baka bush	baka buS
bakbuon	bakbuon
bakl	bakl
bami	bami
ban	ban
banaana	banana
baptis	baptis
batam	batam
batn	batn
baul	baul
bax	baks
baxin	baksin
baya	baia
bayagrafi	bayagrafi
bayosfier	bayosfiEr
beg yu	beg yu
bekaa	beka
bel	bel
beli	beli
ben	ben
bex	beks
bie	biE
biebi	biEbi
bied	biEd
biefies	biEfiEs
biej	biEdZ
biek	biEk
bier	biEr
bies	biEs
bies pahn	biEs pa*
biesik	biEsik
biesin	biEsin
biev	biEv
bifuo	bifuo
bifuor	bifuor
bifuotaim	bifuotaim
bifuotaim piipl	bifuotaim pipl
bigop	bigop
biif	bil
biini	bini
bikaazn	bikazn
bil	bil
bil pahn	bilpa*
bilang	bilaN
biyain	biyain
bizniz	bizniz
blai	blai
blak	blak
blak pepa	blak pepa
blak riva	blakriva
blingki	bliNki
bluu	blu
bod	bod
bokl	bokl
bon	bon
bongjri	boNdZri
bongx	boNks
bot	bot
bota	bota
botn	botn
bou	bou
bout	bout
braad	brad
braatopsi	bratopsi
brazil	brazil
bred	bred
breda	breda
bredfruut	bredfrut
brejrin	bredZrin
briekop	briEkop
briev	briEv
bring tigeda	briN tigeda
bringgl	briNgl
britn	britn
brok	brok
broun	broun
bruus	brus
buk	buk
bulfraag	bulfrag
buod	buod
buod a chostii	buodatSosti
buodn skuul	buodn skul
buot	buot
buut	but
bwai	bwai
bwai pikni	bwai pikni
bwail	bwail
byuuti	byuti
chaaj	tSadZ
chaaklit	tSaklit
chaaklit chrii	tSaklit tSri
chaali	tSali
chaina	tSaina
chais	tSais
chaka-chaka	tSakatSaka
chat	tSat
cheri	tSeri
ches	tSes
chichi	tSitSi
chienj	tSiEndZ
chiiz	tSiz
chikin	tSikin
cho	tSo
chobl	tSobl
choch	tSotS
chokcha	tSoktSa
chos	tSos
chostii	tSosti
chrabl	tSrabl
chradishan	tSradiSan
chrai	tSrai
chrai fi	tSraifi
chrajidi	tSradZidi
chrang	tSraN
chranzfaam	tSranzfam
chranzishan	tSranziSan
chranzishan piiriad	tSranziSan piriad
chranznashinal	tSranznaSinal
chrap	tSrap
chrapik	tSrapik
chrapikal	tSrapikal
chrech	tSretS
chrecha	tSretSa
chrent	tSrent
chretn	tSretn
chried	tSriEd
chrien	tSriEn
chrienin	tSriEnin
chrienja	tSriEndZa
chriet	tSriEt
chrii	tSri
chriit	tSrit
chriiti	tSriti
chrik	tSrik
chrikifai	tSrikifai
chrilaani	tSrilani
chrinidad ahn tubiego	tSrinidad a* tubiEgo
chrompit	tSrompit
chruu	tSru
chuocho	tSuotSo
chuochuo	tSuotSuo
chupid	tSupid
chuu	tSu
chuu-chuu	tSutSu
chuuhout	tSuhout
chuun	tSun
chuut	tSut
chuuz	tSuz
daa	da
daag	dag
daans	dans
daata	data
dailuut	dailut
dainasuor	dainasuor
dairek	dairek
dala	dala
daminiika	daminika
daminikan ripoblik	daminikan ripoblik
danal	danal
dangki	daNki
darati	darati
dash	daS
dash awie	daS awiE
dashiin	daSin
dat	dat
dat a chuu	datatSu
dat-de	datde
dayalek	dayalek
dayaspora	dayaspora
dayatishan	dayatiSan
de	de
debl	debl
ded	ded
definishan	definiSan
dehn	de*
dehn kaali	de* kali
dekied	dekiEd
dem	dem
dem-de	demde
dem-ya	demya
demakrasi	demakrasi
dep	dep
derik	derik
deso	deso
dezat	dezat
di	di
di grietis	digriEtis
di muos	dimuos
di piiplz ripoblik a chaina	di piplz ripoblik a tSaina
di uol a dem	diwuola dem
di wes indiiz	diwesindiz
dibiet	dibiEt
die	diE
dieli	diEli
dievid	diEvid
difiit	difit
difikolti	difikolti
difrahn	difra*
difrans	difrans
digrii	digri
diil	dil
diil wid	dil wid
diklier	dikliEr
diktieta	diktiEta
diktietaship	diktiEtaSip
dimokratizieshan	dimokratiziESan
dipaacha	dipatSa
dipen	dipen
dipen pan	dipen pan
dis	dis
dis-ya	disya
disaid	disaid
disaya	disaya
dischribyuushan	distSribyuSan
disemba	disemba
disendant	disendant
disepshos	disepSos
disgostid	disgostid
diskovri bie	diskovribiE
distingshan	distiNSan
ditiel	ditiEl
divaid	divaid
dizain	dizain
dizain fi	dizainfi
dizort	dizort
domestikieshan	domestikiESan
domplin	domplin
dong	doN
dopi	dopi
dos	dos
doti	doti
doti op	dotiop
dout	dout
drop a grong	dropagroN
dukunu	dukunu
duo	duo
duohn	duo*
duor	duor
dwiit	dwit
dyuu	dyu
ebi	ebi
ebi die	ebi diE
ebn	ebn
ebri	ebri
ebribadi	ebribadi
ebriting	ebritiN
ed a stiet	edastiEt
edikieshan	edikiESan
edita	edita
edwad	edwad
ef	ef
egvaantij	egvantidZ
egzakli	egzakli
egzamin	egzamin
egzampl	egzampl
egzis	egzis
eliat	eliat
eliment	eliment
elivieta	eliviEta
elp	elp
elswe	elswe
en	en
enaji	enadZi
eni	eni
enibadi	enibadi
eniebl	eniEbl
enitaim	enitaim
eniwiez	eniwiEz
entapraiz	entapraiz
eritij	eritidZ
esn	esn
evidens	evidens
evri	evri
exchienj	ekstSiEndZ
exchriim	ekstSrim
exepshan	eksepSan
exkiep	ekskiEp
exkluudn	ekskludn
expanshan	ekspanSan
expiriens	ekspiriEns
expuot	ekspuot
extablish	ekstabli
extingk	ekstiNk
faada	fada
faal	fal
faal dong	fal doN
faal ina lob	fal ina lob
faam	fam
faama	fama
faamat	famat
faar	far
faas	fas
faatifikieshan	fatifikiESan
fagivnis	fagivnis
faib	faib
fain	fain
fainal	fainal
faiya	faiya
faiya bon	faiya bon
faiyaman	faiyaman
fak	fak
fala	fala
falara	falara
falarin	falarin
falmot	falmot
fambli	fambli
farin	farin
farina	farina
fasilitiet	fasilitiEt
faya	faya
febiweri	febiweri
feda	feda
feminis	feminis
feminizim	feminizim
fene	fene
fens	fens
fi	fi
fi chuu	fitSu
fi mi	fimi
fi paapos	fipapos
fi touzn a ier	fitouzn a iEr
fiemos	fiEmos
fies	fiEs
fiesti	fiEsti
fiet	fiEt
fieva	fieva
fif	fif
fiftiin	fiftin
figa	figa
figat	figat
fiicha	fitSa
fiil	fil
fiimiel	fimiEl
fiiva	fiva
fikshan	fikSan
filasafi	filasafi
filipiinz	filipinz
finaminan	finaminan
finanshal	finanSal
fingga	fiNga
fingga-hed	fiNgahed
fiziolaji	fizioladZi
fizishan	fiziSan
fizix	fiziks
flai	flai
flieva	fliEva
flim	flim
flod	flod
flowa	flowa
fluor	fluor
fongkshan	foNkSan
foris	foris
form	form
fos	fos
foul	foul
fraag	frag
frahn	fra*
frai	frai
frai domplin	frai domplin
frai plaan	frai plan
fraitn	fraitn
frans	frans
frenship	frenSip
fruut	frut
fruut juus	frut dZus
fufu	fufu
ful	ful
fuo	fuo
fuokos	fuokos
fuos	fuos
fuot	fuot
fuotiin	fuotin
fut	fut
futbaal	futbal
fuud	fud
fyuil	fyuil
fyuu	fyu
galang	galaN
gens	gens
get apaint	get apaint
get bex	get beks
get hextingk	get hekstiNk
gien	giEn
giet	giEt
ginep	ginep
gluobal	gluobal
go a farin	goafarin
gobna	gobna
gobna-jinaral	gobnadZinaral
goli	goli
golibl	golibl
gon	gon
govament	govament
graasapa	grasapa
grampierans	grampiErans
griep	griEp
griet	griEt
grietis	griEtis
grii	gri
grii pahn	gripa*
grii se	grise
griin	grin
griis	gris
grinieda	griniEda
grong	groN
gruo	gruo
gruot	gruot
gud	gud
gudz	gudz
gunggu	guNgu
gunggu piiz	guNgu piz
guol	guol
guot	guot
guzu	guzu
gwaava	gwava
gwan	gwan
gyaad	Tad
gyaadn	Tadn
gyaalik	Talik
gyada	Tada
gyadarin	Tadarin
gyal	Tal
gyal pikni	Tal pikni
gyas	Tas
haakiek	hakiEk
haalzwie	halzwiE
haatagrafi	hatagrafi
haatikl	hatikl
haatis	hatis
habrij	habridZ
habvios	habvios
hada	hada
hadap	hadap
hadvenchara	hadventSara
hafi	hafi
haid	haid
hairish	hairiS
hairish pitieta	hairiS pitiEta
hambrela	hambrela
hanalisis	hanalisis
hanimal	hanimal
harijin	haridZin
hat	hat
hatityuud	hatityud
haxent	haksent
haxesobl	haksesobl
haxpek	hakspek
hayan	hayan
hayan-mekin	hayanmekin
haz	haz
hebini	hebini
hebm	hebm
hedituoryal	hedituoryal
heg	heg
hels	hels
hen	hen
hen a	hena
heni	heni
heni a	henia
heni a di abov	henia diabov
heniting	henitiN
heniting hels	henitiN hels
hexpand	hekspand
hexplien	hekspliEn
hexpreshan	hekspreSan
hexten	heksten
hextingk	hekstiNk
hidyam	hidyam
hieja	hiEdZa
hiem	hiEm
hiet	hiEt
hietiin	hiEtin
hifek	hifek
higla	higla
hiit	hit
hiiz	hiz
hilekchranik	hilektSranik
hilekchranik komiunikieshan	hilektSranik komyunikiESan
himpres	himpres
hinchradokshan	hintSradokSan
hinchrajuus	hintSradZus
hinchres	hintSres
hinfluens	hinfluens
hingglish	hiNgliS
hinishal	hiniSal
hinkluudn	hinkludn
hintanashinal	hintanaSinal
hintanashinal chrabl	hintanaSinal tSrabl
hofishal	hofiSal
hofishal langwij	hofiSal laNwidZ
honggl	hoNgl
honggri	hoNgri
honyan	ho5an
hopin-en	hopinen
horbanizieshan	horbaniziESan
hori	hori
hori op	hori op
horli	horli
howa	howa
hox	hoks
huobaluk	huobaluk
huol	huol
huol-taima	huoltaima
huoliip	huolip
huoral	huoral
huoral langwij	huoral laNwidZ
huovn	huovn
ie	iE
iebl	iEbl
ieda	iEda
iej	iEdZ
iejobl	iEdZobl
iel	iEl
iemi	iEmi
ienshent	iEnSent
iepril	iEpril
ier	iEr
ieria	iEria
ies	iEs
iet	iEt
ieti	iEti
ietiin	iEtin
iez	iez
iezha	iEZa
ifainali	ifainali
ifek	ifek
igwaana	igwana
ihn	i*
iibm	ibm
iibn	ibn
iihn	i*
iijip	idZip
iikwal	ikwal
iip	ip
iir	ir
iis	is
iistan	istan
iit	it
iit aaf	itaf
iivn	ivn
iivnin	ivnin
ikanami	ikanami
ikanamik	ikanamik
ikanamix	ikanamiks
ilek	ilek
iloschrieshan	ilostSriESan
im	im
impak	impak
impruuv	impruv
impuotant	impuotant
imuoshan	imuoSan
in fak	infak
ina	ina
ina di faam a	inadi fama
ina di wol	inadi wol
inaamos	inamos
inabit	inhabit
indipendans	indipendans
indischroktebl	indistSroktebl
indoschri	indostSri
indoschrial	indostSrial
indoschrializieshan	indostSrializiESan
infamieshan	infamiESan
influens	influens
inggiej	iNgiEdZ
ingglan	iNglan
ingkluudn	iNkludn
ingkorij	iNkoridZ
iniebl	iniEbl
injai	indZai
injinierin	indZiniErin
inkluud	inklud
inkriis	inkris
inruol	inruol
insaiklopiidya	insaiklopidya
inspaya	inspaia
intaikl	intaikl
intanashinal	intanaSinal
intanet	intanet
intatiena	intatiEna
invalv	invalv
inviejan	inviEdZan
ischri	istSri
ishu	iShu
istuorian	istuorian
it	it
itali	itali
ivalv	ivalv
ivenchuali	iventSuali
ivent	ivent
jaagrafi	dZagrafi
jaagrofi	dZagrofi
jaaj	dZadZ
jaaloji	dZalodZi
jain	dZain
jainop	dZainop
jakfruut	dZakfrut
jaloji	dZalodZi
jan	dZan
jangkro	dZaNkro
janiweri	dZaniweri
japan	dZapan
jeli	dZeli
jeliduo	dZeliduo
jiel	dZiEl
jiemz	dZiEmz
jien	dZiEn
jinaral	dZinaral
jinarasiti	dZinarasiti
jinarieshan	dZinariESan
jinja	dZindZa
joj	dZodZ
jomp	dZomp
jomp-up	dZompop
jonjo	dZondZo
jork	dZork
jork chikin	dZork tSikin
jork puok	dZork puok
jork siiznin	dZork siznin
jork spais	dZork spais
jormani	yormani
jornal	dZornal
jostis	dZostis
jraa	dZra
jraadong	dZradoN
jraaf	dZraf
jraafut	dZrafut
jraaz	dZraz
jragan	dZragan
jrai	dZrai
jramatik	dZramatik
jrap	dZrap
jred	dZred
jres	dZres
jresbak	dZresbak
jresdong	dZresdoN
jriepop	dZriEpop
jringk	dZriNk
jrog	dZrog
jrom	dZrom
juk	dZuk
juki-juki	dZukidZuki
julai	dZulai
jumieka	dZumiEka
jumieka lieba paati	yumiEka liEba pati
jumieka taak	dZumiEka tak
junjo	dZundZo
juo	dZuo
juok	dZuok
juu tu	dZutu
juun	dZun
juun plom	dZunplom
juurin	dZurin
juus	dZus
kaa	ka
kaal	kal
kaan	kan
kaanful	kanful
kaanwal kounti	kanwal kounti
kaaz	kaz
kaazn	kazn
kach banit pepa	katS banit pepa
kain	kain
kait	kait
kak	kak
kala	kala
kalalu	kalalu
kalani	kalani
kalanis	kalanis
kalek	kalek
kalekshan	kalekSan
kalij	kalidZ
kaman	kaman
kaman yuusij	kaman yusidZ
kamedi	kamedi
kanchosnis	kantSosnis
kanchrak	kantSrak
kanchuol	kantSuol
kanekshan	kanekSan
kanschrokshan	kanstSrokSan
kansda	kansda
kantent	kantent
kantinyu	kanti5u
kanvasieshan	kanvasiESan
karambuola	karambuola
kasaada	kasada
kasaava	kasava
kasta riika	kastarika
katn	katn
katn chrii	katn tSri
kazmopalitan	kazmopalitan
kech	ketS
kech di riek	ketS di riEk
kechop	ketSop
kelyan	kelyan
kenet	kenet
kianada	kyanada
kiaribiyan	kyaribiyan
kidni biin	kidni bin
kiedens	kiEdens
kieful	kiEful
kiek	kiEk
kien	kien
kies	kiEs
kiet	kiEt
kilomita	kilomita
kimischri	kimistSri
kin	kin
kindom	kindom
kinston	kinston
kisaada	kisada
klaat	klat
klaax tong	klakstoN
klarindan	klarindan
klasikal	klasikal
klie	kliE
klie pat	kliE pat
kliem	kliEm
klier	kliEr
kliermont	kliErmont
klifod	klifod
kliin	klin
kola	kola
kolcha	koltSa
kom	kom
kom iin laka	komin laka
kom ya	kom ya
komiunikieshan	komyunikiESan
kompail	kompail
kompyuuta	kompyuta
kompyuuta manita	kompyuta manita
konchri	kontSri
kongk	koNk
koni	koni
korant	korant
kori guot	kori guot
koril	koril
korl	korl
kos	kos
koskos	koskos
kostad apl	kostad apl
kot	kot
kot patwa	kot patwa
kot yai	kot yai
kotlis	kotlis
kou	kou
kounti	kounti
kowich	kowitS
kozn	kozn
kraani	krani
kraitiirya	kraitirya
krap	krap
krichoul	kritSoul
kriebn	kriEbn
kriep	kriEp
kriet	kriet
krietiv	kriEtiv
krietiv raitn	kriEtiv raitn
kriim	krim
krikit	krikit
kris	kris
kritikal akliem	kritikal akliEm
ku	ku
kudn	kudn
kuk	kuk
kukumba	kukumba
kunu	kunu
kuoknat	kuoknat
kuoknat chrii	kuoknat tSri
kuoknat milk	kuoknat milk
kuoknat waata	kuoknat wata
kuoko	kuoko
kuol	kuol
kuos	kuos
kuot	kuot
kuul	kul
kwaadinet	kwadinet
kwaat	kwat
kwait	kwait
kwaiyat	kwaiyat
kwestiyan	kwestiyan
kwiin	kwin
kwik	kwik
kwik-taim	kwiktaim
kwint	kwint
kyaa	kya
kyaahn	kya*
kyaar	kyar
kyaarat	kyarat
kyabij	kyabidZ
kyahn	kya*
kyaklik	kyaklik
kyamil	kyamil
kyanal	kyanal
kyanggl	kyaNgl
kyangkro	kyaNkro
kyapasiti	kyapasiti
kyapcha	kyaptSa
kyapital	kyapital
kyapitalis	kyapitalis
kyaptin	kyaptin
kyar	kyar
kyarakta	kyarakta
kyari	kyari
kyash	kyaS
kyash krap	kyaS krap
kyashu	kyaSu
kyata	kyata
kyatalis	kyatalis
kyatigari	kyatigari
kyuuba	kyuba
laa	la
laaf	laf
laaj	ladZ
laan	lan
labsta	labsta
lai	lai
laibri	laibri
laif	laif
laifstail	laifstail
laik	laik
lait	lait
laitous	laitous
laiyad	laiyad
laiyan	laiyan
laka	laka
laka se	lakase
lam	lam
lan	lan
landan	landan
lang	laN
langwij	laNwidZ
larans	larans
layad	layad
lebl	lebl
lebm	lebm
leda	leda
lef	lef
lego	lego
lego biis	lego bis
lejislieta	ledZisliEta
lent	lent
leta	leta
lib a farin	libafarin
libn	libn
libn langwij	libn laNwidZ
lichicha	litSitSa
lieba	liEba
liedi	liEdi
liet	liEt
lieta	liEta
lieya	liEya
lifop	lifop
liida	lida
liig	lig
liin	lin
lik	lik
likl	likl
likl muos	likl muos
lili	lili
lingguistik	liNguistik
linggwis	liNgwis
lis	lis
lis a	lisa
lisn	lisn
litosfier	litosfiEr
lizad	lizad
lob	lob
long	loN
lorn	lorn
lou	lou
luk	luk
luo	luo
luokal	luokal
luokalaiz	luokalaiz
luokiet	luokiEt
luokiet ina	luokiEt ina
luokiet nier	luokiEt niEr
luusi	lusi
luwi	luwi
luwiiz	luwiz
maach	matS
maaga	maga
maak	mak
maakit	makit
maakos	makos
maanin	manin
mada	mada
mada-tong	madatoN
madan	madan
madifai	madifai
madifikieshan	madifikiESan
magaziin	magazin
magij	magidZ
magl	magl
maigrieshan	maigriESan
maikal	maikal
main	main
mait	mait
maitbi	maitbi
majariti	madZariti
man	man
manatii	manati
manazebl	manazebl
manchesta	mantSesta
mandivl	mandivl
manggo	maNgo
mangguus	maNgus
manita	manita
mantiga bie	mantiga biE
manyufakcha	ma5ufaktSa
manyufakcharin	ma5ufaktSarin
maruun tong	maruntoN
mas	mas
mas komiunikieshan	mas komyunikiESan
mashet	maSet
mashiin	maSin
mashiin tuul	maSin tul
mashiinri	maSinri
matiirialis	matirialis
matimatix	matimatiks
matyu	matyu
medisn	medisn
meditieshan	meditiESan
meja	medZa
mejament	medZament
mek	mek
mekop	mekop
memba	memba
mexiko	meksiko
mi	mi
midiom	midiom
midya	midya
mie	miE
mie pen	miEpen
miebi	miEbi
mieja	miEdZa
miel	miEl
mien	miEn
mienli	miEnli
mieri	miEri
migl	migl
migl iis	migl is
migl-klaas	migl klas
miglsex kounti	miglseks kounti
miin	min
miinin	minin
miit	mit
miita	mita
miizolek	mizolek
milichri	militSri
miliyan	miliyan
mimuorial	mimuorial
minista	minista
mishaneri	miSaneri
misnuoma	misnuoma
mixcha	mikstSa
mixcho	mikstSo
mobie	mobiE
mongx	moNks
moni	moni
morant bie	morantbiE
mountn	mountn
mout	mout
muo	muo
muo dahn	muoda*
muobail	muobail
muor	muor
muos	muos
muosli	muosli
muotaim	muotaim
muuv	muv
muuv frahn	muvfra*
muuv gaa	muvga
myuuzik	myuzik
myuziom	myuziom
na	na
na fi	nafi
na kech di riek	na ketS di riEk
na onggl	na oNgl
naamali	namali
naaman	naman
naasi	nasi
naasti	nasti
naat	nat
naat afrika	nat afrika
naat amerika	nat amErika
naatiis	natis
naatwes	natwes
nadan	nadan
naijiiria	naidZirya
nain	nain
naint	naint
naintiin	naintin
nais	nais
nait	nait
naiz	naiz
nalij	nalidZ
nanfikshan	nanfikSan
nansi	nansi
naritiv	naritiv
navl	navl
neba	neba
nedalanz	nedalanz
nex	neks
nex ier	neks iEr
niecha	niEtSa
niel	niEl
niem	niEm
niernis	niErnis
nieshan	niESan
nieshan stiet	niESan stiEt
nietib	niEtib
nietib langwij	niEtib laNwidZ
nigril	nigril
niigl	nigl
niyilis	niyilis
no kja	nokya
no kja umoch	nokya umotS
no kwait	no kwait
no kya	no kya
no kya ou	no kiya ou
no riili	no rili
nof	nof
nof piipl	nof pipl
nof tangx	nof taNks
nof-nof	nofnof
noftaim	noftaim
nomba	nomba
non	non
nondiles	nondiles
notn	notn
notn na go so	notn nagoso
novemba	novemba
nuo	nuo
nuot	nuot
nuotobl	nuotobl
nuoz	nuoz
nyaamps	5amps
nyam	5am
nyam aaf	5amaf
nyami-nyami	5ami5ami
nyuu	5u
nyuu yaak	nyuyak
nyuu yaak siti	nyuyak siti
nyuuz	5uz
nyuuzpiepa	5uzpiEpa
ogli	ogli
okor	okor
okro	okro
olo	olo
ombl	ombl
onggl	oNgl
onggl wan	oNgl wan
onjrid	ondZrid
ont	ont
ontalaji	ontaladZi
ontin	ontin
ontruut	ontrut
op	op
op tu	optu
opdiet	opdiEt
opinyan	opi5an
opsaid dong	opsaid doN
orbort	orbort
ort	ort
ortkwiek	ortkwiEk
ou	ou
oun	oun
ous	ous
ousomeba	ousomeba
owad	owad
ozban	ozban
paadn	padn
paal	pal
paaliment	paliment
paarat	parat
paas	pas
paas dong	pasdoN
paas ischri	pas istSri
paasl	pasl
paasn	pasn
paasteriti	pasteriti
paat	paat
paat a	pata
paati	pati
pachrik	patSrik
pahn	pa*
pain	pain
paint	paint
paip	paip
pakistan	pakistan
pakit	pakit
paliis	palis
palisi	palisi
palitikal	palitikal
palitishan	palitiSan
palitix	palitiks
panish	panish
panish tong	paniStoN
papila	papila
papilieshan	papiliESan
papishuo	papiSuo
papyulieshan	papyuliESan
pashan fruut	paSan frut
pat	pat
pati	pati
patwa	patwa
pel	pel
pelin	pelin
pepa	pepa
picha	pitSa
picha buk	pitSa buk
pie	piE
pie fa	piEfa
piej	piEdZ
piepa	piEpa
pier	piEr
pierans	piErans
pieschri	piEstSri
pieshans	piESans
piich patan	pitS patan
piik	pik
piika	pika
piiki-puoki	pikipuoki
piil	pil
piini	pini
piini-waali	piniwali
piipl	pipl
piipl nashinal paati	pipl naSinal pati
piiriad	piriad
piis	pis
piita	pita
piiz	piz
pikni	pikni
pilikin	pilikin
pimenta	pimenta
pio	pio
pit	pit
pitieta	pitiEta
pitni	pitni
plaan	plan
plaant	plant
plaantin	plantin
pleja	pledZa
plie	pliE
plies	pliEs
pliet	pliEt
plit	plit
plom	plom
poblik	poblik
poblikieshan	poblikiESan
poblish	pobliS
poblisha	pobliSa
pofaam	pofam
poliis	polis
poliisman	polisman
politikal paati	politikal pati
pongkin	poNkin
ponish	poniS
ponishment	poniSment
por-kiapita	por kyapita
porl	porl
pormanent	pormanent
posnal	posnal
posnal infamieshan	posnal infamiESan
pospektiv	pospektiv
potenshal	potenSal
potienin	potiEnin
potikila	potikila
potikyula	potikyula
powa	powa
prablem	prablem
praim	praim
praim minista	praim minista
prais	prais
praivisi	praivisi
prajek	pradZek
pramis	pramis
pravins	pravins
pred	pred
preke	preke
priivos	privos
primenta	primenta
prizaab	prizab
prizn	prizn
prodok	prodok
prodokshan	prodokSan
profeshanal chrienin	profeSanal tSriEnin
pronongx	pronoNks
protek	protek
protekshan	protekSan
prumuot	prumuot
pruogram	pruogram
pruoses	pruoses
pudn	pudn
pumuot	pumuot
puo	puo
puohim	puohim
puok	puok
puos	puos
puosha	puoSa
puosi	puosi
puot	puot
puot antuoni	puot antuoni
puot maraya	puotmaraya
puotlan	puotlan
puotmuor	puotmuor
pupaa	pupa
pus	pus
pwail	pwail
pyaa-pyaa	pyapya
pyuuriti	pyuriti
raa	ra
raatid	ratid
raip	raip
rais	rais
rais ahn piiz	rais a* piz
rait	rait
raita	raita
raitn	raitn
raki paint	rakipaint
raktuon	raktuon
rang	raN
rang-said	raNsaid
raya byuuno	rayabyuno
reda	reda
redi	redi
refa	refa
refa tu	refatu
refa tu az	refatuaz
refarans	refarans
refarans buk	refarans buk
refrans	refrans
rekaad	rekad
rekanaiz	rekanaiz
rekanaiz se	rekanaizse
rekanishan	rekaniSan
respirieshan	respiriESan
revaluushan	revaluSan
revarii	revari
revinyuu	revi5u
riba	riba
ribelyan	ribelyan
ridim	ridim
ried	riEd
riedio	riEdio
riek	riEk
rielwie	riElwiE
rielwie stieshan	riElwiE stiESan
rien	riEn
rienj	riEndZ
ries	riEs
riesin	riEsin
riesizim	riEsizim
rieza	riEza
riezn	riEzn
rifaam	rifam
rifain	rifain
rigl	rigl
riid	rid
riida	rida
riijan	ridZan
riijanal	ridZanal
riili	rili
riisant	risant
riizn	rizn
rijais	riyais
rilaxieshan	rilaksiESan
rilieshanship	riliESanSip
rilietid	riliEtid
riliis	rilis
rilijan	rilidZan
rimien	rimiEn
ripoblik	ripoblik
ripoblik a airilan	ripoblik a airilan
ripoblik a chaina	ripoblik a tSaina
riprizent	riprizent
ris	ris
rispek	rispek
ritorn	ritorn
rivazdiel	rivazdiEl
rivuolt	rivuolt
rizaat	rizat
rizolt	rizolt
romantik	romantik
ron	ron
ronawe bie	ronawebiE
rosha	roSa
ruod	ruod
ruoman kyaklik	ruoman kyaklik
ruoman kyaklik choch	ruoman kyaklik tSotS
ruos	ruos
ruudnis	rudnis
ruul	rul
ruut	rut
saab	sab
saabis	sabis
saach	satS
saadi ariebia	sadi ariEbya
saaf	saf
saalfish	salfiS
saaya saas	saya sas
sai	sai
saiman	saiman
sait	sait
saiyans	saiyans
sakrifais	sakrifais
salaman	salaman
samyuel	samyuel
san	san
sang	saN
sanja	sandZa
santa kruuz	santakruz
santapii	santapi
sar	sar
saril	saril
sasayati	sasayati
sataya	sataya
savlamaar	savlamar
sayans	sayans
sayantis	sayantis
schraip	stSraip
schuu	stSu
se	se
sebm	sebm
sebmt	sebmt
sebmtiin	sebmtin
sebn	sebn
sebnt	sebnt
sebntiin	sebntin
sebral	sebral
sef	sef
sekan	sekan
sekl	sekl
seklment	seklment
sekshan	sekSan
sela	sela
senchral hieja	sentSralhiEdZa
senchri	sentSri
senit	senit
senita	senita
sens	sens
sensobl	sensobl
sensos	sensos
sentans	sentans
sentri	sentri
separieshan	separiESan
septemba	septemba
set a ruul	setarul
sexizim	seksizim
sfier	sfiEr
shaachij	SatSidZ
shaat	Sat
shap	Sap
shap-maasa	Sapmasa
sheda	Seda
shiem	SiEm
shier	SiEr
shob	Sob
shot	Sot
shout	Sout
shudn	Sudn
shuga	Suga
shuga kien	Suga kiEn
shuo	Suo
shuor	Suor
shuut	Sut
si	si
sib	sib
sidong	sidoN
sief	siEf
sieka	siEka
siel	siEl
siem	siEm
siem wie	siEm wiE
siem wie laka ef	siEm wiE laka ef
siera	siEra
siev	siEv
sii	si
sii kyaptin	si kyaptin
siikuel	sikwel
siim	sim
siim fi	simfi
siin	sin
siis	sis
siitorkl	sitorkl
siizn	sizn
siiznin	siznin
sik	sik
silekshan	silekSan
silvia	silvia
sin jiemz	sindZiEmz
sin kiachrin	sinkyatSrin
sin kits ahn niivis	sinkits a* nivis
sin luusha	sinluSa
sin mieri	sinmiEri
sin tamas	sintamas
sin vinsn ahn di grenidiinz	sinvinsn a* di grenidinz
sing	siN
singa	siNa
singgapuor	siNgapuor
siniek	siniEk
sinieli	siniEli
sint an	sintan
sint anju	sintandZu
sint anz bie	sintanzbiE
sint ilizibet	sintilizibet
sinting	sintiN
sipl	sipl
sista	sista
sistim	sistim
siti	siti
sitieshan	sitiESan
sitiet	sitiEt
sitizn	sitizn
sitn	sitn
six	siks
sixt	sikst
sixtiin	sikstin
skai	skai
skelyan	skelyan
skuul	skul
skwier	skwiEr
skwier kilomita	skwiEr kilomita
slait	slait
slieb	sliEb
sliip	slip
sluo	sluo
smaal	smal
smadi	smadi
smadi els	smadi els
smadi uu	smadi u
smuok	smuok
so langx az	solaNksaz
sobjek	sobdZek
sodan	sodan
sofa	sofa
sofarieshan	sofariESan
sohn	so*
sojes	sodZes
som	som
soma	soma
somwe	somwe
sopm	sopm
sopraizn	sopraizn
sopres	sopres
sori kounti	sori kounti
sorkl	sorkl
sorniem	sorniEm
sorosi	sorosi
soroun	soroun
soroun bai	soroun bai
sostien	sostiEn
soua	soua
soun	soun
sout	sout
sout afrika	sout afrika
sout koria	sout koria
soutiis	soutis
soutiis ieja	soutisiEdZa
soutwes	soutwes
spais	spais
spekchrom	spektSrom
spien	spiEn
spies	spiEs
spiishiz	spiSiz
spring	spriN
spring rien	spriN riEn
spring waata	spriN wata
spuoxman	spuoksman
staach	statS
staam	stam
staar	star
staar apl	star apl
staarfruut	star frut
staat	stat
stail	stail
stie	stiE
stiebl	stiEbl
stiej	stiEdZ
stieshan	stiESan
stiet	stiEt
stietos	stiEtos
stiibm	stibm
stiim	stim
stiim powa	stim powa
stodi	stodi
stuon	stuon
suhn	su*
suimz	suimz
suitsalan	suitsalan
sumaal	sumal
sumuud	sumud
suoja	suodZa
suop	suop
suos	suos
suoshal	suoSal
suoshal woka	suoSal woka
suoviet yuunian	suoviEt yunyan
susu	susu
suucha	sutSa
suun	sun
suup	sup
swiidn	swidn
swiit	swit
swiit pepa	swit pepa
swiit pitieta	swit pitiEta
swiit-swiit	switswit
swimin	swimin
taak	tak
taakin	takin
taat	tat
taat frahn	tat fra*
taikl	taikl
tailan	tailan
taim	taim
talawa	talawa
tamas	tamas
tambrik	tambrik
tambrin	tambrin
tan	tan
tan op	tanop
tandad	tandad
tangx	taNks
tap	tap
tapik	tapik
taya	taya
tayad	tayad
tek	tek
tek iin	tek in
tek kier a	tek kiEr
tek plies	tek pliEs
tek uoba	tek uoba
tekniik	teknik
tel	tel
tel nou	tel nou
ten	ten
tenis	tenis
tent	tent
tenya	te5a
terichri	teritSri
tertiin	tertin
textail	tekstail
tide	tide
tiebl	tiEbl
tiel	tiEl
ties	tiEs
tieta	tiEta
tigeda	tigeda
tii	ti
tiich	titS
tiif	tif
tiit	tit
tik	tik
tingk	tiNk
tingz	tiNz
tiori	tiori
tisyu	tisyu
tix	tiks
toch	totS
tod	tod
todi	todi
tof	tof
ton	ton
tong	toN
torkl	torkl
torm	torm
tormal	tormal
tornin paint	tornin paint
torpmtaim	torpmtaim
toti	toti
toun	toun
touzn	touzn
towa	towa
towil	towil
tros	tros
tu	tu
tumatis	tumatis
tuo	tuo
tuofuu	tuofu
tuon	tuon
tuonaliti	tuonaliti
tuori	tuori
tuu	tu
tuul	tul
twelb	twelb
twenti	twenti
ud	ud
uman	uman
umoch	umotS
unu	unu
uoba	uoba
uoba taim	uoba taim
uobasior	uobasior
uochi rayas	uotSirayas
uol	uol
uoli	uoli
uoliip	huolip
uom	uom
uon	uon
uona	uona
uonaship	uonaSip
uonyan	uo5an
uopm	uopm
uopm op	uopm op
uoshan	uoSan
uovn	uovn
uu	u
vais	vais
van	van
varayati	varayati
vejitebl	vedZitebl
vieri	viEri
vietnam	viEtnam
vijan	vidZan
vik	vik
viniga	viniga
volkieno	volkiEno
vorjan	vordZan
vowil	vowil
vuokal	vuokal
vuokalis	vuokalis
vuot	vuot
wa	wa
wa dehn kaal	wa dehn kal
waak	wak
waal	wal
waam	wam
waapm	wapm
waar	war
waata	wata
wahn	wa*
waidpred	waidpred
waif	waif
wail	wail
wails	wails
wait	wait
wala	wala
wan	wan
wan nex	wan neks
wan wie	wan wiE
wapn-bapn	wapnbapn
was	was
wat-lef	watlef
wat-liiv	watliv
we miin se	weminse
weda	weda
wehn	we*
wes	wes
wes afrika	wes afrika
wesmolan	wesmolan
westan yuurop	wEstan yurop
wi	wi
wid	wid
widout	widout
widoutn	widoutn
wie	wiE
wiej	wiEdZ
wiet	wiEt
wiik	wik
wiil	wil
winta	winta
wod	wod
wod-a-mout	wodamout
wok	wok
wok fuos	wok fuos
woka	woka
woklis	woklis
wol	wol
wori	wori
worom	worom
wot	wot
wotlis	wotlis
wud	wud
wuol	wuol
ya	ya
yaad	yad
yaadi	yadi
yai	yai
yam	yam
yampi	yampi
yaso	yaso
yaxep	yaksep
yeside	yeside
yong	yoN
yu	yu
yumaniti	yumaniti
yunaitid kindom	yunaitid kindom
yunaitid stiet	yunaitid stiEt
yunivorsiti	yunivorsiti
yuu	yu
yuukrien	yukriEn
yuuman	yuman
yuuna	iuna
yuuniiknis	yuniknis
yuunyan	yu5an
yuurop	yurop
yuus	yus
yuusful	yusful
yuusij	yusidZ
yuut	yut
yuuz	yuz
zela	zela
zuu	zu
