le	le
de	de
e	e
un	un
del	del
in	in
es	es
que	ke
Le	le
su	su
a	a
pro	pro
per	per
esseva	eseva
al	al
ha	ha
con	kon
se	se
como	komo
plus	plus
non	non
o	o
In	in
ille	ile
iste	iste
pote	pote
altere	altere
illo	ilo
esser	eser
Ille	ile
era	era
isotopo	isotopo
Illo	ilo
annos	anos
habeva	habeva
Un	un
prime	prime
ma	ma
inter	inter
lo	lo
grande	grande
lor	lor
super	super
duo	duo
qui	ki
il	il
Iste	iste
Su	su
multe	multe
lingua	liNgwa
on	on
durante	durante
parte	parte
tote	tote
multo	multo
son	son
illos	ilos
Il	il
anque	anke
essite	esite
nove	nove
quando	kwando
mesme	mesme
nomine	nomine
etiam	etyam
qual	kwal
usque	uske
forma	forma
citate	citate
post	post
solmente	solmente
tempore	tempore
isto	isto
mundo	mundo
usate	usate
vita	vita
sur	sur
ab	ab
linguas	liNgwas
circa	cirka
deveniva	deveniva
illes	iles
population	populatyon
si	si
sin	sin
alcun	alkun
et	et
parolas	parolas
anno	ano
ubi	ubi
debe	debe
importante	importante
tres	tres
causa	kasa
omne	omne
esse	ese
seculo	sekulo
cata	kata
plure	plure
personas	personas
pais	pas
cognoscite	kognoscite
anglese	aNglese
ante	ante
exemplo	eksemplo
stato	stato
appellate	apelate
ben	ben
Post	post
alicun	alikun
contra	kontra
illa	ila
numero	numero
parola	parola
ex	eks
differente	diferente
systema	sistema
Pro	pro
rege	rege
persona	persona
morte	morte
fin	fin
assi	asi
gruppo	grupo
nos	nos
historia	historya
vices	vices
Isto	isto
la	la
minus	minus
major	maZor
principal	principal
sub	sub
parve	parve
sed	sed
commun	komun
proque	proke
haber	haber
paises	pases
secunde	sekunde
Durante	durante
considerate	konsiderate
A	a
On	on
obras	obras
sovente	sovente
obra	obra
human	human
habitantes	habitantes
politic	politik
sol	sol
alte	alte
loco	loko
secundo	sekundo
facer	facer
proprie	proprye
majoritate	maZoritate
Illa	ila
international	internatyonal
termino	termino
Deo	8eo
tal	tal
uso	uso
moderne	moderne
membros	membros
longe	loNge
ultime	ultime
include	inklude
faceva	faceva
familia	familya
libro	libro
nominate	nominate
Francia	francya
The	te
existe	eksiste
guerra	gwera
hodie	hodye
face	face
alteres	alteres
comenciava	komencyava
musica	musika
periodo	periodo
tamben	tamben
Al	al
usa	usa
significa	signifika
maniera	manyera
popular	popular
general	general
varie	varye
vice	vice
etate	etate
typo	tipo
interlingua	interliNgwa
poteva	poteva
publicate	publikate
los	los
quasi	kwasi
De	de
Illos	ilos
facite	facite
patre	patre
quatro	kwatro
movimento	movimento
Per	per
francese	francese
Quando	kwando
ancora	ankora
re	re
capital	kapital
Unite	unite
desde	desde
governamento	governamento
centro	centro
formas	formas
social	socyal
Como	komo
facto	fakto
area	area
poter	poter
serie	serye
Europa	eropa
mesmo	mesmo
puncto	punkto
gruppos	grupos
certe	certe
generalmente	generalmente
of	of
region	regyon
grec	grek
libros	libros
solo	solo
studio	studyo
filio	filyo
quales	kwales
Si	si
roman	roman
Union	unyon
pauc	pawk
scribeva	skribeva
corpore	korpore
famose	famose
homines	homines
tanto	tanto
moriva	moriva
aqua	akwa
infantes	infantes
trova	trova
original	original
tarde	tarde
diverse	diverse
milliones	milyones
possibile	posibile
terra	tera
Ecclesia	eklesya
toto	toto
base	base
europee	europee
medio	medyo
animales	animales
verso	verso
antique	antikwe
insula	insula
religiose	religyose
scientific	scyentifik
sexual	sekswal
Jesus	Zesus
basate	basate
Secundo	sekundo
bon	bon
caso	kaso
nord	nord
partes	partes
statos	statos
Ben	ben
Europee	europee
frequentemente	frekwentemente
natural	natural
sequente	sekwente
create	kreate
espaniol	espanyol
Christo	kristo
official	oficyal
Statos	statos
autor	ator
aEC	a ek
dice	dice
ecclesia	eklesya
origine	origine
banda	banda
contine	kontine
cuje	kuZe
habe	habe
Nonobstante	nonobstante
postea	postea
version	versyon
economic	ekonomik
public	publik
sud	sud
Illes	iles
cultura	kultura
die	die
por	por
Ma	ma
cinque	ciNkwe
elementos	elementos
disveloppamento	disvelopamento
film	film
situate	sitwate
classic	klasik
objecto	obZekto
scribite	skribite
sia	sia
basse	base
forte	forte
homine	homine
national	natyonal
simple	simple
specialmente	specyalmente
alora	alora
joco	Zoko
position	posityon
dies	dies
relationes	relatyones
les	les
Con	kon
io	io
juvene	Zuvene
genere	genere
ancian	ancyan
tertie	tertye
theoria	teoria
Interlingua	interliNgwa
nulle	nule
texto	teksto
Assi	asi
Nove	nove
depost	depost
ni	ni
rolo	rolo
usar	usar
natura	natura
permitte	permite
german	german
mais	mais
typos	tipos
actual	aktwal
considera	konsidera
casos	kasos
jam	Zam
nigre	nigre
publicava	publikava
historic	historik
latin	latin
titulo	titulo
campo	kampo
codice	kodice
etc	etk
membro	membro
nostre	nostre
urbe	urbe
Altere	altere
christian	kristyan
linguage	lingwaZe
organisation	organisatyon
regno	regno
systemas	sistemas
unic	unik
esserea	eserea
final	final
gente	gente
processo	proceso
derecto	derekto
initio	inityo
labor	labor
personal	personal
relation	relatyon
sempre	sempre
ambe	ambe
cultural	kultural
datos	datos
da	da
intra	intra
politica	politika
presente	presente
successo	suceso
usualmente	uswalmente
occidental	ocidental
parla	parla
proxime	proksime
traditional	tradityonal
alsi	alsi
derectos	derektos
programma	programa
religion	religyon
Multe	multe
refere	refere
senso	senso
influentia	inflwentya
ipse	ipse
modo	modo
species	specyes
Imperio	imperyo
album	album
practica	praktika
tosto	tosto
consiste	konsiste
fundate	fundate
structura	struktura
vive	vive
II	duo
Roma	roma
education	edukatyon
ganiava	ganyava
ideas	ideas
matre	matre
musical	musikal
schola	sCola
radio	radyo
Sancte	sankte
curte	kurte
nivello	nivelo
Espania	espanya
Germania	germanya
litteratura	literatura
medie	medye
problemas	problemas
total	total
central	central
latino	latino
trans	trans
casa	kasa
fortia	fortya
idea	idea
linea	linea
linguistic	lingwistik
traduction	traduktyon
ver	ver
creava	kreava
departimento	departimento
mundial	mundyal
uno	uno
Guerra	gwera
Svedia	svedya
Universitate	universitate
cantos	kantos
lege	lege
scientia	scyentya
scriber	skriber
Regno	regno
creation	kreatyon
nasceva	nasceva
nunc	nunk
nunquam	nunkwam
recipeva	recipeva
territorio	teritoryo
adjuta	adZuta
cosas	kosas
crear	krear
epocha	epoka
nomines	nomines
ordine	ordine
resultato	resultato
Grande	grande
Hodie	hodye
feminas	feminas
scripte	skripte
similar	similar
communitate	komunitate
en	an
formate	formate
insimul	insimul
metros	metros
societate	socyetate
via	via
articulo	artikulo
includente	inkludente
monstra	monstra
particular	partikular
presidente	presidente
Totevia	totevia
and	and
objectos	obZektos
principalmente	principalmente
the	te
essera	esera
lista	lista
melior	melyor
qualcunque	kwalkuNkwe
material	materyal
arte	arte
definition	definityon
libere	libere
litteras	literas
methodo	metodo
numeros	numeros
opera	opera
poterea	poterea
production	produktyon
Danmark	danmark
Es	es
Plus	plus
active	aktive
energia	energia
est	est
local	lokal
recerca	recerka
scopo	skopo
seculos	sekulos
spatio	spatyo
specific	specifik
ultra	ultra
Inter	inter
International	internatyonal
appella	apela
debeva	debeva
electric	elektrik
equalmente	ekwalmente
femina	femina
fide	fide
latere	latere
menses	menses
phrase	frase
succedite	sucedite
canto	kanto
continuava	kontinwava
fonte	fonte
leges	leges
physic	fisik
recente	recente
stilo	stilo
Alcun	alkun
Departimento	departimento
militar	militar
necessari	necesari
Cata	kata
associate	asocyate
blanc	blank
carriera	karyera
existentia	eksistentya
independente	independente
principio	principyo
valor	valor
Biblia	biblya
Lor	lor
Non	non
Wikipedia	wikipedya
characteristicas	karakteristikas
diceva	diceva
fluvio	fluvyo
mal	mal
numerose	numerose
occurre	okure
totevia	totevia
vide	vide
vista	vista
I	i
Tote	tote
action	aktyon
armea	armea
color	kolor
concepto	koncepto
km	kaem
statounitese	statounitese
tradition	tradityon
trovate	trovate
dava	dava
difficile	dificile
svedese	svedese
Esperanto	esperanto
Terra	tera
commercial	komercyal
complete	komplete
crede	krede
maladia	maladia
regiones	regyones
semper	semper
textos	tekstos
Postea	postea
Republica	republika
ad	ad
articulos	artikulos
character	karakter
citates	citates
comencia	komencya
dividite	dividite
libertate	libertate
philosophia	philosofia
simplemente	simplemente
special	specyal
studios	studyos
terminos	terminos
capacitate	kapacitate
construite	konstrwite
definite	definite
ergo	ergo
filia	filya
no	no
sono	sono
specie	specye
America	amerika
britannic	britannik
deveni	deveni
filios	filyos
programmas	programas
representa	representa
controlo	kontrolo
distincte	distinkte
disveloppate	disvelopate
interesse	interese
mar	mar
ration	ratyon
tracta	trakta
tunc	tunk
John	Zohn
ambiente	ambyente
capite	kapite
devenite	devenite
lineas	lineas
litterari	literari
viage	vyaZe
E	e
amor	amor
appare	apare
autores	atores
defensa	defensa
includeva	inkludeva
information	informatyon
jocator	Zokator
julio	Zulyo
partir	partir
projecto	proZekto
rete	rete
ser	ser
sito	sito
va	va
animal	animal
contos	kontos
date	date
differentia	diferentya
fontes	fontes
ibi	ibi
importantia	importantya
momento	momento
probabilemente	probabilemente
problema	problema
punctos	punktos
rock	rokk
usava	usava
cavallo	kavalo
classe	klase
data	data
devenir	devenir
function	funktyon
indica	indika
insulas	insulas
lumine	lumine
populo	populo
superior	superyor
trovar	trovar
conditiones	kondityones
deos	8eos
essente	esente
haberea	haberea
normalmente	normalmente
singule	singule
verbos	verbos
Italia	italya
accordo	akordo
activitate	aktivitate
battalia	batalya
casas	kasas
interne	interne
mesura	mesura
rapidemente	rapidemente
regulas	regulas
unitate	unitate
urban	urban
vider	vider
vole	vole
Alicun	alikun
Anglaterra	aNglatera
Desde	desde
Se	se
american	amerikan
catholic	katolik
cognoscentia	kognoscentya
construction	konstruktyon
originalmente	originalmente
provincia	provincya
retornava	retornava
veni	veni
La	la
arrivava	arivava
basso	baso
collection	kolektyon
cosa	kosa
elemento	elemento
finalmente	finalmente
recognoscite	rekognoscite
voleva	voleva
west	west
appareva	apareva
areas	areas
clar	klar
dece	dece
foras	foras
proprietates	propryetates
resto	resto
septe	septe
situation	sitwatyon
subsequente	subsekwente
television	televisyon
themas	temas
Mundial	mundyal
Paris	paris
currente	kurente
dunque	duNkwe
fortias	fortyas
grado	grado
universal	universal
utilisate	utilisate
albumes	albumes
april	april
association	asocyatyon
autoritate	atoritate
civil	civil
doctrina	doktrina
ecclesias	eklesyas
economia	ekonomia
gratias	gratyas
limitate	limitate
operation	operatyon
pagina	pagina
separate	separate
sex	seks
supra	supra
symbolo	simbolo
tu	tu
veniva	veniva
Anque	anke
Consilio	konsilyo
National	natyonal
Nord	nord
cerca	cerka
designate	designate
disco	disko
effecto	efekto
medios	medyos
modello	modelo
remane	remane
scholas	sColas
simile	simile
sposa	sposa
travalio	travalyo
viveva	viveva
New	niw
Spirito	spirito
anterior	anteryor
basic	basik
castello	kastelo
chimic	kimik
existente	eksistente
januario	Zanwaryo
large	large
minor	minor
novembre	novembre
pedophilia	pedofilia
presso	preso
producite	producite
vidite	vidite
Ante	ante
Basse	base
Sud	sud
York	york
direction	direktyon
equipa	ekwipa
institutiones	institutyones
romance	romance
vos	vos
aperte	aperte
bandas	bandas
chef	Sef
cognite	kognite
decembre	decembre
edition	edityon
expression	ekspresyon
formation	formatyon
fundamental	fundamental
rubie	rubye
significato	signifikato
versiones	versyones
vocabulario	vokabularyo
Io	io
Senior	senyor
Stato	stato
campos	kampos
continua	kontinwa
continue	kontinwe
danese	danese
dar	dar
dicer	dicer
extension	ekstensyon
memoria	memorya
mense	mense
methodos	metodos
paginas	paginas
parlate	parlate
plantas	plantas
possede	posede
posterior	posteryor
private	private
question	kwestyon
sape	sape
servicio	servicyo
ulle	ule
varia	varya
Malgrado	malgrado
cellulas	celulas
chinese	Sinese
complexe	komplekse
directe	direkte
distantia	distantya
littera	litera
mano	mano
nascentia	nascentya
porta	porta
standard	standard
trovava	trovava
universo	universo
Africa	afrika
can	kan
continente	kontinente
deberea	deberea
derivate	derivate
dominio	dominyo
guitarra	ghitara
istos	istos
mi	mi
passate	pasate
referentia	referentya
undas	undas
verbo	verbo
videva	videva
augusto	agusto
causava	kasava
circum	cirkum
computator	komputator
describe	deskribe
dirigite	dirigite
independentia	independentya
km²	kaem duo
monarchia	monarkia
moral	moral
movimentos	movimentos
pare	pare
representate	representate
stellas	stelas
cambiava	kambyava
cognosce	kognosce
commercio	komercyo
communication	komunikatyon
completemente	kompletemente
differentias	diferentyas
fundava	fundava
interior	interyor
lucta	lukta
me	me
million	milyon
nascite	nascite
nonobstante	nonobstante
petra	petra
pois	pois
potente	potente
qualitate	kwalitate
require	rekwire
sede	sede
superficie	superficye
Maria	maria
attinger	atiNger
feminin	feminin
greco	greko
instrumento	instrumento
martio	martyo
materia	materya
nation	natyon
normal	normal
oriental	oryental
particularmente	partikularmente
quantitate	kwantitate
Depost	depost
Tractato	traktato
contento	kontento
evolution	evolutyon
formava	formava
fratre	fratre
functiones	funktyones
grecos	grekos
imperio	imperyo
junio	Zunyo
massa	masa
mental	mental
octobre	oktobre
parlar	parlar
passava	pasava
popularitate	popularitate
projectos	proZektos
servicios	servicyos
sole	sole
stella	stela
subjecto	subZekto
utilisa	utilisa
vetule	vetule
SUA	swa
UE	we
actiones	aktyones
activitates	aktivitates
addition	adityon
comportamento	komportamento
disponibile	disponibile
facile	facile
imperator	imperator
includite	inkludite
jocos	Zokos
legal	legal
notabile	notabile
potentia	potentya
proprietate	propryetate
publication	publikatyon
qualque	kwalke
real	real
structuras	strukturas
victoria	viktorya
Asia	asya
Mar	mar
Russia	rusya
actualmente	aktwalmente
adultos	adultos
attacco	atako
causate	kasate
costa	kosta
eventos	eventos
instrumentos	instrumentos
italian	italyan
professional	profesyonal
station	statyon
union	unyon
Academia	akademia
Brasil	brasil
Grecia	grecya
cambio	kambyo
climate	klimate
compania	kompania
composite	komposite
dur	dur
figura	figura
formar	formar
infante	infante
ja	Za
longitude	loNgitude
maio	mayo
nederlandese	nederlandese
octo	okto
produce	produce
scriptor	skriptor
tempores	tempores
varietate	varyetate
web	web
Duo	duo
Henrico	henriko
Nos	nos
Solmente	solmente
Tamen	tamen
cambios	kambyos
cm	seem
consilio	konsilyo
debite	debite
deriva	deriva
election	elektyon
establiva	establiva
evitar	evitar
imagine	imagine
organisationes	organisatyones
passato	pasato
pecia	pecya
perdeva	perdeva
plural	plural
sanitate	sanitate
velocitate	velocitate
village	vilaZe
zona	zona
Parlamento	parlamento
alto	alto
artistas	artistas
chassa	Sasa
denominate	denominate
eligite	eligite
grandor	grandor
hic	hik
obscur	obskur
opposition	oposityon
pecias	pecyas
perdite	perdite
populos	populos
presentia	presentya
principios	principyos
quotidian	kwotidyan
vivente	vivente
Catholic	katolik
Partito	partito
adversario	adversaryo
applicationes	aplikatyones
colores	kolores
combatto	kombato
consequentia	konsekwentya
contrario	kontraryo
credentia	kredentya
edificio	edificyo
electronic	elektronik
filmes	filmes
grammatica	gramatika
integre	integre
locos	lokos
maestro	maestro
magnetic	magnetik
medietate	medyetate
objectivo	obZektivo
plen	plen
presenta	presenta
primari	primari
respecto	respekto
romanos	romanos
securitate	sekuritate
signos	signos
software	software
thema	tema
usator	usator
Charles	Carles
David	david
Internet	internet
Odysseo	odiseo
Omne	omne
absolute	absolute
arabe	arabe
attention	atentyon
attingeva	atiNgeva
condition	kondityon
conto	konto
decideva	decideva
domestic	domestik
domo	domo
equal	ekwal
exacte	eksakte
experientia	eksperyentya
inclusive	inklusive
individual	individwal
istes	istes
m	em
moneta	moneta
pedon	pedon
practic	praktik
previe	prevye
programmation	programatyon
questiones	kwestyones
relativemente	relativemente
remaneva	remaneva
seque	sekwe
totalmente	totalmente
China	Sina
Etiam	etyam
Pais	pas
adjectivos	adZektivos
classification	klasifikatyon
depende	depende
discos	diskos
extende	ekstende
externe	eksterne
generes	generes
guerras	gweras
habite	habite
kilometros	kilometros
machina	makina
mercato	merkato
mover	mover
pertine	pertine
poco	poko
recipe	recipe
section	sektyon
traductiones	traduktyones
troppo	tropo
unda	unda
usatores	usatores
Britannia	britanya
Newton	Newton
additional	adityonal
aspectos	aspektos
calendario	kalendaryo
carga	karga
cartas	kartas
christianismo	kristyanismo
contexto	konteksto
corte	korte
critica	kritika
cum	kum
dicite	dicite
esperanto	esperanto
existeva	eksisteva
februario	febrwaryo
finiva	finiva
forsan	forsan
geographic	geografik
initial	inityal
judee	Zudee
justitia	Zustitya
organisate	organisate
pace	pace
partito	partito
phase	fase
portugese	portugese
publico	publiko
radioamatori	radyoamatori
realitate	realitate
revista	revista
septembre	septembre
symbolos	simbolos
temperatura	temperatura
Finalmente	finalmente
Sol	sol
Testamento	testamento
University	universiti
artista	artista
combination	kombinatyon
correcte	korekte
curso	kurso
dedicate	dedikate
deo	8eo
describite	deskribite
formal	formal
habitation	habitatyon
imagines	imagines
naturalmente	naturalmente
peso	peso
premio	premyo
primo	primo
racia	racya
rapide	rapide
resulta	resulta
resultatos	resultatos
signo	signo
usage	usaZe
voce	voce
Carolo	karolo
Del	del
Duvert	duvert
acceptate	aceptate
administrative	administrative
blanco	blanko
communmente	komunmente
considerava	konsiderava
correspondente	korespondente
designo	designo
directemente	direktemente
discoperite	diskoperite
excepte	ekscepte
facilemente	facilemente
futuro	futuro
germano	germano
historias	historyas
immediatemente	imedyatemente
infantil	infantil
linguages	lingwaZes
maritava	maritava
necessitate	necesitate
nocte	nokte
nomina	nomina
notation	notatyon
ora	ora
passa	pasa
postal	postal
pression	presyon
professor	profesor
protection	protektyon
regula	regula
russe	ruse
scriptores	skriptores
studiava	studyava
substantivo	substantivo
telephonic	telefonik
universitate	universitate
usante	usante
American	amerikan
Dunque	duNkwe
amicos	amikos
appoio	apoyo
apprender	aprender
categoria	kategoria
characterisate	Carakterisate
conflicto	konflikto
conta	konta
contato	kontato
critic	kritik
declarava	deklarava
describer	deskriber
director	direktor
distante	distante
divide	divide
dum	dum
industrial	industryal
masculin	maskulin
municipalitates	municipalitates
nave	nave
nucleo	nukleo
omnes	omnes
parlatores	parlatores
planeta	planeta
prende	prende
radices	radices
responsa	responsa
scientistas	scyentistas
scopos	skopos
soldatos	soldatos
traducite	traducite
typicamente	tipikamente
vadeva	vadeva
veritate	veritate
Roman	roman
Troia	8roya
actor	aktor
breve	breve
categorias	kategorias
celo	celo
colpo	kolpo
contemporanee	kontemporanee
discurso	diskurso
divin	divin
favor	favor
foco	foko
fundator	fundator
habente	habente
humanitate	humanitate
includer	inkluder
inferior	inferyor
malgrado	malgrado
organismos	organismos
parentes	parentes
prendite	prendite
quarte	kwarte
rationes	ratyones
regnos	regnos
vendite	vendite
viver	viver
Ab	ab
Dublin	dublin
Irlanda	irlanda
Johannes	Zohannes
London	london
Occidental	ocidental
Rege	rege
Robert	robert
adjectivo	adZektivo
adoptate	adoptate
antea	antea
arriva	ariva
cambiar	kambyar
characteristic	karakteristik
classes	klases
compone	kompone
corresponde	koresponde
dialectos	dyalektos
electiones	elektyones
films	films
fratres	fratres
habita	habita
horas	horas
humanos	humanos
individuos	individwos
jornal	Zornal
oculos	okulos
offere	ofere
physica	fisika
poteres	poteres
prendeva	prendeva
profunde	profunde
referer	referer
salvage	salvaZe
secur	sekur
stricte	strikte
theorias	teorias
vocales	vokales
Gustav	gustav
Plure	plure
Raphael	rafael
Sed	sed
Societate	socyetate
accesso	aceso
amico	amiko
analyse	analise
aspecto	aspekto
assatis	asatis
benque	beNkwe
colonia	kolonia
constitue	konstitwe
crea	krea
cresce	kresce
dea	dea
elevate	elevate
inseniamento	insenyamento
interpretation	interpretatyon
japonese	Zaponese
juvenes	Zuvenes
maxime	maksime
operas	operas
orthographia	ortografia
personage	personaZe
poema	poema
prender	prender
recipite	recipite
regional	regyonal
regular	regular
sanguine	sangwine
scriptura	skriptura
secundari	sekundari
spirito	spirito
succedeva	sucedeva
territorios	teritoryos
to	to
tractamento	traktamento
voluntate	voluntate
Cook	kook
Dr	deer
James	Zames
Prime	prime
Usque	uske
altitude	altitude
artistic	artistik
belle	bele
calide	kalide
cambia	kambya
camera	kamera
cento	cento
comprender	komprender
concernente	koncernente
decennio	decenyo
defini	defini
dialecto	dyalekto
disveloppava	disvelopava
episcopo	episkopo
essential	esentyal
experimentos	eksperimentos
fini	fini
functiona	funktyona
identic	identik
illac	ilak
kg	kage
ligate	ligate
location	lokatyon
materiales	materyales
novas	novas
par	par
permittite	permitite
petras	petras
poemas	poemas
policia	policia
politicas	politikas
ponte	ponte
praseodymium	praseodimyum
prision	prisyon
proveni	proveni
regal	regal
regina	regina
saper	saper
spiritual	spiritwal
tellurium	teluryum
terras	teras
Fox	foks
George	george
III	tres
India	indya
Paulo	palo
San	san
Star	star
administration	administratyon
alphabeto	alfabeto
approximativemente	aproksimativemente
attinge	atiNge
avante	avante
basa	basa
bastante	bastante
contacto	kontakto
credeva	kredeva
cresceva	kresceva
crescimento	krescimento
culturas	kulturas
demanda	demanda
editiones	edityones
fusion	fusyon
futur	futur
ganiar	ganyar
honor	honor
hypothese	hipotese
infantia	infantya
laborava	laborava
lanthano	lantano
medieval	medyeval
nam	nam
obstante	obstante
occurreva	okureva
pedemontese	pedemontese
pictura	piktura
poc	pok
populationes	populatyones
pronomines	pronomines
salvation	salvatyon
scena	scena
servi	servi
substantivos	substantivos
technic	teknik
tribos	tribos
unitates	unitates
verde	verde
Erasmo	erasmo
Kristian	kristyan
Mexico	meksiko
NAMBLA	nambla
Patre	patre
Premio	premyo
accepta	acepta
applicate	aplikate
application	aplikatyon
armas	armas
aves	aves
biblic	biblik
composition	komposityon
copias	kopyas
distinction	distinktyon
documento	dokumento
effectos	efektos
establite	establite
frequentia	frekwentya
industria	industrya
investigation	investigatyon
jammais	Zamais
jocatores	Zokatores
medicina	medicina
message	mesaZe
ministro	ministro
monarcha	monarCa
monstrar	monstrar
parlantes	parlantes
partita	partita
pede	pede
positive	positive
realisar	realisar
registrate	registrate
resultava	resultava
romances	romances
romanic	romanik
significante	signifikante
signification	signifikatyon
singular	siNgular
tamen	tamen
termination	terminatyon
Committee	komiti
Eduardo	edwardo
General	general
Generalmente	generalmente
IV	kwatro
MSX	emesiks
Thomas	tomas
alimento	alimento
apparatos	aparatos
architectura	arCitektura
auxiliar	aksilyar
capabile	kapabile
cauda	kada
christianos	kristyanos
culto	kulto
distingue	distiNgwe
division	divisyon
eveni	eveni
executate	eksekutate
exterior	eksteryor
familias	familyas
incontrava	inkontrava
iodo	yodo
juridic	Zuridik
mantener	mantener
modellos	modelos
multes	multes
neodymium	neodimyum
nihil	nihil
obtener	obtener
parlamento	parlamento
particulas	partikulas
plano	plano
produceva	produceva
pur	pur
recognosce	rekognosce
reges	reges
representation	representatyon
revolution	revolutyon
ric	rik
septimanas	septimanas
slave	slave
successor	sucesor
turre	ture
Documento	dokumento
Eneas	eneas
Japon	Zapon
Kalmar	kalmar
William	wilyam
acto	akto
adherentes	adherentes
anima	anima
appellava	apelava
armate	armate
cathedral	katedral
centos	centos
citatanos	citatanos
classificate	klasifikate
colonias	kolonias
constante	konstante
conversion	konversyon
corona	korona
cupro	kupro
dependente	dependente
determinate	determinate
dominante	dominante
figuras	figuras
finite	finite
frequente	frekwente
fundation	fundatyon
ganiate	ganyate
generation	generatyon
grados	grados
indium	indyum
lassava	lasava
ligno	ligno
metropolitan	metropolitan
move	move
passo	paso
patrono	patrono
pensa	pensa
permitteva	permiteva
perque	perke
positiones	posityones
protestante	protestante
provide	provide
quadrato	kwadrato
quanto	kwanto
representar	representar
samarium	samaryum
scientias	scyentyas
scribe	skribe
sexualitate	sekswalitate
sinistre	sinistre
technica	teknika
tentava	tentava
travaliava	travalyava
typic	tipik
variante	varyante
vermente	vermente
visibile	visibile
vulpes	vulpes
zinc	zink
Association	asocyatyon
Erik	erik
Filio	filyo
Secunde	sekunde
Smith	smit
West	west
aere	aere
affaires	afers
campania	kampanya
canes	kanes
clave	klave
communitates	komunitates
continental	kontinental
dama	dama
debile	debile
defender	defender
dictionario	diktyonaryo
documentos	dokumentos
entrata	entrata
exactemente	eksaktemente
false	false
gay	gay
genetic	genetik
implica	implika
informationes	informatyones
krypton	kripton
maritage	maritaZe
mathematica	matematika
minores	minores
nordic	nordik
opinion	opinyon
peninsula	peninsula
possibilitate	posibilitate
presentava	presentava
previemente	prevyemente
promethium	prometyum
rarmente	rarmente
realisate	realisate
reciper	reciper
reputation	reputatyon
retro	retro
rubidium	rubidyum
sablo	sablo
sequite	sekwite
tante	tante
tractato	traktato
transverso	transverso
valores	valores
yttrium	itryum
Oriental	oryental
affirma	afirma
alternative	alternative
ample	ample
arbore	arbore
cambiate	kambyate
cercar	cerkar
characteristica	karakteristika
concertos	koncertos
constitution	konstitutyon
decision	decisyon
determinar	determinar
developpamento	developamento
differe	difere
equivalente	ekwivalente
estimate	estimate
evento	evento
exemplos	eksemplos
haveva	haveva
homosexual	homosekswal
impossibile	imposibile
initiava	inityava
intendite	intendite
interpretate	interpretate
introduceva	introduceva
isolate	isolate
italiano	italyano
jocar	Zokar
leger	leger
manos	manos
media	medya
mente	mente
mythologia	mitologia
nivellos	nivelos
occidite	ocidite
officialmente	oficyalmente
palladium	paladyum
passar	pasar
pedophilos	pedofilos
poner	poner
prefixos	prefiksos
processos	procesos
regime	reZim
relative	relative
republica	republika
responsabile	responsabile
rolos	rolos
scala	skala
soror	soror
studentes	studentes
tabula	tabula
talia	talya
terrestre	terestre
theatro	teatro
tractos	traktos
utile	utile
vetere	vetere
Bernard	bernard
Copenhagen	kopenhagen
Edward	edward
Israel	israel
Joseph	Zosef
Licentia	licentya
Mais	mais
Ricardo	rikardo
abstracte	abstrakte
addite	adite
adjutar	adZutar
capace	kapace
consentimento	konsentimento
corde	korde
crescente	krescente
despecto	despekto
destruite	destrwite
districto	distrikto
duple	duple
el	el
enorme	enorme
entrava	entrava
essayava	esayava
essayos	esayos
estate	estate
exprimer	eksprimer
factos	faktos
folios	folyos
for	for
fortemente	fortemente
gadolinimum	gadolinimum
heroe	heroe
identitate	identitate
incontra	inkontra
individuo	individwo
ligamines	ligamines
logica	logika
marca	marka
melio	melyo
novo	novo
occupa	okupa
organo	organo
participava	participava
pauco	pawko
pensamento	pensamento
phenomeno	fenomeno
poeta	poeta
ponite	ponite
portava	portava
primarimente	primarimente
producer	producer
religiones	religyones
rhodium	rhodyum
scriptos	skriptos
sequeva	sekweva
solution	solutyon
strontium	strontyum
technetium	teknetyum
technicas	teknikas
templo	templo
temporal	temporal
vicin	vicin
von	von
vulpe	vulpe
Carl	karl
Dynastia	dinastia
Ergo	ergo
Hall	hol
Marx	marks
OmegaT	omega te
Proque	proke
Stockholm	stokkholm
Studios	studyos
academic	akademik
apud	apud
aures	awres
cavallos	kavalos
commando	komando
componentes	komponentes
conception	konceptyon
conceptos	konceptos
consequentias	konsekwentyas
conservate	konservate
credentias	kredentyas
designos	designos
editor	editor
evidentia	evidentya
expansion	ekspansyon
foreste	foreste
fructo	frukto
fundo	fundo
germanium	germanyum
gratia	gratya
guida	gwida
influentiate	inflwentyate
inspirate	inspirate
judeos	Zudeos
manco	manko
manieras	manyeras
mentionate	mentyonate
milles	miles
native	native
nigro	nigro
obteneva	obteneva
periodos	periodos
philosophic	philosofik
poesia	poesia
populate	populate
publicar	publikar
pueros	pueros
reformas	reformas
sequer	sekwer
sitos	sitos
sta	sta
theologic	teologik
traditiones	tradityones
unite	unite
viste	viste
zonas	zonas
Apollon	apolon
Provincia	provincya
Royal	royal
Senato	senato
Switza	switza
acheos	aCeos
actrice	aktrice
assemblea	asemblea
atomos	atomos
attitude	atitude
auro	aro
automatic	atomatik
autonome	atonome
autoritates	atoritates
candidato	kandidato
carne	karne
cobalt	kobalt
communista	komunista
comparation	komparatyon
componite	komponite
considerar	konsiderar
doctrinas	doktrinas
durava	durava
errores	erores
ethnic	etnik
fama	fama
familiar	familyar
federal	federal
fixate	fiksate
formato	formato
governamentos	governamentos
guarda	gwarda
habitava	habitava
historicos	historikos
initialmente	inityalmente
ista	ista
jazz	jez
juventute	Zuventute
mathematic	matematik
modificationes	modifikatyones
multiple	multiple
nationes	natyones
negative	negative
niobium	niobyum
nota	nota
occupava	okupava
pelle	pele
personages	personaZes
piano	pyano
placia	placya
precise	precise
proponite	proponite
proposition	proposityon
proteger	proteger
puero	puero
rebellion	rebelyon
referite	referite
resistentia	resistentya
series	seryes
sorta	sorta
specialisate	specyalisate
sufficiente	suficyente
troianos	troanos
univa	univa
vertical	vertikal
Achilles	akiles
Balki	balki
Cesare	cesare
IALA	yala
Instituto	instituto
Larry	lari
Madrid	madrid
Marco	marko
Museo	museo
Nobel	nobel
Nota	nota
World	world
adulte	adulte
african	afrikan
annual	anwal
blau	bla
brasilian	brasilyan
carbon	karbon
comprendite	komprendite
conjuncto	konZunkto
corpores	korpores
description	deskriptyon
disciplina	disciplina
duceva	duceva
ecclesiastic	eklesyastik
edificios	edificyos
entitate	entitate
exclusivemente	eksklusivemente
explica	eksplika
facie	facye
governate	governate
illas	ilas
jocava	Zokava
labores	labores
minerales	minerales
molybdenum	molibdenum
monstrate	monstrate
naves	naves
necun	nekun
notas	notas
pan	pan
parlava	parlava
partitos	partitos
pornographia	pornografia
presentate	presentate
primitive	primitive
radice	radice
retorno	retorno
ruthenium	rutenyum
selenium	selenyum
senior	senyor
studia	studya
supreme	supreme
tempo	tempo
tractate	traktate
transition	transityon
vento	vento
violentia	vyolentya
wiki	wiki
Alora	alora
Cambridge	kambridge
Circa	cirka
City	citi
Egypto	egipto
Ibi	ibi
VI	seks
adjutava	adZutava
adresse	adrese
antiquitate	antikwitate
apparato	aparato
assere	asere
bandiera	bandyera
bibliotheca	biblyoteka
characteres	Carakteres
cognoscer	kognoscer
cognosceva	kognosceva
considerabile	konsiderabile
copyright	kopirait
definir	definir
demandava	demandava
depois	depois
deserto	deserto
detalios	detalyos
di	di
difficultates	difikultates
diffusion	difusyon
dura	dura
duration	duratyon
effortios	efortyos
espanioles	espanyoles
esseres	eseres
estranie	estranye
experientias	eksperyentyas
global	global
habilitate	habilitate
historico	historiko
introducite	introducite
invention	inventyon
lente	lente
marin	marin
menacia	menacya
musicos	musikos
nuclear	nuklear
organic	organik
paradoxo	paradokso
passage	pasaZe
pena	pena
periculo	perikulo
permanente	permanente
picturas	pikturas
portate	portate
prefere	prefere
prefixo	prefikso
presidentia	presidentya
provincias	provincyas
publica	publika
quantic	kwantik
representantes	representantes
retornar	retornar
selection	selektyon
silicium	silicyum
societates	socyetates
solide	solide
stationes	statyones
throno	trono
totes	totes
variantes	varyantes
vision	visyon
Antonio	antonyo
Augusto	agusto
Brown	brown
Central	central
Gratias	gratyas
Oriente	oryente
Ultra	ultra
alcunos	alkunos
assassinate	asasinate
assecurar	asekurar
calor	kalor
cameras	kameras
catena	katena
catholicos	katolikos
circulo	cirkulo
civilisation	civilisatyon
computatores	komputatores
connectite	konektite
cursos	kursos
dansa	dansa
decide	decide
determina	determina
distribuite	distribwite
episcopos	episkopos
error	eror
execution	eksekutyon
extra	ekstra
frigide	frigide
fronte	fronte
gallium	galyum
habitate	habitate
hiberno	hiberno
i	i
impostos	impostos
incontro	inkontro
infra	infra
instruction	instruktyon
irregular	iregular
jocate	Zokate
judicio	Zudicyo
limite	limite
logic	logik
manuscriptos	manuskriptos
minutas	minutas
normas	normas
participar	participar
peccato	pekato
permitter	permiter
planetas	planetas
planos	planos
productos	produktos
rar	rar
realisava	realisava
secun	sekun
sembla	sembla
sinistra	sinistra
slovene	slovene
substantias	substantyas
technologia	teknologia
terreno	tereno
transmission	transmisyon
tropic	tropik
vitas	vitas
Athena	atena
Benque	beNkwe
Bolívar	bolivar
Corte	korte
El	el
Gulielmo	gulyelmo
Linné	line
Portugal	portugal
Toki	toki
Vasa	vasa
XX	vinti
adolescentes	adolescentes
agricultura	agrikultura
ambes	ambes
ancestre	ancestre
artificial	artificyal
catto	kato
causar	kasar
cinema	cinema
comenciamento	komencyamento
compositos	kompositos
comprende	komprende
contribueva	kontribweva
coperi	koperi
debatto	debato
decisiones	decisyones
desiro	desiro
distribution	distributyon
dynamic	dinamik
effective	efektive
establir	establir
eveniva	eveniva
executive	eksekutive
experimental	eksperimental
extreme	ekstreme
governator	governator
gris	gris
ido	ido
influentias	inflwentyas
institution	institutyon
internet	internet
introduction	introduktyon
iva	iva
kitsune	kitsune
licentia	licentya
marcate	markate
mechanica	mekanika
metallos	metalos
mille	mile
monstrava	monstrava
nickel	nikel
nobile	nobile
novem	novem
nube	nube
oceano	oceano
oculo	okulo
pedophile	pedofile
placiate	placyate
polonese	polonese
posto	posto
proposito	proposito
reguardate	regwardate
resta	resta
saison	sezon
sclavos	sklavos
serviva	serviva
significantia	signifikantya
significar	signifikar
simultaneemente	simultaneemente
studiar	studyar
ulterior	ulteryor
universitates	universitates
vocal	vokal
Citate	citate
Democratic	demokratik
Fluvio	fluvyo
Islam	islam
Language	laNgwage
Lingua	liNgwa
Louis	lwi
Mundo	mundo
Norvegia	norvegya
Polonia	polonya
Pona	pona
Scotia	skotya
Shakespeare	Sakespeare
Tony	toni
XIX	decenovem
Zeus	Zeus
activismo	aktivismo
actualitate	aktwalitate
alliantia	alyantya
amonta	amonta
appoiava	apoava
arrivar	arivar
arrivata	arivata
artes	artes
atomic	atomik
beltate	beltate
calculo	kalkulo
causas	kasas
clarmente	klarmente
conscientia	konscyentya
continuar	kontinwar
contributiones	kontributyones
controlar	kontrolar
decennios	decenyos
dimension	dimensyon
discoperiva	diskoperiva
disveloppar	disvelopar
diversitate	diversitate
editate	editate
entrar	entrar
eterne	eterne
expertos	ekspertos
fixe	fikse
fluxo	flukso
fortalessa	fortalesa
fungos	fuNgos
habera	habera
hora	hora
identificate	identifikate
incognite	inkognite
initia	initya
intellectual	intelektwal
intelligente	inteligente
jornales	Zornales
laborar	laborar
lectores	lektores
liberal	liberal
magazin	magazin
maladias	maladias
manganese	maNganese
massive	masive
minoritate	minoritate
motor	motor
nominava	nominava
obtenite	obtenite
oleo	oleo
oral	oral
phosphoro	phosforo
pone	pone
porto	porto
povre	povre
practicas	praktikas
precedente	precedente
presidential	presidentyal
prominente	prominente
promotion	promotyon
reforma	reforma
regularmente	regularmente
requirite	rekwirite
schema	sCema
sexo	sekso
solar	solar
suffreva	sufreva
superfacie	superfacye
surgeva	surgeva
syllaba	silaba
theologia	teologia
titulos	titulos
torno	torno
transformation	transformatyon
transporto	transporto
truppas	trupas
usos	usos
variationes	varyatyones
vaste	vaste
zirconium	zirkonyum
Bibliotheca	biblyoteka
Carinthia	karintya
Centro	centro
Constitution	konstitutyon
Evangelio	evaNgelyo
Istes	istes
Istos	istos
Jerusalem	Zerusalem
Latin	latin
Libro	libro
Lo	lo
Originalmente	originalmente
Que	ke
Rock	rokk
Sparta	sparta
Tiberio	tiberyo
V	ve
Vide	vide
accompaniate	akompanyate
apparentia	aparentya
attaccos	atakos
avantiate	avantyate
axe	akse
benes	benes
binari	binari
c	se
chimia	kimia
chromium	kromyum
circulation	cirkulatyon
contrasto	kontrasto
coperite	koperite
copia	kopya
criticos	kritikos
decade	dekade
denomina	denomina
describeva	deskribeva
dirigeva	dirigeva
distinctive	distinktive
dramas	dramas
duce	duce
efficace	efikace
exister	eksister
fluvios	fluvyos
indian	indyan
infection	infektyon
inseniava	insenyava
labora	labora
largemente	largemente
litteralmente	literalmente
locate	lokate
manual	manwal
masculo	maskulo
mineral	mineral
mm	emem
modificate	modifikate
montanias	montanyas
notate	notate
observate	observate
occupate	okupate
patronos	patronos
pedes	pedes
pensar	pensar
perdita	perdita
proteina	protena
pseudonymo	pseudonimo
publicationes	publikatyones
quadratos	kwadratos
racias	racyas
radical	radikal
risco	risko
s	es
scandium	skandyum
scripto	skripto
seligite	seligite
sensibile	sensibile
serea	serea
servitor	servitor
sic	sik
sulfure	sulfure
symbolic	simbolik
te	te
tendentia	tendentya
teneva	teneva
tenite	tenite
titanium	titanyum
transmittite	transmitite
travalios	travalyos
vias	vias
visual	viswal
Ambe	ambe
Amsterdam	amsterdam
Battalia	batalya
Brian	bryan
Colombia	kolombya
Couturat	kouturat
Era	era
Luna	luna
Nederland	Nederland
Paises	pases
Peter	peter
Press	press
accento	acento
adder	ader
adoptava	adoptava
age	age
augmenta	agmenta
autonomia	atonomia
censo	censo
chacos	Sakos
chloro	kloro
clause	klase
collectiones	kolektyones
commenciava	komencyava
compositor	kompositor
condemnate	kondemnate
construer	konstrwer
costo	kosto
criticas	kritikas
denomination	denominatyon
discipulos	discipulos
discussion	diskusyon
disputa	disputa
dolor	dolor
electromagnetic	elektromagnetik
episodio	episodyo
equilibrio	ekwilibryo
expedition	ekspedityon
files	fails
financiari	financyari
football	futbol
frontiera	frontyera
fructos	fruktos
generic	generik
germanic	germanik
grave	grave
horologio	horologyo
humide	humide
immediate	imedyate
indianos	indyanos
indicate	indikate
inseniar	insenyar
intense	intense
interessante	interesante
interessate	interesate
inventate	inventate
inviate	invyate
lassa	lasa
lector	lektor
limites	limites
magic	magik
manteneva	manteneva
masculos	maskulos
mechanismo	meCanismo
mixtura	mikstura
mobile	mobile
municipal	municipal
muro	muro
necessita	necesita
notion	notyon
nubes	nubes
objectivos	obZektivos
observationes	observatyones
offereva	ofereva
officio	oficyo
opposite	oposite
orientate	oryentate
origines	origines
papiro	papiro
plan	plan
proba	proba
probabile	probabile
producto	produkto
promover	promover
pronunciation	pronuncyatyon
quand	kwand
radiation	radyatyon
radioamatores	radyoamatores
recognosceva	rekognosceva
referentias	referentyas
reimplaciate	remplacyate
rende	rende
representationes	representatyones
ressources	ressurses
sapeva	sapeva
secrete	sekrete
sectiones	sektyones
sector	sektor
separation	separatyon
sera	sera
sona	sona
sonos	sonos
spatial	spatyal
strictemente	striktemente
studiate	studyate
substantia	substantya
suggere	sugere
supporto	suporto
temperaturas	temperaturas
tende	tende
tornados	tornados
tubo	tubo
una	una
unes	unes
utilisar	utilisar
virus	virus
vitro	vitro
volumine	volumine
votos	votos
Anne	ane
Assemblea	asemblea
Cage	kage
Cid	cid
Communitate	komunitate
Existe	eksiste
Historia	historya
Hollywood	holiwood
ISO	iso
Kansas	kansas
Latino	latino
Martin	martin
Minor	minor
PIE	pye
Revolution	revolutyon
Sicilia	sicilya
Sur	sur
Tamben	tamben
Tres	tres
Turre	ture
VIH	vih
Vetule	vetule
acceptava	aceptava
acido	acido
animate	animate
annunciava	anuncyava
approximatemente	aproksimatemente
arbores	arbores
armeas	armeas
arrestate	arestate
cade	kade
capitulos	kapitulos
cercava	cerkava
collo	kolo
combina	kombina
comenciate	komencyate
comprehende	komprehende
consistente	konsistente
contactos	kontaktos
cosmic	kosmik
creator	kreator
cura	kura
democratic	demokratik
diametro	dyametro
digital	digital
dispareva	dispareva
distinguer	distiNgwer
donava	donava
essentialmente	esentyalmente
exprime	eksprime
frontieras	frontyeras
fundatores	fundatores
illegal	ilegal
impedir	impedir
influentiava	inflwentyava
legenda	legenda
liberation	liberatyon
ligamine	ligamine
meliorar	melyorar
mixte	mikste
montaniose	montanyose
morite	morite
nasce	nasce
operationes	operatyones
opiniones	opinyones
ordinari	ordinari
orthodoxe	ortodokse
palatio	palatyo
partiva	partiva
pensava	pensava
periculose	perikulose
periodic	peryodik
possedeva	posedeva
posteriormente	posteryormente
progressive	progresive
propone	propone
propositiones	proposityones
puncta	punkta
quitava	kwitava
realmente	realmente
representante	representante
resultante	resultante
reuniones	renyones
rito	rito
saepe	saepe
secretario	sekretaryo
septimana	septimana
servite	servite
situationes	sitwatyones
soldato	soldato
sposo	sposo
successos	sucesos
supernomine	supernomine
tentativa	tentativa
theoric	teorik
traditionalmente	tradityonalmente
unitari	unitari
urbes	urbes
vader	vader
visitava	visitava
ADN	adn
Bon	bon
Britannic	britannik
Canada	kanada
Esseva	eseva
Fame	fame
Francisco	francisko
Hic	hik
Insulas	insulas
Justitia	Zustitya
Luther	luter
Miguel	migwel
Paul	pal
Platon	platon
Posteriormente	posteryormente
Region	regyon
Tal	tal
Texto	teksto
acute	akute
angulo	angulo
apertura	apertura
architecto	arCitekto
assertion	asertyon
augmentar	agmentar
conjunctemente	konZunktemente
constitutional	konstitutyonal
cooperation	kooperatyon
costumes	kostumes
credite	kredite
criticate	kritikate
designa	designa
detra	detra
dictionarios	diktyonaryos
discoperta	diskoperta
editorial	editoryal
effortio	efortyo
emphase	emfase
estima	estima
extendite	ekstendite
forestes	forestes
functionamento	funktyonamento
ideal	ideal
identificar	identifikar
imperial	imperyal
imprimite	imprimite
influente	inflwente
instructiones	instruktyones
intention	intentyon
interrate	interate
ir	ir
jalne	Zalne
magnesium	magnesyum
manca	manka
mangiar	manZar
mantene	mantene
memorias	memoryas
modificar	modifikar
nobilitate	nobilitate
note	note
occupation	okupatyon
opponente	oponente
orbita	orbita
organos	organos
pagar	pagar
passos	pasos
perfecte	perfekte
phenomenos	fenomenos
placer	placer
planta	planta
possibilemente	posibilemente
presentar	presentar
pressa	presa
probas	probas
prova	prova
psychologic	psikologik
quadrate	kwadrate
quantitates	kwantitates
rango	raNgo
recentemente	recentemente
recercas	recerkas
refusava	refusava
regulate	regulate
respectivemente	respektivemente
responsabilitate	responsabilitate
retes	retes
revela	revela
seriose	seryose
sport	sport
stabilitate	stabilitate
stratas	stratas
stylo	stilo
succession	sucesyon
superviveva	superviveva
territorial	teritoryal
totalitate	totalitate
turres	tures
ut	ut
valle	vale
van	van
vector	vektor
verbal	verbal
video	video
y	ipsilon
Achille	aCile
Actualmente	aktwalmente
Athenas	atenas
Berlin	berlin
California	kalifornya
Die	die
Etate	etate
Frits	frits
Fundation	fundatyon
Guerras	gweras
Harry	hari
Hectore	hektore
Insula	insula
Libere	libere
Luca	luka
OMS	oms
Renascentia	renascentya
Scripturas	skripturas
Super	super
Tjörn	tZorn
acclamate	aklamate
accusate	akusate
actos	aktos
adaptate	adaptate
agricole	agrikole
alco	alko
algorithmos	algoritmos
alliatos	alyatos
ancestres	ancestres
applica	aplika
apprendeva	aprendeva
arco	arko
arrangiamento	aranZamento
attingite	atiNgite
augmentava	agmentava
brevemente	brevemente
celle	cele
cellula	celula
cellular	celular
characterisa	Carakterisa
circular	cirkular
coincide	koncide
comenciar	komencyar
conducta	kondukta
conserva	konserva
consonante	konsonante
consonantes	konsonantes
cornamusa	kornamusa
creante	kreante
credente	kredente
deber	deber
decisive	decisive
dedicava	dedikava
defende	defende
destruction	destruktyon
discoperi	diskoperi
discoperir	diskoperir
distinguite	distiNgwite
emergentia	emergentya
emplea	emplea
ensemble	ansamble
eruditos	eruditos
eventualmente	eventwalmente
examine	eksamine
exilio	eksilyo
exposition	eksposityon
expressiones	ekspresyones
ferro	fero
filias	filyas
functional	funktyonal
gas	gas
gases	gases
idiomas	idyomas
indicar	indikar
insenia	insenya
interslavo	interslavo
intervention	interventyon
jornalista	Zornalista
kalium	kalyum
laboratorio	laboratoryo
linguistica	lingwistika
listas	listas
luctava	luktava
machinas	makinas
magazines	magazins
materne	materne
medic	medik
melodic	melodik
meridional	meridyonal
metallic	metalik
minime	minime
mission	misyon
municipalitate	municipalitate
muros	muros
museo	museo
narra	nara
narration	naratyon
natrium	natryum
nominar	nominar
novemente	novemente
obtene	obtene
parco	parko
partialmente	partyalmente
participantes	participantes
patiente	patyente
pederastia	pederastia
personalitate	personalitate
pictor	piktor
planification	planifikatyon
poneva	poneva
portas	portas
portion	portyon
precoce	prekoce
preter	preter
productor	produktor
progresso	progreso
prohibite	prohibite
pronomine	pronomine
pulvere	pulvere
reducite	reducite
renominate	renominate
restava	restava
sancte	sankte
sapite	sapite
signava	signava
sphera	sfera
stilos	stilos
suffre	sufre
summa	suma
supernatural	supernatural
tenta	tenta
tono	tono
totos	totos
toures	toures
tractatos	traktatos
ventos	ventos
viages	vyaZes
Annos	anos
C	se
Castello	kastelo
Commission	komisyon
Congresso	koNgreso
Derectos	derektos
Duce	duce
Est	est
Exemplos	eksemplos
Juan	Zwan
King	kiNg
Liga	liga
Ludovico	ludoviko
Manifesto	manifesto
Ordine	ordine
Prince	prince
Richard	riCard
Sovente	sovente
Trump	trump
Zamenhof	zamenhof
abuso	abuso
adjacente	adZacente
adjutate	adZutate
ager	ager
alimentos	alimentos
altemente	altemente
antenna	antena
aperite	aperite
appropriate	apropryate
aquas	akwas
assignate	asignate
atmosphera	atmosfera
authentic	atentik
avantiamento	avantyamento
battalias	batalyas
batteria	bateria
bloco	bloko
blues	blwes
bordo	bordo
brancas	brankas
canal	kanal
celate	celate
celebre	celebre
centros	centros
cerebro	cerebro
cessava	cesava
chordas	Cordas
claudite	kladite
cogniscite	kogniscite
colonos	kolonos
committee	komiti
complexo	komplekso
conferentias	konferentyas
congresso	koNgreso
consisteva	konsisteva
continuitate	kontinwitate
corruption	koruptyon
credentes	kredentes
crise	krise
criterios	kriteryos
declaration	deklaratyon
declinava	deklinava
democratia	demokratia
densitate	densitate
des	des
descriptiones	deskriptyones
desira	desira
digitos	digitos
divisiones	divisyones
donate	donate
drogas	drogas
eminente	eminente
entitates	entitates
essaya	esaya
exceptiones	eksceptyones
exemplares	eksemplares
facente	facente
fragmentos	fragmentos
gradualmente	gradwalmente
imposto	imposto
indigena	indigena
invasion	invasyon
legendas	legendas
legislative	legislative
legite	legite
liberate	liberate
longor	loNgor
luna	luna
maritate	maritate
mediante	medyante
mus	mus
musico	musiko
neon	neon
objective	obZektive
opponentes	oponentes
originava	originava
papa	papa
parlante	parlante
participation	participatyon
patientes	patyentes
permission	permisyon
perspectiva	perspektiva
petroleo	petroleo
photographia	photografia
phrases	frases
pop	pop
pronunciate	pronuncyate
pugno	pugno
reducer	reducer
resolution	resolutyon
restos	restos
revistas	revistas
rural	rural
saliva	saliva
san	san
scenas	scenas
sedes	sedes
studente	studente
symptomas	simptomas
tabella	tabela
telescopio	teleskopyo
tendentias	tendentyas
universitari	universitari
variabile	varyabile
vicinitate	vicinitate
visita	visita
Addams	adams
Age	age
Anna	ana
Argentina	argentina
Florentia	florentya
German	german
Helena	helena
Jean	Zean
Lege	lege
Mae	mae
Medievo	medyevo
Mesmo	mesmo
Papa	papa
Pedro	pedro
Petro	petro
Schola	sCola
Scriptura	skriptura
Singapur	siNgapur
Sovietic	sovyetik
Sub	sub
Tom	tom
Vasari	vasari
acceptation	aceptatyon
adde	ade
aer	aer
aeree	aeree
agente	agente
agitation	agitatyon
alcunes	alkunes
appello	apelo
appreciate	aprecyate
assistentia	asistentya
associationes	asocyatyones
avantage	avantaZe
avantiar	avantyar
bilingue	biliNgwe
brillante	brilante
castellos	kastelos
celebrate	celebrate
circulos	cirkulos
colpos	kolpos
communicar	komunikar
communitari	komunitari
concerne	koncerne
conclusion	konklusyon
conduceva	konduceva
conferentia	konferentya
consenso	konsenso
constituyentes	konstituyentes
contava	kontava
convention	konventyon
defensive	defensive
descendentes	descendentes
descendentia	descendentya
designar	designar
diabete	dyabete
dirige	dirige
disposition	disposityon
dissolution	disolutyon
disveloppa	disvelopa
dominava	dominava
drama	drama
dubita	dubita
dulce	dulce
edificate	edifikate
educative	edukative
elemental	elemental
evidente	evidente
explicar	eksplikar
exprimite	eksprimite
factor	faktor
fiction	fiktyon
flotta	flota
fortiate	fortyate
generationes	generatyones
hospite	hospite
incorporate	inkorporate
independentemente	independentemente
inseniate	insenyate
integrate	integrate
integration	integratyon
interesses	intereses
intime	intime
isse	ise
joca	Zoka
juxta	Zuksta
lanceate	lanceate
leader	leader
lentemente	lentemente
li	li
licentias	licentyas
medical	medikal
micre	mikre
millennio	milenyo
milliardos	milyardos
molle	mole
moveva	moveva
mythos	mitos
nemo	nemo
novella	novela
obligatori	obligatori
observar	observar
occasiones	okasyones
operator	operator
or	or
ordinate	ordinate
ordinava	ordinava
ordines	ordines
organismo	organismo
parlamentari	parlamentari
passive	pasive
patas	patas
pertineva	pertineva
phases	fases
photographias	photografias
photos	fotos
platteforma	plateforma
portar	portar
possibilitates	posibilitates
pp	pepe
precios	precyos
preparation	preparatyon
pretendentes	pretendentes
prince	prince
propagation	propagatyon
protegite	protegite
registrava	registrava
resurrection	resurektyon
retirava	retirava
revolta	revolta
ritos	ritos
riviera	rivyera
rugby	rugbi
sacre	sakre
sagessa	saZesa
sentimentos	sentimentos
serpente	serpente
seta	seta
sonate	sonate
specificamente	specifikamente
statal	statal
suffice	sufice
tabuliero	tabulyero
termina	termina
tornava	tornava
trenta	trenta
usual	uswal
vacuo	vakwo
vale	vale
venir	venir
vulgar	vulgar
Abu	abu
Australia	astralya
B	be
Christian	kristyan
Derecto	derekto
Don	don
Frequentemente	frekwentemente
Gruppo	grupo
Hans	hans
Jehovah	Zehovah
Jonathan	Zonatan
Karl	karl
Lord	lord
Los	los
Mary	mari
Multo	multo
Quasi	kwasi
Regal	regal
SIDA	sida
Santa	santa
Sin	sin
St	este
Tacito	tacito
Vos	vos
X	iks
XML	iksemel
abandonava	abandonava
absentia	absentya
acceptar	aceptar
alique	alike
alter	alter
amicitate	amicitate
aperiva	aperiva
apparente	aparente
applicabile	aplikabile
attribuite	atribwite
bases	bases
besonia	besonya
biologic	byologik
bits	bits
brun	brun
ca	ka
cadita	kadita
cammino	kamino
captura	kaptura
cavallero	kavalero
combatter	kombater
commandante	komandante
complexitate	kompleksitate
componente	komponente
componeva	komponeva
comprendeva	komprendeva
connexe	konekse
connexiones	koneksyones
contar	kontar
controlate	kontrolate
convertite	konvertite
cosino	kosino
costose	kostose
creaturas	kreaturas
creder	kreder
cursa	kursa
descendente	descendente
detaliate	detalyate
discopertas	diskopertas
discussiones	diskusyones
domination	dominatyon
dominios	dominyos
dynastia	dinastia
elaborate	elaborate
emergeva	emergeva
emphysema	emfisema
entra	entra
episodios	episodyos
establimento	establimento
executar	eksekutar
experimento	eksperimento
extendeva	ekstendeva
extense	ekstense
factores	faktores
ferroviari	ferovyari
franc	frank
gamma	gama
gania	ganya
gigante	gigante
grammatic	gramatik
hereditate	hereditate
ideologia	ideologia
incorpora	inkorpora
inimicos	inimikos
intermediari	intermedyari
introducer	introducer
irlandese	irlandese
laco	lako
legier	leZer
leon	leon
liquido	likwido
longemente	loNgemente
luctar	luktar
malade	malade
mammales	mamales
manifesta	manifesta
mappa	mapa
matrimonio	matrimonyo
mentiona	mentyona
metallo	metalo
modos	modos
mortal	mortal
mortes	mortes
motivo	motivo
motores	motores
musulmanes	musulmanes
necessarimente	necesarimente
nobiles	nobiles
obligate	obligate
occasion	okasyon
occide	ocide
paisage	pasaZe
partitas	partitas
partition	partityon
pedones	pedones
penal	penal
perception	perceptyon
philosophos	philosofos
poetas	poetas
precio	precyo
preparate	preparate
primavera	primavera
promove	promove
proponeva	proponeva
provar	provar
providite	providite
qualitates	kwalitates
quinte	kwinte
radios	radyos
reactiones	reaktyones
realisa	realisa
reception	receptyon
redaction	redaktyon
reflecte	reflekte
representava	representava
reproduction	reproduktyon
respondeva	respondeva
rhythmo	ritmo
satis	satis
senti	senti
spiral	spiral
statua	statwa
suffixos	sufiksos
superava	superava
superficial	superficyal
supponite	suponite
supportar	suportar
switze	switze
tertio	tertyo
theatral	teatral
tra	tra
tractava	traktava
tropical	tropikal
utensiles	utensiles
vehiculo	vehikulo
versos	versos
viagiar	vyaZar
vostre	vostre
Anglese	aNglese
Basel	basel
Bison	bison
Camera	kamera
Castilia	kastilya
Claudio	kladyo
Comocunque	komokuNkwe
Confederation	konfederatyon
Contato	kontato
Copertura	kopertura
Dorking	dorkiNg
Dum	dum
Evangelios	evaNgelyos
Giovanni	gyovani
Joh	Zoh
Julio	Zulyo
Leonardo	leonardo
Les	les
Marilyn	marilin
Michael	miCael
Monte	monte
Palatio	palatyo
Ponte	ponte
Presidente	presidente
Van	van
XIV	decekwatro
alcuno	alkuno
alimentation	alimentatyon
ama	ama
apparer	aparer
armenie	armenye
arrangiate	araNgyate
attacca	ataka
ave	ave
bisonte	bisonte
branca	branka
cambiamento	kambyamento
capitulo	kapitulo
capturate	kapturate
cavitate	kavitate
circumstantias	cirkumstantyas
citatano	citatano
cognoscimento	kognoscimento
comprar	komprar
comprension	komprensyon
concrete	konkrete
configuration	konfiguratyon
connexion	koneksyon
consequente	konsekwente
conservative	konservative
constantemente	konstantemente
contineva	kontineva
controverse	kontroverse
converteva	konverteva
copertura	kopertura
cornos	kornos
correspondentia	korespondentya
crescer	krescer
cultivate	kultivate
decime	decime
demonstrate	demonstrate
dense	dense
desinentia	desinentya
developpate	developate
disciplinas	disciplinas
discrimination	diskriminatyon
discursos	diskursos
dona	dona
elevation	elevatyon
emission	emisyon
estranier	estranyer
evita	evita
excambio	ekskambyo
expandite	ekspandite
explicate	eksplikate
explication	eksplikatyon
explicitemente	eksplicitemente
explosion	eksplosyon
fabrica	fabrika
filos	filos
formante	formante
functionalitate	funktyonalitate
genes	genes
geometria	geometria
governar	governar
governava	governava
gran	gran
granos	granos
gusto	gusto
historicamente	historikamente
horizontal	horizontal
humor	humor
hydrogeno	hidrogeno
impression	impresyon
ingeniero	iNgenyero
inseniamentos	insenyamentos
intende	intende
involvite	involvite
justo	Zusto
lacte	lakte
liquide	likwide
lontan	lontan
magazine	magazin
maximo	maksimo
medico	mediko
mesuras	mesuras
migration	migratyon
multitude	multitude
occider	ocider
occurrer	okurer
offensiva	ofensiva
opponeva	oponeva
optic	optik
orientation	oryentatyon
parallel	paralel
parente	parente
pareva	pareva
participa	participa
participio	participyo
perse	perse
precision	precisyon
preste	preste
pretende	pretende
proclamava	proklamava
promovite	promovite
proteinas	protenas
puera	puera
punk	puNk
quartiero	kwartyero
rational	ratyonal
recensiones	recensyones
reduction	reduktyon
referendum	referendum
registration	registratyon
reguarda	regwarda
removite	removite
reservate	reservate
respective	respektive
responde	responde
reticulo	retikulo
scandalo	skandalo
scripturas	skripturas
secular	sekular
secundas	sekundas
sensos	sensos
sequentia	sekwentya
signate	signate
significatos	signifikatos
spisse	spise
sportive	sportive
stabile	stabile
static	statik
strata	strata
strategia	strategia
suffixo	sufikso
supervive	supervive
supporta	suporta
talento	talento
terminate	terminate
testa	testa
timor	timor
traducer	traducer
traduceva	traduceva
transferite	transferite
utilisation	utilisatyon
victima	viktima
vigor	vigor
virtute	virtute
zero	zero
Alexander	aleksander
Alfred	alfred
Ancora	ankora
Atlantic	atlantik
Bakonyi	bakonyi
Brongersma	broNgersma
Cascadas	kaskadas
Concilio	koncilyo
Corea	korea
Daejeon	daeZeon
Disney	disney
Districto	distrikto
EC	ek
Francese	francese
Georgio	georgyo
Herodoto	herodoto
Hertz	hertz
Historicamente	historikamente
Intertanto	intertanto
Jacobo	Zakobo
Jam	Zam
Jedi	Zedi
Margareta	margareta
Nationes	natyones
Nulle	nule
Ora	ora
Pace	pace
Parola	parola
Priamo	pryamo
Records	rekords
Secun	sekun
Tu	tu
Universal	universal
VII	septe
Victoria	viktorya
Wilson	wilson
XVI	deceseks
Zelanda	zelanda
abbreviate	abrevyate
abbreviation	abrevyatyon
abundante	abundante
accusationes	akusatyones
activista	aktivista
actores	aktores
adequate	adekwate
administrator	administrator
adoptar	adoptar
advocato	advokato
affirmava	afirmava
alternativa	alternativa
anatomia	anatomia
appoia	apoa
approbation	aprobatyon
astronomic	astronomik
attaccate	atakate
attrahite	atrahite
auree	aree
automaticamente	atomatikamente
balla	bala
bestial	bestyal
campion	kampyon
carta	karta
centimetros	centimetros
codification	kodifikatyon
cognate	kognate
collaboration	kolaboratyon
comocunque	komokuNkwe
companias	kompanias
companion	kompanyon
complicate	komplikate
compositores	kompositores
conflictos	konfliktos
conforme	konforme
conjugation	konZugatyon
consideration	konsideratyon
constitueva	konstitweva
costas	kostas
costume	kostume
declino	deklino
demandar	demandar
derivation	derivatyon
descende	descende
desirava	desirava
dieta	dyeta
difficultate	difikultate
dimensiones	dimensyones
discutite	diskutite
distantias	distantyas
domesticate	domestikate
du	du
equipas	ekwipas
esperantistas	esperantistas
essayo	esayo
europeos	europeos
evangelio	evaNgelyo
evolveva	evolveva
excellente	ekscelente
explicite	eksplicite
exploration	eksploratyon
extinction	ekstinktyon
extrememente	ekstrememente
faciente	facyente
favorabile	favorabile
ferite	ferite
file	fail
filo	filo
gothic	gotik
idioma	idyoma
immigration	imigratyon
impedi	impedi
indefinite	indefinite
indice	indice
infinite	infinite
influential	inflwentyal
initiate	inityate
inscription	inskriptyon
inspiration	inspiratyon
installation	instalatyon
internationalmente	internatyonalmente
islamic	islamik
judicial	Zudicyal
juncte	Zunkte
lancea	lancea
las	las
lectiones	lektyones
lectura	lektura
leve	leve
luce	luce
luctas	luktas
manifestation	manifestatyon
marita	marita
mechanic	mekanik
mechanismos	meCanismos
ministerio	ministeryo
monasterio	monasteryo
monumentos	monumentos
negotios	negotyos
neutral	netral
nodo	nodo
nomen	nomen
novellas	novelas
observation	observatyon
organisa	organisa
partial	partyal
peccatos	pekatos
pertinente	pertinente
pesante	pesante
phonetic	fonetik
pipiones	pipyones
politico	politiko
possession	posesyon
potentias	potentyas
preciose	precyose
predominante	predominante
primemente	primemente
principe	principe
protagonista	protagonista
qualcosa	kwalkosa
rapiditate	rapiditate
realisation	realisatyon
registrar	registrar
rejectate	reZektate
render	render
reunion	renyon
romantic	romantik
salvate	salvate
scientista	scyentista
signal	signal
significative	signifikative
sino	sino
spectaculo	spektakulo
stoppar	stopar
subito	subito
substantial	substantyal
sue	sue
superviver	superviver
supportate	suportate
surge	surge
temperate	temperate
tene	tene
terminologia	terminologia
unicamente	unikamente
utilisante	utilisante
vacca	vaka
vade	vade
variate	varyate
veces	veces
venite	venite
verificar	verifikar
vinti	vinti
wikis	wikis
Alexandria	aleksandrya
Ambes	ambes
Angeles	aNgeles
Antique	antikwe
Aphrodite	afrodite
Aragon	aragon
Brahe	brahe
Casa	kasa
Cor	kor
Costa	kosta
Elizabeth	elizabet
Espaniol	espanyol
Gabriel	gabryel
Galles	gales
Gay	gay
Granada	granada
Groenlandia	groenlandya
Intra	intra
Joco	Zoko
José	Zose
Leonidas	leonidas
Lisbona	lisbona
Love	love
Mat	mat
Mattheo	mateo
Normalmente	normalmente
Occidente	ocidente
Oceano	oceano
Odense	odense
PIB	pib
Pacific	pacifik
Personas	personas
RFC	erefse
Re	re
Representantes	representantes
Roll	rol
Romulo	romulo
Septe	septe
Society	socyeti
Supreme	supreme
Toto	toto
Tribunal	tribunal
UMI	umi
Urano	urano
Version	versyon
Washington	waSiNgton
Windows	windows
XVII	decesepte
accidente	acidente
acquirite	akkwirite
alas	alas
alicunes	alikunes
ambito	ambito
apogeo	apogeo
appoiar	apoar
apprentissage	aprentisaZe
arbitrari	arbitrari
arrivate	arivate
asino	asino
assume	asume
astronomia	astronomia
attaccar	atakar
attraction	atraktyon
attributos	atributos
bolla	bola
bracio	bracyo
cadeva	kadeva
canales	kanales
capites	kapites
cargate	kargate
cassa	kasa
catalan	katalan
chaco	Sako
chimpanzes	Simpanzes
cifra	cifra
colon	kolon
columna	kolumna
combinate	kombinate
comic	komik
competition	kompetityon
compilation	kompilatyon
completar	kompletar
compositiones	komposityones
concentration	koncentratyon
concerto	koncerto
confirmate	konfirmate
confrontava	konfrontava
conquesta	koNkwesta
conquireva	koNkwireva
conspiration	konspiratyon
continueva	kontinweva
contractiones	kontraktyones
contribue	kontribwe
controversia	kontroversya
crimine	krimine
curiositate	kuryositate
denominava	denominava
dextre	dekstre
directiones	direktyones
doctor	doktor
domos	domos
dramatic	dramatik
electricitate	elektricitate
electrones	elektrones
elegite	elegite
elementari	elementari
empleate	empleate
empleo	empleo
epochas	epokas
ethica	etika
exception	eksceptyon
expandeva	ekspandeva
extensive	ekstensive
extincte	ekstinkte
faction	faktyon
febre	febre
felicitate	felicitate
fidel	fidel
fideles	fideles
filas	filas
fossile	fosile
galaxias	galaksyas
gentes	gentes
geographia	geografia
guitarras	ghitaras
habitual	habitwal
hebreo	hebreo
immigrantes	imigrantes
impacto	impakto
incendio	incendyo
indicante	indikante
infundibulo	infundibulo
initiativa	inityativa
instantia	instantya
interaction	interaktyon
interpretationes	interpretatyones
interprisa	interprisa
investigationes	investigatyones
invisibile	invisibile
is	is
judicamento	Zudikamento
judice	Zudice
lassar	lasar
lassate	lasate
liberar	liberar
libertates	libertates
linguistas	lingwistas
magne	magne
magnitude	magnitude
mantenite	mantenite
massas	masas
matur	matur
mexican	meksikan
minimo	minimo
ministros	ministros
moderate	moderate
montania	montanya
monte	monte
mytho	mito
natal	natal
nive	nive
notar	notar
nova	nova
observava	observava
optime	optime
p	pe
pacchetto	paCeto
pacchettos	paCetos
pensata	pensata
peste	peste
phasic	fasik
photo	foto
photographic	photografik
pluvial	pluvyal
poetic	poetik
portrait	portre
practicate	praktikate
preparar	preparar
principato	principato
prisioneros	prisyoneros
pronunciar	pronuncyar
proprietario	propryetaryo
provider	provider
pueras	pueras
quadro	kwadro
quam	kwam
radioamator	radyoamator
rattos	ratos
reaction	reaktyon
recercatores	recerkatores
recognoscer	rekognoscer
registro	registro
reimplaciar	remplacyar
reimplaciava	remplacyava
remaner	remaner
renascentia	renascentya
residentia	residentya
resolver	resolver
responder	responder
ritual	ritwal
satellite	satelite
sentimento	sentimento
servir	servir
significava	signifikava
slovenos	slovenos
socialismo	socyalismo
socialista	socyalista
solutiones	solutyones
sonar	sonar
specificate	specifikate
spectro	spektro
subite	subite
successive	sucesive
sucro	sukro
superviventia	superviventya
tener	tener
tentativas	tentativas
terminava	terminava
these	tese
titulate	titulate
tolerantia	tolerantya
tourismo	turismo
transformate	transformate
travaliar	travalyar
travaliatores	travalyatores
troian	troan
tue	tue
vectores	vektores
vender	vender
vino	vino
vocabulos	vokabulos
voces	voces
volumines	volumines
ASCII	ascyi
Additionalmente	adityonalmente
Adjectivos	adZektivos
Buddha	budha
Chinese	Sinese
Convention	konventyon
Daniel	danyel
Dobkin	dobkin
English	eNgliS
Federal	federal
Federation	federatyon
Festival	festival
Frank	fraNk
Gallia	galya
Hannover	hanover
Henry	henri
Hitler	hitler
House	house
Ido	ido
Initialmente	inityalmente
Invariabile	invaryabile
Jamblicho	ZambliCo
Java	Zava
Jupiter	Zupiter
Jutlandia	Zutlandya
Largo	largo
Leon	leon
León	leon
Liberation	liberatyon
Lublin	lublin
Magne	magne
Marte	marte
Martijn	martiZn
Medie	medye
Mi	mi
Neptuno	neptuno
Niagara	Nyagara
Nostre	nostre
Nuwas	nuwas
ONU	onu
Orthodoxe	ortodokse
Peano	peano
Poseidon	posedon
Pote	pote
Professor	profesor
Quatro	kwatro
Regina	regina
School	sCool
Sectiones	sektyones
Similarmente	similarmente
Superman	superman
São	sao
Traditionalmente	tradityonalmente
Turner	turner
Uppsala	upsala
Varie	varye
abandonar	abandonar
abolition	abolityon
academia	akademia
adresses	adreses
affaire	afer
affectate	afektate
affligite	afligite
algorithmo	algoritmo
alicunos	alikunos
alteremente	alteremente
amplemente	amplemente
analytic	analitik
anonyme	anonime
apparition	aparityon
appellar	apelar
applicar	aplikar
apprende	aprende
aragonese	aragonese
archivos	arCivos
asiatic	asyatik
assumeva	asumeva
attitudes	atitudes
audir	adir
aut	at
baptisate	baptisate
baptismo	baptismo
biographias	byografias
bisontes	bisontes
bucca	buka
byzantin	bizantin
calcular	kalkular
calculate	kalkulate
cardiac	kardiak
cargo	kargo
celebration	celebratyon
celtic	celtik
chefes	Cefes
cocina	kocina
commentarios	komentaryos
communion	komunyon
competentia	kompetentya
complite	komplite
concipite	koncipite
concorda	konkorda
conducto	kondukto
conservation	konservatyon
constituente	konstitwente
constituite	konstitwite
conte	konte
contes	kontes
continuate	kontinwate
converte	konverte
creative	kreative
criterio	kriteryo
crystallin	kristalin
currer	kurer
cyclo	ciklo
damnos	damnos
dante	dante
debilitate	debilitate
decades	dekades
declara	deklara
declarate	deklarate
demonstra	demonstra
der	der
destinate	destinate
destination	destinatyon
destrueva	destrweva
detalio	detalyo
dialogo	dyalogo
diario	dyaryo
dirigente	dirigente
disordine	disordine
dispare	dispare
dissolveva	disolveva
dominate	dominate
dorso	dorso
eligeva	eligeva
emissiones	emisyones
emittite	emitite
energetic	energetik
energic	energik
epistolas	epistolas
equipamento	ekwipamento
essentia	esentya
excessive	ekscesive
executa	eksekuta
exige	eksige
explicava	eksplikava
fabula	fabula
facilita	facilita
ferma	ferma
festas	festas
fila	fila
finir	finir
foramine	foramine
formalmente	formalmente
fraude	frade
frequentias	frekwentyas
genera	genera
gestion	gestyon
glacie	glacye
gloria	glorya
granpatre	granpatre
greges	greges
guidate	gwidate
habitat	habitat
hardware	hardware
hereditario	hereditaryo
homosexuales	homosekswales
hospites	hospites
humano	humano
identifica	identifika
importa	importa
imprisionate	imprisyonate
ingenieria	ingenyeria
innovationes	inovatyones
inspirava	inspirava
integral	integral
interprisas	interprisas
intersection	intersektyon
interslave	interslave
invariabile	invaryabile
inviava	invyava
laboratores	laboratores
lanceava	lanceava
lassante	lasante
legislation	legislatyon
liberemente	liberemente
lithium	lityum
litros	litros
lupo	lupo
mandava	mandava
match	maC
menaciate	menacyate
minuta	minuta
modifica	modifika
moleculas	molekulas
momentos	momentos
monarchias	monarkias
motion	motyon
motivos	motivos
movite	movite
n	en
navigation	navigatyon
norma	norma
nude	nude
occideva	ocideva
occurrite	okurite
orbital	orbital
ossos	osos
ove	ove
pagan	pagan
paisanos	pasanos
parasito	parasito
pares	pares
patria	patrya
perder	perder
permittente	permitente
physico	fisiko
plagias	plaZas
plu	plu
pluvia	pluvya
politicos	politikos
possessive	posesive
posta	posta
practicamente	praktikamente
precipitation	precipitatyon
preda	preda
preferentia	preferentya
premios	premyos
prepositiones	preposityones
presentation	presentatyon
preservation	preservatyon
primates	primates
psychologia	psikologia
publicitate	publicitate
qua	kwa
quaranta	kwaranta
racemo	racemo
rebelliones	rebelyones
recognition	rekognityon
redactor	redaktor
representative	representative
republican	republikan
requireva	rekwireva
resimila	resimila
retorna	retorna
sacco	sako
sacrificio	sakrificyo
sclavitude	sklavitude
secta	sekta
sectores	sektores
secunda	sekunda
seliger	seliger
semantic	semantik
senatores	senatores
sentiva	sentiva
septime	septime
sever	sever
show	Sow
sine	sine
sovietic	sovyetik
spatios	spatyos
sperantia	sperantya
stellar	stelar
strato	strato
subgeneres	subgeneres
substituite	substitwite
sulco	sulko
supervivente	supervivente
tabulas	tabulas
taxa	taksa
technologias	teknologias
tornado	tornado
touristas	turistas
traduce	traduce
traffico	trafiko
traverso	traverso
u	u
uncias	uncyas
valide	valide
vegetation	vegetatyon
vel	vel
vestimentos	vestimentos
visitar	visitar
visitate	visitate
vocabulo	vokabulo
voto	voto
Albert	albert
Arthur	artur
Austria	awstrya
Aves	aves
Bakunin	bakunin
Beatles	beatles
Belgica	belgika
Blue	blwe
Book	book
Celsius	celsyus
Certe	certe
Ciceron	ciceron
Congo	koNgo
Consequentemente	konsekwentemente
Constantino	konstantino
Conte	konte
Corona	korona
Cure	kure
Ecce	ece
Ensemble	ansamble
Fide	fide
Foucault	foukalt
Grammy	grami
Institute	institute
JSP	Zotaespe
Jane	Zane
Kinsey	kinsey
LHC	elhase
Lupin	lupin
Manuel	manwel
Mark	mark
Michel	miCel
Microsoft	mikrosoft
Multes	multes
Nascite	nascite
Neubronner	nebroner
Nigre	nigre
Organisation	organisatyon
Pakistan	pakistan
Philippinas	filipinas
Philippo	filipo
Pois	pois
Polo	polo
Praga	praga
Quanto	kwanto
Research	researC
Sede	sede
Street	street
Systema	sistema
Textos	tekstos
Theatre	teatre
Traduction	traduktyon
Vaticano	vatikano
Venetia	venetya
Vietnam	vyetnam
Vita	vita
Wilhelm	wilhelm
XVIII	deceoTto
Zag	zag
Zig	zig
absolutemente	absolutemente
accordos	akordos
addeva	adeva
adopta	adopta
adverbios	adverbyos
affecta	afekta
aggressive	agresive
ambiental	ambyental
amplitude	amplitude
apparentemente	aparentemente
apparite	aparite
appartamento	apartamento
apportava	aportava
approbate	aprobate
arabic	arabik
archeologic	arkeologik
argumentos	argumentos
armenio	armenyo
assecurava	asekurava
assisteva	asisteva
audientia	adyentya
ballon	balon
bonasus	bonasus
canna	kana
cantator	kantator
cantava	kantava
capturar	kapturar
cargas	kargas
celebrava	celebrava
centrate	centrate
ceremonia	ceremonia
cholera	kolera
cinctura	cinktura
circumferite	cirkumferite
cives	cives
clinic	klinik
codices	kodices
combinationes	kombinatyones
comedias	komedyas
comenciante	komencyante
commercialmente	komercyalmente
communismo	komunismo
companiones	kompanyones
comparate	komparate
computation	komputatyon
concentrate	koncentrate
conduce	konduce
conducer	konducer
confession	konfesyon
confrontar	konfrontar
confusion	konfusyon
conquirite	koNkwirite
conventiones	konventyones
converter	konverter
corage	koraZe
coronate	koronate
cortes	kortes
cumulo	kumulo
cyclos	ciklos
damno	damno
decidite	decidite
defia	defia
definitiones	definityones
definitive	definitive
definiva	definiva
dentes	dentes
deputatos	deputatos
destino	destino
destruer	destrwer
dextera	dekstera
dialogos	dyalogos
digito	digito
discographic	diskografik
discuter	diskuter
divider	divider
divideva	divideva
durar	durar
educate	edukate
egyptian	egiptyan
emotional	emotyonal
epic	epik
equationes	ekwatyones
erronee	eronee
escappar	eskapar
estraniero	estranyero
evolvite	evolvite
exigeva	eksigeva
expectate	ekspektate
experte	eksperte
expone	ekspone
fabrication	fabrikatyon
facilitar	facilitar
facultate	fakultate
felice	felice
finales	finales
flores	flores
fluido	fluido
folklore	folklor
formulas	formulas
forni	forni
fossiles	fosiles
fresc	fresk
fugir	fugir
fundos	fundos
generar	generar
geometric	geometrik
goal	gol
habilitates	habilitates
harmonia	harmonia
hasardo	hasardo
hebree	hebree
hereditava	hereditava
heterosexual	heterosekswal
historiographia	historyografia
hollandese	holandese
iconic	ikonik
immagazinage	imagazinaZe
immagazinate	imagazinate
immense	imense
imposition	imposityon
incarcerate	inkarcerate
incorporava	inkorporava
indicava	indikava
indigenas	indigenas
industrias	industryas
intensitate	intensitate
interactiones	interaktyones
involve	involve
julian	Zulyan
late	late
liga	liga
limita	limita
linear	linear
listate	listate
literalmente	literalmente
litoral	litoral
longeve	loNgeve
mandato	mandato
marcas	markas
membrana	membrana
messages	mesaZes
mesurate	mesurate
millias	milyas
miraculos	mirakulos
monachos	monakos
mori	mori
motto	moto
multos	multos
museos	museos
music	musik
musulman	musulman
mythic	mitik
narrationes	naratyones
naval	naval
necesse	necese
neutre	netre
nomination	nominatyon
notava	notava
occasionalmente	okasyonalmente
officiero	oficyero
pacific	pacifik
parentheses	parenteses
passages	pasaZes
pectore	pektore
pedophilic	pedofilik
pellicula	pelikula
pensatores	pensatores
perditas	perditas
persecution	persekutyon
philosopho	philosofo
pilo	pilo
pionero	pyonero
pisces	pisces
populose	populose
potential	potentyal
potite	potite
predas	predas
prediction	prediktyon
prefixate	prefiksate
preservar	preservar
profunditate	profunditate
programmatura	programatura
promitteva	promiteva
promoveva	promoveva
propaganda	propaganda
proprietarios	propryetaryos
protocollo	protokolo
protocollos	protokolos
proximitate	proksimitate
pullos	pulos
quartieros	kwartyeros
quicunque	kikunkwe
r	er
radioamatorismo	radyoamatorismo
rationamento	ratyonamento
recte	rekte
reduce	reduce
relationate	relatyonate
remover	remover
rendite	rendite
reporto	reporto
resultar	resultar
reteneva	reteneva
reuniva	reniva
revelate	revelate
revolutiones	revolutyones
rhythmos	ritmos
rocca	roka
rotation	rotatyon
rumine	rumine
salas	salas
sanitari	sanitari
scuto	skuto
segmento	segmento
seligeva	seligeva
sententia	sententya
separatemente	separatemente
star	star
stratos	stratos
subjecte	subZekte
supernominate	supernominate
sustene	sustene
syntactic	sintaktik
syntaxe	sintakse
tecto	tekto
telephono	telefono
traductor	traduktor
transgenere	transgenere
ubicate	ubikate
ubique	ubikwe
umbra	umbra
unification	unifikatyon
unquam	unkwam
utilisava	utilisava
variabiles	varyabiles
variar	varyar
variation	varyatyon
vendeva	vendeva
viagia	vyagya
victimas	viktimas
vinceva	vinceva
violente	vyolente
vital	vital
voluntari	voluntari
Agamemnon	agamemnon
Alcunes	alkunes
Alcunos	alkunos
Alte	alte
Andross	andross
Aristotele	aristotele
Barcelona	barcelona
Blanc	blank
Bornholm	bornholm
Canto	kanto
Cathedral	katedral
Collegio	kolegyo
Columbia	kolumbya
Credo	kredo
Debite	debite
Dido	dido
Dominica	dominika
Donald	donald
Donatello	donatelo
Ecclesias	eklesyas
Engels	eNgels
Enrique	enrikwe
Entertainment	entertanment
Equalmente	ekwalmente
Fiume	fyume
Gaio	gao
Georgia	georgya
Gode	gode
Gregorio	gregoryo
Heleno	heleno
Hidalgo	hidalgo
Human	human
Introduction	introduktyon
Johan	Zohan
Johann	Zohan
Kazakhstan	kazakhstan
Kennedy	kenedi
Libano	libano
Madagascar	madagaskar
Membros	membros
Menelao	menelao
Messia	mesia
Ministerio	ministeryo
Montreal	montreal
Nam	nam
Nova	nova
O	o
Orleans	orleans
Paz	paz
Penelope	penelope
Pilato	pilato
Qui	ki
RFCs	erefsees
Russe	ruse
Sapir	sapir
Sayyid	sayyid
Software	software
Tempore	tempore
Testes	testes
Texas	teksas
Top	top
Trek	trek
Tudor	tudor
Tunc	tunk
Typicamente	tipikamente
Valle	vale
XI	deceun
acceder	aceder
accentuate	acentwate
accordate	akordate
acidos	acidos
acquireva	akkwireva
acquisition	akkwisityon
administrate	administrate
adolescentia	adolescentya
alcohol	alkohol
algebra	algebra
aliquando	alikwando
altera	altera
anniversario	aniversaryo
antennas	antenas
anthropologia	antropologia
aperi	aperi
apostolos	apostolos
appoiate	apoate
aquelle	akwele
as	as
assalto	asalto
astronomos	astronomos
attachate	ataCate
aun	an
autumno	atumno
avantages	avantaZes
avantia	avantya
banca	banka
becco	beko
bibliothecas	biblyotekas
bosco	bosko
cambiamentos	kambyamentos
canta	kanta
capitano	kapitano
captivitate	kaptivitate
catholicismo	katolicismo
caudas	kadas
causante	kasante
christiano	kristyano
chronic	kronik
classificar	klasifikar
clientes	klyentes
colonisation	kolonisatyon
compacte	kompakte
complimento	komplimento
conditional	kondityonal
confundite	konfundite
connecte	konekte
conquirer	koNkwirer
conservar	konservar
contextos	kontekstos
contrari	kontrari
conventional	konventyonal
conversation	konversatyon
coperir	koperir
cordes	kordes
coronas	koronas
corporal	korporal
correctemente	korektemente
cortice	kortice
crescentia	krescentya
crescite	krescite
criminal	kriminal
cruce	kruce
crusta	krusta
cyclones	ciklones
debattos	debatos
declarationes	deklaratyones
defendeva	defendeva
depingite	depiNgite
derivar	derivar
designator	designator
destructive	destruktive
dextra	dekstra
diabolo	dyabolo
diagramma	dyagrama
dicte	dikte
differentemente	diferentemente
diffundite	difundite
discute	diskute
disparition	disparityon
dispositiones	disposityones
disputas	disputas
distacca	distaka
districtos	distriktos
dominica	dominika
dos	dos
editores	editores
eliger	eliger
equation	ekwatyon
esque	eske
eucaryotes	ekaryotes
expeditiones	ekspedityones
fabricate	fabrikate
facte	fakte
fiasco	fyasko
fictional	fiktyonal
fixar	fiksar
flechas	fleSas
fora	fora
formula	formula
fornite	fornite
forrage	foraZe
fortuna	fortuna
fugiva	fugiva
fundamento	fundamento
galleco	galeko
ganiator	ganyator
generate	generate
germanos	germanos
gigantes	gigantes
governamental	governamental
grammatical	gramatikal
haver	haver
hemispherio	hemisferyo
hereditage	hereditaZe
hierarchia	hyerarkia
homosexualitate	homosekswalitate
horologios	horologyos
identification	identifikatyon
implementation	implementatyon
imponeva	imponeva
imponite	imponite
incerte	incerte
incomplete	inkomplete
incontrar	inkontrar
incontrate	inkontrate
incorrecte	inkorekte
inducite	inducite
induction	induktyon
inflation	inflatyon
informal	informal
insular	insular
integremente	integremente
intendeva	intendeva
interviews	interviws
introduce	introduce
inventor	inventor
istas	istas
judices	Zudices
juncto	Zunkto
lacos	lakos
lateres	lateres
lexical	leksikal
limitationes	limitatyones
localisate	lokalisate
localitate	lokalitate
magia	magia
mangia	maNgya
mappas	mapas
martial	martyal
mediterranee	mediteranee
meliorava	melyorava
metro	metro
modification	modifikatyon
molecular	molekular
monetari	monetari
montante	montante
mortos	mortos
mostra	mostra
mythologic	mitologik
naturalistic	naturalistik
necessitates	necesitates
necuno	nekuno
nervose	nervose
norvegian	norvegyan
notitias	notityas
obscuritate	obskuritate
octave	oktave
offensive	ofensive
offerer	oferer
orchestra	orCestra
origina	origina
pariete	paryete
participante	participante
particula	partikula
passageros	pasaZeros
patres	patres
patrimonio	patrimonyo
perde	perde
phantastic	fantastik
placiava	placyava
plagia	plaZa
plures	plures
pms	peemes
potera	potera
predecessor	predecesor
preservate	preservate
prestigio	prestigyo
primes	primes
privilegios	privilegyos
procede	procede
productive	produktive
professores	profesores
programmatores	programatores
prole	prole
prophetia	profetia
prototypo	prototipo
provate	provate
proveniente	provenyente
purmente	purmente
rata	rata
reguardo	regwardo
remarcabile	remarkabile
requesta	rekwesta
requestas	rekwestas
resolvite	resolvite
respectar	respektar
reuni	reni
revolutionari	revolutyonari
rival	rival
rosate	rosate
russo	ruso
sacerdote	sacerdote
sacramentos	sakramentos
sal	sal
salute	salute
sanctos	sanktos
satellites	satelites
scepticismo	scepticismo
sculptura	skulptura
selectionate	selektyonate
semines	semines
separa	separa
separava	separava
septentrional	septentryonal
sexanta	seksanta
sexte	sekste
sicut	sikut
single	siNgle
solitari	solitari
sonava	sonava
specialistas	specyalistas
stabilite	stabilite
stadios	stadyos
statistica	statistika
structural	struktural
suggerite	sugerite
superar	superar
superate	superate
synonymo	sinonimo
tan	tan
tango	taNgo
technologic	teknologik
tensiones	tensyones
tenue	tenwe
terminar	terminar
testimonio	testimonyo
touristic	turistik
traciar	tracyar
tractamentos	traktamentos
traductores	traduktores
transformava	transformava
tumba	tumba
uni	uni
unificate	unifikate
uniforme	uniforme
unir	unir
vapor	vapor
vehiculos	vehikulos
velocitates	velocitates
vendita	vendita
vengiantia	venZantya
verme	verme
viagiava	vyagyava
viro	viro
visitas	visitas
voluntarios	voluntaryos
ya	ya
Aeroporto	aeroporto
Aires	ares
Alba	alba
Alteremente	alteremente
Alteres	alteres
Andersen	andersen
Apollo	apolo
Armstrong	armstroNg
Arte	arte
Atlantico	atlantiko
Auro	aro
Bismarck	bismarkk
Boston	boston
Buddhismo	budhismo
Buenos	bwenos
Bulgaria	bulgarya
Carlos	karlos
Chicago	Cikago
Ci	ci
Civil	civil
Compania	kompania
Corporation	korporatyon
Creta	kreta
Cromwell	kromwel
Day	day
Declaration	deklaratyon
Der	der
Dewey	dewey
Dictionary	diktyonari
Equus	ekwus
Esque	eske
Football	futbol
Gallecia	galecya
Gilbert	gilbert
Google	google
Grec	grek
Groningen	groniNgen
Ha	ha
Hector	hektor
Historias	historyas
Hogwarts	hogwarts
Hollanda	holanda
Huygens	huygens
ILGA	ilga
IP	ip
Indonesia	indonesya
Jan	Zan
Jocos	Zokos
Jones	Zones
Julia	Zulya
Julietta	Zulyeta
Laco	lako
Lancaster	lankaster
Las	las
Latio	latyo
Linnaeus	linaes
Lu	lu
Macedonia	macedonya
Magazine	magazin
Magnus	magnus
Manila	manila
Mappa	mapa
Maurice	marice
Media	medya
Minnesota	minesota
Naruto	naruto
Ni	ni
Nicolas	nikolas
Normandia	Normandia
North	nort
Olympic	olimpik
PM	peem
Pablo	pablo
Pacioli	pacyoli
Parolas	parolas
Patroclo	patroklo
Pauc	pawk
Peru	peru
Piaget	pyaget
Piro	piro
Pythagoras	pitagoras
Recerca	recerka
Republican	republikan
Roger	roger
Saturno	saturno
Science	scyence
Solo	solo
Sture	sture
Taiwan	tawan
Tractatos	traktatos
Turchia	8urkia
Uno	uno
Usualmente	uswalmente
Utah	utah
Verso	verso
White	white
Wikidata	wikidata
Wujek	wuZek
XIII	decetres
XV	dececinkwe
Xenophon	ksenofon
You	you
abandonate	abandonate
abundantia	abundantya
abusos	abusos
accentos	acentos
accentua	acentwa
accessibile	akcesibile
adverbio	adverbyo
affin	afin
alicuno	alikuno
alie	alye
alimenta	alimenta
alimentar	alimentar
alterate	alterate
amante	amante
amica	amika
anatomic	anatomik
angelo	angelo
annuncia	anuncya
anteriormente	anteryormente
apportar	aportar
apportate	aportate
appunctate	apunktate
apte	apte
aquatic	akwatik
archaic	arkaik
argumento	argumento
articulation	artikulatyon
assassinato	asasinato
assereva	asereva
assimilation	asimilatyon
assumer	asumer
atheismo	atesmo
audite	adite
augmentate	agmentate
aventuras	aventuras
biographia	byografia
biologia	byologia
bobina	bobina
boxa	boksa
boxer	bokser
brasilianos	brasilyanos
cader	kader
calefaction	kalefaktyon
cantatores	kantatores
cantatrice	kantatrice
car	kar
catalogo	katalogo
celebra	celebra
centra	centra
certemente	certemente
certo	certo
cessa	cesa
chassatores	Casatores
cinquanta	ciNkwanta
civilisationes	civilisatyones
classifica	klasifika
cliente	klyente
climatic	klimatik
cognoscentias	kognoscentyas
collaborava	kolaborava
columnas	kolumnas
comedia	komedya
compara	kompara
competentias	kompetentyas
compilate	kompilate
completate	kompletate
complir	komplir
compliva	kompliva
concedite	koncedite
condemnation	kondemnatyon
consentite	konsentite
constructiones	konstruktyones
construe	konstrwe
contatos	kontatos
continentes	kontinentes
continer	kontiner
continuemente	kontinwemente
contribution	kontributyon
control	kontrol
controlava	kontrolava
copula	kopula
corda	korda
coxa	koksa
criticava	kritikava
cruciate	krucyate
culpa	kulpa
declination	deklinatyon
defensores	defensores
demonstrava	demonstrava
dependentia	dependentya
designava	designava
desirate	desirate
dextere	dekstere
dialectal	dyalektal
diaphragma	dyafragma
digne	digne
dignitate	dignitate
diminue	diminwe
diminuer	diminwer
diplomatic	diplomatik
disparite	disparite
distaccate	distakate
distribuer	distribwer
disveloppamentos	disvelopamentos
divinitate	divinitate
documentari	dokumentari
dollares	dolares
dono	dono
donos	donos
ducite	ducite
durabile	durabile
educational	edukatyonal
elastic	elastik
electe	elekte
electron	elektron
emotiones	emotyones
encyclopedia	enciklopedia
equalitate	ekwalitate
equipage	ekwipaZe
erigite	erigite
erosion	erosyon
essayate	esayate
ethic	etik
etiquetta	etiketa
etymologic	etimologik
excludite	ekskludite
existite	eksistite
experimentation	eksperimentatyon
experimentava	eksperimentava
explora	eksplora
extremitate	ekstremitate
facilitates	facilitates
falcon	falkon
falleva	faleva
fame	fame
favorite	favorite
flexibile	fleksibile
focar	fokar
folk	folk
fornir	fornir
fortalessas	fortalesas
frigido	frigido
fundamentos	fundamentos
galaxia	galaksya
gamba	gamba
glacial	glacyal
glandulas	glandulas
governa	governa
grandemente	grandemente
grano	grano
graphic	grafik
gravitate	gravitate
gravitational	gravitatyonal
grosse	grose
hellenistic	helenistik
hereditari	hereditari
hindu	hindu
historietta	historyeta
honorari	honorari
honores	honores
hypothetic	hipotetik
illustrate	ilustrate
imperatores	imperatores
implicate	implikate
incarnation	inkarnatyon
infectate	infektate
infectiones	infektyones
infinitivo	infinitivo
influentiar	inflwentyar
inimico	inimiko
insectos	insektos
instabilitate	instabilitate
instantanee	instantanee
insulina	insulina
intentiones	intentyones
interpreta	interpreta
interpretar	interpretar
intervallo	intervalo
inundation	inundatyon
inventava	inventava
jardin	Zardin
judicate	Zudikate
largor	largor
lequales	lekwales
lettera	letera
liturgic	liturgik
locationes	lokatyones
loyal	loyal
mandate	mandate
mangiate	maNgyate
manifestava	manifestava
manipulation	manipulatyon
manuscripto	manuskripto
mares	mares
margine	margine
marineros	marineros
marito	marito
mata	mata
materias	materyas
medalia	medalya
medievo	medyevo
meliorate	melyorate
mer	mer
mesurar	mesurar
mina	mina
minas	minas
monastic	monastik
morphologia	morfologia
municipios	municipyos
mutual	mutwal
mystic	mistik
ne	ne
nervos	nervos
nodos	nodos
nominal	nominal
normanne	normane
normative	normative
notabilemente	notabilemente
obedientia	obedyentya
obvie	obvye
oceanic	oceanik
offerite	oferite
omaso	omaso
opportunitate	oportunitate
orange	oranZe
oration	oratyon
organisava	organisava
originari	originari
originate	originate
oves	oves
pagate	pagate
pannello	panelo
parietes	paryetes
participate	participate
partisanos	partisanos
patente	patente
paupere	pawpere
periodico	peryodiko
personalitates	personalitates
pesa	pesa
pete	pete
petroglyphos	petroglifos
physicamente	fisikamente
pisca	piska
plana	plana
politicamente	politikamente
portraits	portres
posseder	poseder
prece	prece
precisemente	precisemente
predecessores	predecesores
predication	predikatyon
prestigiose	prestigyose
prevention	preventyon
priones	pryones
productivitate	produktivitate
prohibition	prohibityon
promissa	promisa
pronuncia	pronuncya
proportion	proportyon
proportiones	proportyones
propriemente	propryemente
psychiatria	psikyatria
pulmonar	pulmonar
qualificate	kwalifikate
quante	kwante
quarto	kwarto
rangos	raNgos
ratto	rato
receptas	receptas
recognoscibile	rekognoscibile
recommenda	rekomenda
recursos	rekursos
reflexion	refleksyon
reger	reger
registros	registros
regite	regite
rejection	reZektyon
relievo	relyevo
repasto	repasto
republicas	republikas
reside	reside
restante	restante
retirar	retirar
retirate	retirate
rigide	rigide
roccas	rokas
ronde	ronde
rota	rota
rotante	rotante
ruptura	ruptura
sacrificios	sakrificyos
scenario	scenaryo
schemas	sCemas
segmentos	segmentos
sentir	sentir
separar	separar
servitores	servitores
sexos	seksos
sexualmente	sekswalmente
signala	signala
silva	silva
similaritates	similaritates
simultanee	simultanee
situa	sitwa
slavos	slavos
soveranitate	soveranitate
stadio	stadyo
standardisate	standardisate
statistic	statistik
statuas	statwas
subinde	subinde
subjectos	subZektos
supertoto	supertoto
supervivite	supervivite
supportava	suportava
suppression	supresyon
surprisa	surprisa
synthetic	sintetik
tagalog	tagalog
tales	tales
tardive	tardive
tempos	tempos
terminationes	terminatyones
testamento	testamento
textual	tekstwal
titular	titular
trainamento	tranamento
transmitter	transmiter
triangulo	tryangulo
tribo	tribo
tubos	tubos
und	und
usabile	usabile
validitate	validitate
veniente	venyente
venita	venita
vicinos	vicinos
vincite	vincite
viros	viros
