te	te
i	i
o	o
ki	ki
ngā	Na
e	e
ka	ka
a	a
me	me
ana	ana
he	he
nga	Na
Te	te
ko	ko
mai	ma
Ko	ko
atu	atu
Ka	ka
He	he
ai	a
hei	hei
mō	mo
Māori	maori
kia	kia
ia	ia
I	i
mahi	mahi
hoki	hoki
nei	nei
tau	tau
tēnei	tenei
tētahi	tetahi
E	e
roto	roto
mea	mea
ake	ake
kei	kei
kua	kua
kōrero	korero
ā	a
anō	ano
nui	nui
reo	reo
haere	hare
tangata	taNata
ētahi	etahi
tonu	tonu
mo	mo
katoa	katoa
mā	ma
rātou	ratou
whai	fa
iwi	iwi
noho	noho
koe	kwe
runga	ruNa
Kei	kei
tō	to
rānei	ranei
whenua	fenua
to	to
noa	noa
ākonga	akoNa
wā	wa
kaupapa	kaupapa
whare	fare
tana	tana
tino	tino
pai	pa
Aotearoa	atearoa
rā	ra
take	take
Ngā	Na
tenei	tenei
aha	aha
ra	ra
taua	taua
toa	toa
taea	taa
tōna	tona
kura	kura
kai	ka
tae	ta
rawa	rawa
rua	rua
Kua	kua
kore	kore
whakaaro	fakaaro
mate	mate
puta	puta
tamariki	tamariki
tikanga	tikaNa
ēnei	enei
reira	reira
wāhi	wahi
taku	taku
wai	wa
iho	iho
pukapuka	pukapuka
ano	ano
au	au
ao	a
T	t
waka	waka
tā	ta
kitea	kitea
tetahi	tetahi
kupu	kupu
momo	momo
muri	muri
Me	me
ako	ako
mua	mua
taha	taha
whakaatu	fakaatu
whānau	fanau
tika	tika
korero	korero
tahi	tahi
nā	na
tauira	tauira
nō	no
kaha	kaha
tohu	tohu
pā	pa
M	m
matua	matua
āhua	ahua
Kia	kia
ratou	ratou
kāore	kaore
pea	pea
engari	eNari
ōna	ona
tuatahi	tuatahi
kē	ke
wāhanga	wahaNa
the	the
Hei	hei
hua	hua
ingoa	iNoa
maha	maha
nama	nama
hou	hou
raro	raro
hunga	huNa
ō	o
mana	mana
roa	roa
tēnā	tena
Mātauranga	matauraNa
āhuatanga	ahuataNa
Nā	na
Ki	ki
kaiwhakahaere	kafakahare
mōhio	mohio
tū	tu
hanga	haNa
rōpū	ropu
ahau	ahau
koutou	koutou
wa	wa
waiata	waata
tuku	tuku
tērā	tera
tona	tona
kotahi	kotahi
taki	taki
mau	mau
mātou	matou
Ngati	Nati
na	na
utu	utu
hiahia	hiahia
rārangi	raraNi
tautoko	tautoko
arā	ara
rauemi	rauemi
Mā	ma
hāngai	haNa
tāngata	taNata
wahine	wahine
Kete	kete
ara	ara
Nō	no
Rauemi	rauemi
kōwhiringa	kofiriNa
kaore	kare
huarahi	huarahi
Ipurangi	ipuraNi
whakamahi	fakamahi
toru	toru
Reo	reo
Kāore	kaore
kite	kite
tekau	tekau
ma	ma
Ngāti	Nati
Kohinga	kohiNa
aua	aua
Maori	mari
whakaahua	fakaahua
iti	iti
hoa	hoa
rāua	raua
ta	ta
rangatira	raNatira
taonga	taNa
tātou	tatou
rohe	rohe
Iwi	iwi
New	new
whakahaere	fakahare
rere	rere
marama	marama
āta	ata
Kura	kura
etahi	etahi
Na	na
moana	moana
ture	ture
ora	ora
nuinga	nuiNa
konei	konei
rite	rite
matou	matou
tata	tata
no	no
Makino	makino
rau	rau
Tiriti	tiriti
rātau	ratau
pānui	panui
tini	tini
whakamārama	fakamarama
taumata	taumata
mutu	mutu
papa	papa
pērā	pera
whānui	fanui
tuhi	tuhi
kāinga	kaiNa
Pākehā	pakeha
tamaiti	tamati
or	or
anake	anake
tuhinga	tuhiNa
tipu	tipu
manu	manu
raua	raua
hapori	hapori
titiro	titiro
ika	ika
pa	pa
Ehara	ehara
Kōrero	korero
huri	huri
hui	hui
āwhina	afina
Kātahi	katahi
Nau	nau
marae	mara
mātauranga	matauraNa
kino	kino
rapu	rapu
whakarite	fakarite
rongo	roNo
kī	ki
āna	ana
Hoki	hoki
motu	motu
pouako	pouako
rangi	raNi
tono	tono
TKI	tki
pātai	pata
rerekē	rereke
kainga	kaNa
kaiako	kaako
whakamahia	fakamahia
Engari	eNari
waho	waho
heke	heke
uru	uru
wahi	wahi
rahi	rahi
tatou	tatou
pēhea	pehea
tinana	tinana
Tai	ta
oti	oti
whakatau	fakatau
ngaro	Naro
pōti	poti
ahakoa	ahakoa
hau	hau
rangahau	raNahau
tukuna	tukuna
piki	piki
kaimahi	kamahi
pae	pa
tohunga	tohuNa
Whare	fare
rākau	rakau
tuarua	tuarua
tīmata	timata
ranei	ranei
putanga	putaNa
whiwhi	fifi
moni	moni
ahi	ahi
tera	tera
tāna	tana
ata	ata
wātea	watea
akoranga	akoraNa
tere	tere
Ahakoa	ahakoa
wiki	wiki
pēnei	penei
awa	awa
kāwanatanga	kawanataNa
waenganui	waNanui
Waitangi	wataNi
enei	enei
mohio	mohio
ērā	era
mihi	mihi
tu	tu
whārangi	faraNi
Heoi	heo
hoko	hoko
pakeke	pakeke
ona	ona
toi	to
rima	rima
hononga	honoNa
riro	riro
pānga	paNa
pakanga	pakaNa
ōrau	orau
motuhake	motuhake
whā	fa
eke	eke
kau	kau
kātahi	katahi
ōrite	orite
tiaki	tiaki
hia	hia
taiao	taa
whāinga	faiNa
mārama	marama
ringa	riNa
aroha	aroha
neke	neke
whakaae	fakaa
Mēnā	mena
waahi	waahi
Koia	koa
raruraru	raruraru
haka	haka
oranga	oraNa
hauora	hauora
mahere	mahere
karakia	karakia
pūrākau	purakau
tirohia	tirohia
uri	uri
tena	tena
ngä	Na
rautaki	rautaki
whanau	fanau
kawe	kawe
Kaore	kare
tuhia	tuhia
koia	koa
Tuhia	tuhia
Katahi	katahi
māmā	mama
patu	patu
whakautu	fakautu
whakarongo	fakaroNo
mutunga	mutuNa
aku	aku
aro	aro
kapa	kapa
huanga	huaNa
mēnā	mena
Tokerau	tokerau
Waikato	wakato
Week	week
pirihimana	pirihimana
tirotiro	tirotiro
Mākino	makino
A	a
akomanga	akomaNa
tangi	taNi
ina	ina
rerenga	rereNa
ahua	ahua
tohutohu	tohutohu
waahanga	waahaNa
whakataetae	fakatata
hōtaka	hotaka
No	no
pūrongo	puroNo
whakauru	fakauru
ratonga	ratoNa
mātua	matua
wairua	warua
kīia	kiia
tētehi	tetehi
Kaupapa	kaupapa
uaua	uaua
hea	hea
tama	tama
Tau	tau
whakaputa	fakaputa
waihanga	wahaNa
kaua	kaua
pū	pu
whakaako	fakaako
kimi	kimi
karanga	karaNa
rakau	rakau
Mai	ma
tango	taNo
Niu	niu
riri	riri
waenga	waNa
mahinga	mahiNa
Ao	a
raupapa	raupapa
ke	ke
hangaia	haNaa
maunga	mauNa
āhei	ahei
Ture	ture
whakawhiti	fakafiti
Matua	matua
whakaritea	fakaritea
Whenua	fenua
ope	ope
pepa	pepa
painga	paNa
atua	atua
tirohanga	tirohaNa
whawhai	fafa
whakanui	fakanui
whakaaturanga	fakaaturaNa
To	to
takoto	takoto
tukutuku	tukutuku
takiwā	takiwa
poto	poto
whakaaturia	fakaaturia
haerenga	hareNa
wānanga	wanaNa
moe	mwe
whiriwhiri	firifiri
Mō	mo
po	po
mata	mata
mema	mema
Tari	tari
whakapono	fakapono
kanohi	kanohi
huinga	huiNa
waiho	waho
whakamutunga	fakamutuNa
Marautanga	marautaNa
raraunga	rarauNa
Nga	Na
awhina	afina
whakaari	fakaari
pou	pou
pupuri	pupuri
mahia	mahia
mehemea	mehemea
ono	ono
The	the
pikitia	pikitia
pūkenga	pukeNa
tupu	tupu
whakaoti	fakati
Arā	ara
tua	tua
tatau	tatau
tawhiti	tafiti
whakaritenga	fakariteNa
here	here
kii	kii
tukua	tukua
Haere	hare
in	in
tūtohu	tutohu
Karauna	karauna
hono	hono
Kāwanatanga	kawanataNa
taitara	tatara
Ingarangi	iNaraNi
mātau	matau
hoatu	hoatu
tai	ta
ahu	ahu
hangarau	haNarau
ipurangi	ipuraNi
kā	ka
tukanga	tukaNa
whakatakoto	fakatakoto
Tautoko	tautoko
mano	mano
hapū	hapu
W	w
marautanga	marautaNa
Tirohia	tirohia
ataata	ataata
aromatawai	aromatawa
ārahi	arahi
kōwae	kowa
haumaru	haumaru
ahiahi	ahiahi
Kaunihera	kaunihera
pakihi	pakihi
tuhituhi	tuhituhi
Tireni	tireni
ehara	ehara
whakaata	fakaata
Ara	ara
Koinei	konei
Tuatahi	tuatahi
pūtea	putea
waewae	wawa
tapu	tapu
toku	toku
āu	au
pō	po
Papa	papa
kauwhata	kaufata
Tauranga	tauraNa
taputapu	taputapu
mōhiotia	mohiotia
tangohia	taNohia
tīmatanga	timataNa
ahurea	ahurea
hinga	hiNa
whakapapa	fakapapa
matau	matau
ii	ii
taone	tane
Wānanga	wanaNa
uta	uta
Taumata	taumata
rīpene	ripene
waea	waa
Taki	taki
whakairo	fakaro
waru	waru
taka	taka
tapaina	tapana
tāpiri	tapiri
tōku	toku
ārai	ara
Rangi	raNi
koa	koa
timata	timata
tūranga	turaNa
katahi	katahi
Ina	ina
Māui	maui
Rōpū	ropu
Anei	anei
tutuki	tutuki
ratau	ratau
tawhito	tafito
Mehemea	mehemea
tākaro	takaro
Tērā	tera
arotake	arotake
mōhiohio	mohiohio
whakaaetia	fakaatia
Ngāi	Nai
horopaki	horopaki
pūnaha	punaha
whakamahinga	fakamahiNa
Pāremata	paremata
kararehe	kararehe
kāri	kari
Kotahi	kotahi
Matariki	matariki
niho	niho
uara	uara
hiahiatia	hiahiatia
kiri	kiri
pouaka	pouaka
wehe	wehe
Ma	ma
ngahere	Nahere
pito	pito
tokomaha	tokomaha
tūturu	tuturu
Rau	rau
Taranaki	taranaki
Toi	to
taenga	taNa
whakatūria	fakaturia
Tohu	tohu
kawea	kawea
mahara	mahara
kohinga	kohiNa
tūhura	tuhura
Manu	manu
Tahu	tahu
miriona	miriona
tapawhā	tapafa
Rauparaha	rauparaha
taketake	taketake
tohua	tohua
paetukutuku	patukutuku
Pūtaiao	putaa
tūmatanui	tumatanui
ua	ua
Pirihimana	pirihimana
hokohoko	hokohoko
rorohiko	rorohiko
hāpai	hapa
ngākau	Nakau
whakatutuki	fakatutuki
pūtake	putake
tātai	tata
puna	puna
whakawhanake	fakafanake
nana	nana
tāne	tane
Pakeha	pakeha
kiia	kiia
whakapakari	fakapakari
whakatū	fakatu
tari	tari
whiti	fiti
tokorua	tokorua
Kōhanga	kohaNa
tonga	toNa
aronga	aroNa
Mr	mr
hinengaro	hineNaro
nāna	nana
Tuarua	tuarua
anga	aNa
pārongo	paroNo
Ahitereiria	ahitereiria
aho	aho
whitu	fitu
kōhanga	kohaNa
poari	poari
tipuna	tipuna
kaitiaki	katiaki
waha	waha
whakarato	fakarato
Rua	rua
wera	wera
hōia	hoia
parekura	parekura
teitei	teitei
hoahoa	hoahoa
Toa	toa
pau	pau
tiki	tiki
kamupene	kamupene
mokopuna	mokopuna
pokapū	pokapu
Mahi	mahi
putea	putea
hapu	hapu
ngohe	Nohe
tuatoru	tuatoru
Ingarihi	iNarihi
ngakau	Nakau
Atua	atua
whakamua	fakamua
whāia	faia
Minita	minita
puoro	puoro
Waiata	waata
kaitohutohu	katohutohu
māori	maori
pakari	pakari
pāngarau	paNarau
rapanga	rapaNa
takitahi	takitahi
tuakana	tuakana
ui	ui
katoatia	katoatia
manaaki	manaaki
puka	puka
takirua	takirua
otinga	otiNa
hara	hara
pūtaiao	putaa
tahuri	tahuri
tāone	taone
ngaru	Naru
rongonui	roNonui
Kāinga	kaiNa
Kupu	kupu
ināianei	inaianei
mita	mita
whakatairanga	fakataraNa
hokona	hokona
kuia	kuia
tūmomo	tumomo
whakangungu	fakaNuNu
Karaiti	karati
whakatika	fakatika
Kawanatanga	kawanataNa
Wharekura	farekura
tapa	tapa
kaunihera	kaunihera
whaea	faa
Poari	poari
arotahi	arotahi
hē	he
manuhiri	manuhiri
patua	patua
pupuhi	pupuhi
waa	waa
māna	mana
oro	oro
Takiuru	takiuru
harakeke	harakeke
rēhita	rehita
whakahoki	fakahoki
Rotorua	rotorua
ngaa	Naa
whakataunga	fakatauNa
whenu	fenu
Arawa	arawa
pakeha	pakeha
upoko	upoko
mahue	mahue
ngātahi	Natahi
tane	tane
Kaua	kaua
hopu	hopu
hītori	hitori
whetū	fetu
Pukapuka	pukapuka
huhua	huhua
matatau	matatau
pakaru	pakaru
toro	toro
ariā	aria
mōhiotanga	mohiotaNa
toka	toka
Rā	ra
heoi	heo
whakawhitinga	fakafitiNa
kawenga	kaweNa
whakapae	fakapa
whakawhitiwhiti	fakafitifiti
māramatanga	maramataNa
kākahu	kakahu
tūponotanga	tuponotaNa
whakaora	fakara
whakaputaina	fakaputana
kaipupuri	kapupuri
hai	ha
hiko	hiko
nāianei	naianei
paki	paki
tapatoru	tapatoru
Whakamahia	fakamahia
kete	kete
moutere	moutere
tāu	tau
wāhine	wahine
Moana	moana
Pāwhiria	pafiria
paku	paku
otirā	otira
ētehi	etehi
penei	penei
reta	reta
haurua	haurua
ira	ira
mahana	mahana
roanga	roaNa
rerekētanga	rereketaNa
kahore	kahore
rangona	raNona
whakamātau	fakamatau
Kai	ka
at	at
haora	hara
piri	piri
wero	wero
P	p
hoe	hwe
kitenga	kiteNa
whakaaetanga	fakaataNa
hanganga	haNaNa
tetehi	tetehi
aratohu	aratohu
kaihoko	kahoko
takiwa	takiwa
whakatipu	fakatipu
ine	ine
koki	koki
whakatikatika	fakatikatika
Makaurau	makaurau
Tāhuhu	tahuhu
nunui	nunui
raru	raru
toto	toto
tīpuna	tipuna
tūmanako	tumanako
wehenga	weheNa
whakahau	fakahau
whakawhiwhia	fakafifia
rangatahi	raNatahi
whara	fara
Waipounamu	wapounamu
pono	pono
whakapā	fakapa
Kuini	kuini
Kōti	koti
Tā	ta
pahure	pahure
whakahokia	fakahokia
Tangata	taNata
taipitopito	tapitopito
whakapai	fakapa
kaitono	katono
taiohi	taohi
taumaha	taumaha
Kooti	kooti
Ngunguru	NuNuru
ipu	ipu
Tawhaki	tafaki
kuhu	kuhu
wha	fa
Take	take
kaituhi	katuhi
pūmau	pumau
taupori	taupori
Whanaketanga	fanaketaNa
ihu	ihu
tupuna	tupuna
miraka	miraka
raatau	raatau
Ā	a
era	era
huihuinga	huihuiNa
rumaki	rumaki
tātau	tatau
Kaiwhakahaere	kafakahare
Porou	porou
paetae	pata
taringa	tariNa
taura	taura
Kapa	kapa
Whai	fa
Ngata	Nata
ngāwari	Nawari
uhi	uhi
hāora	haora
kohi	kohi
taunga	tauNa
kaipuke	kapuke
kōpae	kopa
kati	kati
kaumātua	kaumatua
tēhea	tehea
wheako	feako
O	o
hinu	hinu
tonoa	tonoa
whakaarohia	fakaarohia
whakaputanga	fakaputaNa
angitu	aNitu
manawa	manawa
meneti	meneti
taurangi	tauraNi
tou	tou
whakaheke	fakaheke
Pakanga	pakaNa
Taonga	taNa
akiaki	akiaki
kihai	kiha
nekehanga	nekehaNa
oneone	oneone
roopu	roopu
tatari	tatari
urupare	urupare
Marae	mara
Reanga	reaNa
Tēnā	tena
tūtohi	tutohi
Ika	ika
Kōkiri	kokiri
TMOAHe	tmoahe
Taura	taura
Tāmaki	tamaki
Waka	waka
tito	tito
whārite	farite
huringa	huriNa
kāhui	kahui
mamae	mama
kēmu	kemu
pounamu	pounamu
taraiwa	tarawa
whakapuaki	fakapuaki
ōku	oku
Whakaaturia	fakaaturia
Maui	maui
karaka	karaka
matenga	mateNa
pēke	peke
pepeke	pepeke
kiriata	kiriata
kōhungahunga	kohuNahuNa
tonutia	tonutia
whakamarama	fakamarama
Mana	mana
Putumōhio	putumohio
Whanganui	faNanui
ahuatanga	ahuataNa
iwa	iwa
pukapukaNgā	pukapuka Na
tumuaki	tumuaki
wawata	wawata
whaiaro	faaro
whea	fea
aroaro	aroaro
whakahirahira	fakahirahira
whero	fero
īmēra	imera
Tainui	tanui
kounga	kouNa
Tangaroa	taNaroa
karu	karu
maatau	maatau
whakaeke	fakake
whakaminea	fakaminea
Akarana	akarana
Rautaki	rautaki
hokinga	hokiNa
kakahu	kakahu
karaipi	karapi
huka	huka
pānuitanga	panuitaNa
Rumaki	rumaki
hākinakina	hakinakina
kuri	kuri
pu	pu
Whiri	firi
kanikani	kanikani
pūmanawa	pumanawa
Hauora	hauora
Tr	tr
akonga	akoNa
inu	inu
puku	puku
pūngao	puNa
whakamahere	fakamahere
Arotake	arotake
Puni	puni
Rangatira	raNatira
paerewa	parewa
tūpuna	tupuna
wehi	wehi
Tikanga	tikaNa
mōna	mona
whakahē	fakahe
whanaunga	fanauNa
Tekau	tekau
maroke	maroke
Whānau	fanau
kākano	kakano
ringaringa	riNariNa
teina	teina
tōrangapū	toraNapu
Awa	awa
Pou	pou
Tena	tena
pakiwaitara	pakiwatara
pēpi	pepi
Tenei	tenei
inā	ina
kerēme	kereme
Kahungunu	kahuNunu
Kupe	kupe
irirangi	iriraNi
kaitautoko	katautoko
utua	utua
inaianei	inaanei
pouri	pouri
raki	raki
whakatere	fakatere
whanga	faNa
takutai	takuta
Kāti	kati
Papatūānuku	papatuanuku
Tonoa	tonoa
ahumahi	ahumahi
hīkoi	hiko
porotiti	porotiti
rongoā	roNoa
whāiti	faiti
māu	mau
whakarahinga	fakarahiNa
whatu	fatu
whāngai	faNa
ahunga	ahuNa
mātakitaki	matakitaki
tōtika	totika
whanaketanga	fanaketaNa
Pi	pi
Tonga	toNa
Wiremu	wiremu
kohikohi	kohikohi
pātata	patata
raumati	raumati
Hoatu	hoatu
mauri	mauri
on	on
toharite	toharite
uiui	uiui
whakataukī	fakatauki
Hou	hou
mātāpono	matapono
out	out
pūrere	purere
huruhuru	huruhuru
matū	matu
whakapau	fakapau
Nui	nui
koroua	koroua
kūmara	kumara
reka	reka
whānuitanga	fanuitaNa
Tūhoe	tuhwe
hari	hari
matihiko	matihiko
tāpiritanga	tapiritaNa
whakakore	fakakore
Amerika	amerika
Haka	haka
hī	hi
karere	karere
rō	ro
tapeke	tapeke
tāwāhi	tawahi
whanaungatanga	fanauNataNa
Puna	puna
rawe	rawe
whanake	fanake
whiua	fiua
Whakamāramatia	fakamaramatia
kōtiro	kotiro
tumanako	tumanako
tuwhera	tufera
whakaiti	fakati
Kohikohinga	kohikohiNa
Tera	tera
koinei	konei
koiora	koora
print	print
rautau	rautau
rereke	rereke
taniwha	tanifa
tautuhi	tautuhi
whakahaerehia	fakaharehia
whakamōhio	fakamohio
with	with
Hawaiki	hawaki
Ora	ora
tuakiri	tuakiri
tāke	take
Pēhea	pehea
haina	hana
nuku	nuku
peke	peke
whakatinana	fakatinana
Mo	mo
huna	huna
pāpā	papa
tiro	tiro
tuna	tuna
hourua	hourua
kōhatu	kohatu
tōu	tou
ōu	ou
Kāwana	kawana
Titiro	titiro
marau	marau
ngana	Nana
pango	paNo
tūāpapa	tuapapa
whakamana	fakamana
Ō	o
Raukawa	raukawa
pāpori	papori
urunga	uruNa
Kīngitanga	kiNitaNa
Whakawhitiwhiti	fakafitifiti
poraka	poraka
tunu	tunu
maori	mari
whakaurua	fakaurua
Paraire	parare
moenga	mweNa
wawe	wawe
Henare	henare
Waihoki	wahoki
hiki	hiki
horo	horo
kape	kape
nuitia	nuitia
puritia	puritia
pāmu	pamu
pōtitanga	potitaNa
waitohu	watohu
whakatauira	fakatauira
Kahore	kahore
Whanake	fanake
horoi	horo
kaikōrero	kakorero
kawanatanga	kawanataNa
māra	mara
rori	rori
whakamatautau	fakamatautau
whiwhinga	fifiNa
Kīngi	kiNi
Pōti	poti
kahu	kahu
kaiwhakaako	kafakaako
matapaki	matapaki
oma	oma
poti	poti
äkonga	akoNa
Pāngarau	paNarau
one	one
rererangi	rereraNi
hoariri	hoariri
kawa	kawa
kōrerohia	korerohia
maua	maua
mātanga	mataNa
tiakina	tiakina
whakapiki	fakapiki
ū	u
herehere	herehere
huihui	huihui
komiti	komiti
kōura	koura
porowhita	porofita
whakahua	fakahua
ātaahua	ataahua
kaiārahi	kaarahi
takahi	takahi
tiriti	tiriti
whakangahau	fakaNahau
Āta	ata
Mäori	mari
Taea	taa
Tuku	tuku
Tumuaki	tumuaki
Tāne	tane
Whakarongo	fakaroNo
aromātai	aromata
matauranga	matauraNa
ngutu	Nutu
poi	po
pūtau	putau
toki	toki
Kihai	kiha
Ranginui	raNinui
Tae	ta
ahuwhenua	ahufenua
koirā	kora
pitopito	pitopito
rauropi	rauropi
tatauranga	tatauraNa
tāutu	tautu
waipuke	wapuke
whakareatanga	fakareataNa
Kaitiaki	katiaki
Rūnanga	runaNa
kano	kano
kare	kare
kōrua	korua
pera	pera
pukupuku	pukupuku
tōmua	tomua
PouakoHe	pouako he
Rāwhiti	rafiti
ea	ea
haki	haki
kiore	kiore
tīma	tima
wahanga	wahaNa
hurihia	hurihia
otaota	otata
tautohu	tautohu
pehea	pehea
Hine	hine
Pipiri	pipiri
Taku	taku
kaipānui	kapanui
moko	moko
tahuna	tahuna
whati	fati
Tama	tama
Wiki	wiki
māngai	maNa
patai	pata
hautau	hautau
horahanga	horahaNa
kāhore	kahore
whakatakotoria	fakatakotoria
ēngari	eNari
Pirimia	pirimia
Wai	wa
homai	homa
kupenga	kupeNa
timatanga	timataNa
ahurei	ahurei
kōkiri	kokiri
kōrerotia	korerotia
minita	minita
papakupu	papakupu
rama	rama
whakahou	fakahou
mauī	maui
rangatiratanga	raNatirataNa
kiko	kiko
mauria	mauria
tira	tira
tūhono	tuhono
Iho	iho
Nāna	nana
Ope	ope
kumara	kumara
ritenga	riteNa
tātari	tatari
tūnga	tuNa
waipiro	wapiro
wāhitanga	wahitaNa
Otira	otira
auaha	auaha
haria	haria
kaukau	kaukau
oku	oku
rūma	ruma
taunakitanga	taunakitaNa
tūru	turu
whakatō	fakato
Pōneke	poneke
atawhai	atafa
aukati	aukati
kirimana	kirimana
paenga	paNa
waeine	waine
whanonga	fanoNa
Aho	aho
mohiotia	mohiotia
mona	mona
rata	rata
takoha	takoha
Tamaki	tamaki
Whakamana	fakamana
awatea	awatea
kānga	kaNa
ohorere	ohorere
pīrangi	piraNi
takea	takea
tuahine	tuahine
wareware	wareware
Huanga	huaNa
Maniapoto	maniapoto
kohia	kohia
kōwhiri	kofiri
peka	peka
taitamariki	tatamariki
Kaupae	kaupa
Kawana	kawana
Rohe	rohe
hōu	hou
parirau	parirau
poaka	poaka
puke	puke
tauiwi	tauiwi
tānga	taNa
tūtaki	tutaki
Kirihimete	kirihimete
hekenga	hekeNa
hipa	hipa
panoni	panoni
tahua	tahua
tapahi	tapahi
tāpirihia	tapirihia
Hāhi	hahi
Rāhoroi	rahoro
atahanga	atahaNa
koha	koha
kīanga	kiaNa
kōrerorero	korerorero
tohatoha	tohatoha
Mahuru	mahuru
Pouako	pouako
kapua	kapua
korerotia	korerotia
mataku	mataku
ngahuru	Nahuru
para	para
pāngia	paNia
tihi	tihi
toenga	tweNa
toko	toko
tōpana	topana
whakawhānui	fakafanui
Mei	mei
Takawaenga	takawaNa
iii	iii
koi	ko
mara	mara
nekeneke	nekeneke
pahi	pahi
pene	pene
pire	pire
tangohanga	taNohaNa
tara	tara
tupapaku	tupapaku
whakamuri	fakamuri
Ako	ako
Hui	hui
Kamupene	kamupene
arataki	arataki
haramai	harama
puhuruhurutanga	puhuruhurutaNa
puia	puia
rewa	rewa
whakamātautau	fakamatautau
āwangawanga	awaNawaNa
Kara	kara
herea	herea
hurihanga	hurihaNa
kaumatua	kaumatua
main	man
maru	maru
pari	pari
umanga	umaNa
wehewehe	wehewehe
whakaū	fakau
Inā	ina
Kotahitanga	kotahitaNa
Manatū	manatu
Whakahaere	fakahare
hōhonu	hohonu
pōuri	pouri
raina	rana
tākuta	takuta
whaihua	fahua
whakanuia	fakanuia
Aroha	aroha
Ia	ia
Tapu	tapu
Waitaha	wataha
Whakatane	fakatane
hāhi	hahi
karangatia	karaNatia
nohoanga	nohoaNa
oho	oho
rāngai	raNa
tautohetohe	tautohetohe
tomo	tomo
Wairarapa	wararapa
Whakamārama	fakamarama
aa	aa
amuamu	amuamu
hū	hu
poro	poro
tapahia	tapahia
wehea	wehea
whakaakoranga	fakaakoraNa
Paoa	paa
hoiho	hoho
paepae	papa
pua	pua
reanga	reaNa
tamāhine	tamahine
whakahaeretia	fakaharetia
whakapiri	fakapiri
Ahorangi	ahoraNi
Kiwi	kiwi
Wāhanga	wahaNa
ama	ama
awhi	afi
hapa	hapa
kahurangi	kahuraNi
muka	muka
māua	maua
ngaio	Nao
ripoata	ripoata
whakarea	fakarea
ōwehenga	oweheNa
North	north
Pai	pa
Pānui	panui
Tukuna	tukuna
inenga	ineNa
kāre	kare
pārekareka	parekareka
tukunga	tukuNa
tāku	taku
tūāhua	tuahua
whakatupato	fakatupato
whiu	fiu
Ana	ana
Ariki	ariki
Tū	tu
Whānui	fanui
hokonga	hokoNa
kaiwhakawā	kafakawa
konā	kona
puninga	puniNa
takaro	takaro
tautokona	tautokona
tikina	tikina
tohe	tohe
āpiha	apiha
Kingi	kiNi
auraki	auraki
hainatia	hanatia
hoia	hoa
kapu	kapu
kurī	kuri
toe	twe
tohungatanga	tohuNataNa
torotoro	torotoro
waimarie	wamarie
whakakotahi	fakakotahi
whakawhanaketanga	fakafanaketaNa
whānuitia	fanuitia
Kaiako	kaako
Tūroa	turoa
kara	kara
ngāi	Nai
tuākana	tuakana
Henrietta	henrietta
Kimihia	kimihia
Oketopa	oketopa
Tauira	tauira
Turi	turi
hiranga	hiraNa
hopukina	hopukina
kōnae	kona
mataono	matano
mati	mati
ngahau	Nahau
pepeha	pepeha
riu	riu
takahia	takahia
hohoro	hohoro
pere	pere
āheinga	aheiNa
Reipa	reipa
noatia	noatia
rongoa	roNoa
tarai	tara
u	u
Hoani	hoani
Tahi	tahi
Tūwharetoa	tufaretoa
Whakatau	fakatau
hauwhā	haufa
karangahia	karaNahia
kata	kata
kiwi	kiwi
kōti	koti
maimai	mama
maumahara	maumahara
peita	peita
ruarua	ruarua
tūpono	tupono
whakahuatia	fakahuatia
whiringa	firiNa
ōkawa	okawa
Taua	taua
Waiho	waho
hora	hora
kotiro	kotiro
māia	maia
taia	taa
waihangatia	wahaNatia
whakataki	fakataki
whetu	fetu
Hauraki	hauraki
Maehe	mahe
Marama	marama
Motu	motu
Neke	neke
Tu	tu
Uenuku	uenuku
hainatanga	hanataNa
papai	papa
putu	putu
raupatu	raupatu
ruri	ruri
tahu	tahu
tohungia	tohuNia
tē	te
whakarunga	fakaruNa
Hauhau	hauhau
Kahu	kahu
Mātāpunenga	matapuneNa
Rongo	roNo
Rātana	ratana
Tino	tino
Whakaraparapatia	fakaraparapatia
kaipōti	kapoti
karo	karo
kauhoe	kauhwe
tuihono	tuihono
whakaturia	fakaturia
Kāhore	kahore
Noho	noho
Whakaahua	fakaahua
akoako	akoako
harikoa	harikoa
kapi	kapi
kāta	kata
matapae	matapa
ngota	Nota
poipoi	popo
roro	roro
tokotoru	tokotoru
tīpako	tipako
whanui	fanui
Papakupu	papakupu
mīharo	miharo
mōrearea	morearea
putiputi	putiputi
pūngāwerewere	puNawerewere
whakakī	fakaki
whakawakia	fakawakia
ōhanga	ohaNa
Pire	pire
ataahua	ataahua
mārō	maro
nōna	nona
pāpāho	papaho
raranga	raraNa
tiketike	tiketike
turanga	turaNa
Hokianga	hokiaNa
Homai	homa
Karere	karere
Kerei	kerei
ariki	ariki
kaiwhakatere	kafakatere
maro	maro
pōwhiri	pofiri
tauhokohoko	tauhokohoko
whiriwhiria	firifiria
Whiti	fiti
hautoru	hautoru
kaikorero	kakorero
makariri	makariri
taurite	taurite
whakapaunga	fakapauNa
Koirā	kora
Takiwa	takiwa
Tāpiritia	tapiritia
Tīreni	tireni
aruhe	aruhe
hao	ha
kōiwi	koiwi
matea	matea
tuawhenua	tuafenua
whakakapi	fakakapi
whakatipuranga	fakatipuraNa
whakatupu	fakatupu
wāwāhi	wawahi
Apirana	apirana
Kore	kore
Maunga	mauNa
Otirā	otira
Pae	pa
Poneke	poneke
matapihi	matapihi
ngoikore	Nokore
pirau	pirau
puehu	puehu
tamahine	tamahine
tāia	taia
whakamāori	fakamaori
Heretaunga	heretauNa
Mahere	mahere
Noema	nwema
Pānuitia	panuitia
Whāriki	fariki
iahiko	iahiko
kairangahau	karaNahau
kētia	ketia
pata	pata
pukenga	pukeNa
tīkina	tikina
whakaharahara	fakaharahara
whakamau	fakamau
whakawhirinaki	fakafirinaki
īngoa	iNoa
Hepetema	hepetema
Nei	nei
Puhi	puhi
Tamariki	tamariki
kimihia	kimihia
korua	korua
kōpaki	kopaki
maramara	maramara
motokā	motoka
takenga	takeNa
tuturu	tuturu
whaikōrero	fakorero
whakahaeretanga	fakaharetaNa
Ētahi	etahi
rū	ru
tahae	taha
teihana	teihana
tima	tima
tokoiti	tokoti
whaitake	fatake
whakahāngai	fakahaNa
whakarōpū	fakaropu
Anō	ano
Komiti	komiti
Mau	mau
TKKM	tkkm
Tara	tara
aroturuki	aroturuki
hurihuri	hurihuri
kaituku	katuku
kirihou	kirihou
kona	kona
kukume	kukume
maimoatanga	mamoataNa
mitarau	mitarau
paanga	paaNa
parāoa	paraoa
ripanga	ripaNa
tuawhā	tuafa
tutu	tutu
uira	uira
whakapaipai	fakapapa
whakatinanatanga	fakatinanataNa
Aratohu	aratohu
Hangaia	haNaa
Hiku	hiku
Kupenga	kupeNa
Mema	mema
Teina	teina
kaihautū	kahautu
kaute	kaute
more	more
reti	reti
tēpu	tepu
whakatakotoranga	fakatakotoraNa
whatitiri	fatitiri
āwhata	afata
Atu	atu
Hakihea	hakihea
Koiora	koora
Mahara	mahara
Upoko	upoko
Whāia	faia
awe	awe
hautanga	hautaNa
kaupae	kaupa
koro	koro
kō	ko
māpere	mapere
ou	ou
raihana	rahana
torutoru	torutoru
uwha	ufa
Āe	ae
ēhea	ehea
Heke	heke
Kaikohe	kakohe
Rata	rata
herenga	hereNa
hiwi	hiwi
kāwai	kawa
makawe	makawe
ngawari	Nawari
pana	pana
puni	puni
raatou	raatou
ruru	ruru
taiapa	taapa
Kāi	kai
Manaia	manaa
TPK	tpk
Tāhei	tahei
Tākuta	takuta
auau	auau
kaihanga	kahaNa
kauae	kaua
kokonga	kokoNa
pakitara	pakitara
raweke	raweke
taiaha	taaha
tangihanga	taNihaNa
tuhituhinga	tuhituhiNa
Ngake	Nake
Waiariki	waariki
eetahi	eetahi
karapu	karapu
maia	maa
mihinare	mihinare
motika	motika
mōu	mou
otira	otira
ropu	ropu
uiuinga	uiuiNa
whakararo	fakararo
whakarerekē	fakarereke
Mena	mena
Nana	nana
Ngai	Na
Ranga	raNa
Tane	tane
Whakarea	fakarea
aitua	atua
hōhipera	hohipera
meka	meka
neherā	nehera
pena	pena
pikinga	pikiNa
rahinga	rahiNa
rōrahi	rorahi
tauhou	tauhou
whakakaha	fakakaha
whakatupuranga	fakatupuraNa
Ākonga	akoNa
Kōeke	koeke
Porirua	porirua
Rarotonga	rarotoNa
Ratonga	ratoNa
Rēhia	rehia
Tata	tata
Tatauranga	tatauraNa
hira	hira
hāunga	hauNa
kaumoana	kaumoana
kohatu	kohatu
maku	maku
motukā	motuka
mura	mura
mātai	mata
paraoa	paraa
paru	paru
tahataha	tahataha
tohorā	tohora
utaina	utana
werohia	werohia
whakatairite	fakatarite
whakatenatena	fakatenatena
Ōtautahi	otautahi
Mutu	mutu
Rangitāne	raNitane
Tika	tika
Tukua	tukua
Turanga	turaNa
Tutanekai	tutaneka
Waiapu	waapu
harore	harore
kaihokohoko	kahokohoko
kaitākaro	katakaro
kakara	kakara
kītanga	kitaNa
manawanui	manawanui
miharo	miharo
moea	mwea
motuka	motuka
nehe	nehe
panui	panui
taina	tana
taraka	taraka
tautohe	tautohe
tumu	tumu
whakarauora	fakarauora
whakariterite	fakariterite
Haina	hana
Kiwa	kiwa
Matatini	matatini
Pā	pa
akona	akona
haurehu	haurehu
hue	hue
kaka	kaka
koroni	koroni
mīhini	mihini
ngau	Nau
papanga	papaNa
tāpiria	tapiria
whakanoho	fakanoho
whakarewa	fakarewa
whakataurite	fakataurite
Hangarau	haNarau
Hāunga	hauNa
Mihi	mihi
Parihaka	parihaka
Pita	pita
Puea	puea
Pēwhairangi	pefaraNi
Waititi	watiti
atamira	atamira
auahi	auahi
kake	kake
maa	maa
mahunga	mahuNa
mātāmua	matamua
ngako	Nako
oriori	oriori
pahikara	pahikara
pepe	pepe
tao	ta
taro	taro
taru	taru
taunaki	taunaki
tina	tina
wh	wh
whakatā	fakata
Kaha	kaha
Tohua	tohua
Tēnei	tenei
Whakaritea	fakaritea
Whina	fina
hararei	hararei
manaakitanga	manaakitaNa
maoa	maa
mōteatea	moteatea
nau	nau
ngākaunui	Nakaunui
paunga	pauNa
pēnā	pena
taangata	taaNata
taatau	taatau
teenei	teenei
tü	tu
wao	wa
whakaingoatia	fakaNoatia
whakamihi	fakamihi
whakamāramatanga	fakamaramataNa
whakapūmau	fakapumau
wharenui	farenui
ātete	atete
Kāhui	kahui
Ngapuhi	Napuhi
Runanga	runaNa
Timi	timi
Whakataunga	fakatauNa
apopo	apopo
hika	hika
hiku	hiku
honoa	honoa
kumea	kumea
kīhai	kiha
marea	marea
ngārara	Narara
puhi	puhi
rawatia	rawatia
rūnanga	runaNa
tohaina	tohana
whaia	faa
whakarere	fakarere
wheke	feke
Hirini	hirini
Kōmihana	komihana
Mate	mate
Ngohe	Nohe
Rātapu	ratapu
eka	eka
haumi	haumi
huaina	huana
hākari	hakari
kapo	kapo
punga	puNa
punua	punua
ruku	ruku
rōia	roia
tuara	tuara
whakaekea	fakakea
whakahoutanga	fakahoutaNa
whiriwhiringa	firifiriNa
āe	ae
Ahupūngao	ahupuNa
Koro	koro
Nāwai	nawa
Peter	peter
Puketeraki	puketeraki
Pēpuere	pepuere
Rūnaka	runaka
Taiao	taa
Whakaata	fakaata
Whātaitai	fatata
aka	aka
anoo	anoo
hipi	hipi
iri	iri
pononga	ponoNa
pāwhiri	pafiri
pūtohu	putohu
raakau	raakau
roimata	romata
tāpaetanga	tapataNa
tāua	taua
tōkeke	tokeke
uku	uku
waiaro	waaro
whakaahuatia	fakaahuatia
whakaatuhia	fakaatuhia
whakamaharatanga	fakamaharataNa
whakaratohia	fakaratohia
whakarārangi	fakararaNi
whakatutukitanga	fakatutukitaNa
Harakeke	harakeke
Heuheu	heuheu
Huirapa	huirapa
Hōngongoi	hoNoNo
Mere	mere
Mihinare	mihinare
Ngaheu	Naheu
Taupo	taupo
Tiaki	tiaki
ahei	ahei
hangarite	haNarite
hine	hine
huānga	huaNa
karangatanga	karaNataNa
mātao	mata
pakupaku	pakupaku
pia	pia
pōturi	poturi
repo	repo
rāwhiti	rafiti
titoa	titoa
toroa	toroa
Āti	ati
Kairangi	karaNi
MPI	mpi
Mahia	mahia
Mahuta	mahuta
Pouaka	pouaka
Puanga	puaNa
Raki	raki
Rangahau	raNahau
Rere	rere
Tangi	taNi
Tihema	tihema
Waitara	watara
ate	ate
huarere	huarere
hā	ha
kaitirotiro	katirotiro
kaiwhiwhi	kafifi
karahipi	karahipi
kauhau	kauhau
kiritaki	kiritaki
korowai	korowa
kowhatu	kofatu
kōaro	koaro
kōwhai	kofa
kōwhiria	kofiria
moemoeā	mwemwea
piriona	piriona
rae	ra
tāhuhu	tahuhu
tārua	tarua
whakatangi	fakataNi
whakatata	fakatata
whakatauranga	fakatauraNa
āwhinatia	afinatia
Apanui	apanui
Mane	mane
Taupō	taupo
Tongarewa	toNarewa
Tūranga	turaNa
an	an
ekenga	ekeNa
horahia	horahia
huia	huia
kaainga	kaaNa
kaitito	katito
korokoro	korokoro
manene	manene
matawaka	matawaka
mö	mo
paemahana	pamahana
pūwāhi	puwahi
raanei	raanei
turi	turi
uhia	uhia
whakaakona	fakaakona
whakaara	fakaara
whakakitenga	fakakiteNa
whiri	firi
ëtahi	etahi
ākona	akona
īnanga	inaNa
Aurere	aurere
Kawekawe	kawekawe
Kirikiriroa	kirikiriroa
Kāre	kare
Maketu	maketu
Ngāpuhi	Napuhi
Tūmatauenga	tumataueNa
hihi	hihi
kohuru	kohuru
kori	kori
miro	miro
māharahara	maharahara
mōkai	moka
paheko	paheko
paparanga	paparaNa
puru	puru
pānuitia	panuitia
pātaka	pataka
rahui	rahui
rāhui	rahui
taatai	taata
tūmataiti	tumatati
whakarahi	fakarahi
whakaraupapa	fakaraupapa
whutupōro	futuporo
Hopihona	hopihona
Kuki	kuki
Kāwhia	kafia
Mohi	mohi
Oranga	oraNa
Tuhoe	tuhwe
Wairoa	waroa
Whaea	faa
korenga	koreNa
meatia	meatia
mihingare	mihiNare
mē	me
pūkete	pukete
rapa	rapa
rapua	rapua
tahumaero	tahumaro
taupatupatu	taupatupatu
toitū	totu
umu	umu
whakawa	fakawa
wharekura	farekura
whutupaoro	futuparo
wāriu	wariu
Ano	ano
Atawhai	atafa
Hune	hune
Katoa	katoa
Taitokerau	tatokerau
Taurangi	tauraNi
arahi	arahi
ena	ena
hemo	hemo
kaihauturu	kahauturu
kainoho	kanoho
kaki	kaki
karekau	karekau
kui	kui
kuku	kuku
pitihana	pitihana
purapura	purapura
pātara	patara
pōhēhē	pohehe
rarangi	raraNi
tukinga	tukiNa
tūmahi	tumahi
tūrangawaewae	turaNawawa
waikano	wakano
waikawa	wakawa
whakamāramatia	fakamaramatia
ūpoko	upoko
Ihaka	ihaka
Kākano	kakano
Manawatū	manawatu
Mark	mark
Motuhake	motuhake
Rārangi	raraNi
Unit	unit
Whakamāramahia	fakamaramahia
kairangi	karaNi
karaehe	karahe
kauri	kauri
kiihia	kiihia
manako	manako
pirangi	piraNi
poho	poho
puare	puare
pūoro	puoro
ruma	ruma
takanga	takaNa
tatū	tatu
tuaka	tuaka
tūhonohono	tuhonohono
waihoki	wahoki
wananga	wanaNa
whakakorea	fakakorea
whakakorehia	fakakorehia
ārainga	araNa
Komihana	komihana
Korero	korero
Ta	ta
Toko	toko
Whakaaro	fakaaro
ahuareka	ahuareka
are	are
honohono	honohono
kaiwhakamahi	kafakamahi
koko	koko
marangai	maraNa
mataara	mataara
matakitaki	matakitaki
memeha	memeha
mihini	mihini
omaoma	omama
oo	oo
paearu	paaru
panga	paNa
parauri	parauri
pirepire	pirepire
pēwhea	pefea
pūkoro	pukoro
rawhiti	rafiti
rotarota	rotarota
tuitui	tuitui
turoro	turoro
tāpui	tapui
waia	waa
wetewete	wetewete
Ae	a
Awarua	awarua
Kōwhiri	kofiri
Matiu	matiu
Opotiki	opotiki
Pounamu	pounamu
Tinirau	tinirau
Tongariro	toNariro
Wairua	warua
arai	ara
arero	arero
ihirangi	ihiraNi
kamo	kamo
makere	makere
mautohe	mautohe
pakirehua	pakirehua
poka	poka
poroporoaki	poroporoaki
pungarehu	puNarehu
pupū	pupu
puāwai	puawa
reorua	reorua
rokohanga	rokohaNa
tauanga	tauaNa
tirotirohia	tirotirohia
titi	titi
tāhei	tahei
tāroaroa	taroaroa
tūpato	tupato
whaiwhai	fafa
whakaarotia	fakaarotia
whakahaerenga	fakahareNa
whakatu	fakatu
whakatūpato	fakatupato
whana	fana
Ināianei	inaianei
Kati	kati
Taka	taka
hāpori	hapori
hōnore	honore
ihi	ihi
inoi	ino
kanae	kana
kiripuaki	kiripuaki
koura	koura
kīnaki	kinaki
kīwaha	kiwaha
matatini	matatini
mokai	moka
nawe	nawe
nūpepa	nupepa
pani	pani
pāremata	paremata
pōtae	pota
rironga	riroNa
tauranga	tauraNa
tokowhā	tokofa
tāpae	tapa
tūroro	turoro
whakaingoa	fakaNoa
whakairi	fakari
whakama	fakama
whakamahana	fakamahana
whakamanahia	fakamanahia
whakatauhia	fakatauhia
whiore	fiore
wātaka	wataka
Ākarana	akarana
ākau	akau
Hongoeka	hoNweka
Kōwhiringa	kofiriNa
Otiia	otiia
Poutini	poutini
Rehua	rehua
Tairāwhiti	tarafiti
Tētahi	tetahi
aahua	aahua
huaki	huaki
hūnuku	hunuku
kaikawe	kakawe
kirikiri	kirikiri
kooti	kooti
kuraina	kurana
kāwana	kawana
mokemoke	mokemoke
nohoia	nohoa
pātuhi	patuhi
pīni	pini
pūtoru	putoru
tahitia	tahitia
taiepa	taepa
takere	takere
tiwhikete	tifikete
tutaki	tutaki
wahie	wahie
waiatatia	waatatia
whaimana	famana
whakawakanga	fakawakaNa
Āniwaniwa	aniwaniwa
ātea	atea
Hanuere	hanuere
Hauauru	hauauru
Hiko	hiko
Hone	hone
Kapiti	kapiti
MP	mp
Maru	maru
Mua	mua
Paerewa	parewa
Wenerei	wenerei
Whāinga	faiNa
aituā	atua
heketea	heketea
kaihoe	kahwe
karihi	karihi
keke	keke
kereru	kereru
korikori	korikori
manaakitia	manaakitia
mimiti	mimiti
mōkihi	mokihi
ngaki	Naki
ngarara	Narara
paura	paura
putake	putake
rereketanga	rereketaNa
rita	rita
rokiroki	rokiroki
rīpoata	ripoata
tahaki	tahaki
teka	teka
that	that
tukino	tukino
tupato	tupato
tëtahi	tetahi
tūhuratanga	tuhurataNa
whainga	faNa
whakahoahoa	fakahoahoa
whakamutu	fakamutu
whakaongaonga	fakaNaNa
whakawehe	fakawehe
whangai	faNa
Āpiha	apiha
Āwhina	afina
Kahurangi	kahuraNi
Matū	matu
Park	park
Poutama	poutama
Pērā	pera
Pū	pu
Tauiwi	tauiwi
Tokomaru	tokomaru
Whanau	fanau
ahatia	ahatia
anuhe	anuhe
etehi	etehi
hi	hi
hokowhitu	hokofitu
manga	maNa
papaki	papaki
poua	poua
rare	rare
rourou	rourou
rāwaho	rawaho
tatauria	tatauria
tautokohia	tautokohia
tawahi	tawahi
tereina	tereina
tia	tia
tonutanga	tonutaNa
tuatahitia	tuatahitia
waituhi	watuhi
waro	waro
whaitua	fatua
whakatauki	fakatauki
whakautua	fakautua
whakawātea	fakawatea
whānautanga	fanautaNa
whētui	fetui
Ōtaki	otaki
Heoti	heoti
Huia	huia
Iti	iti
Karaitiana	karatiana
Kitea	kitea
Kāpiti	kapiti
Mea	mea
Rangahautia	raNahautia
Urewera	urewera
aronui	aronui
keehi	keehi
motopaika	motopaka
ngâ	Na
nona	nona
nēhi	nehi
ohotata	ohotata
okioki	okioki
pona	pona
pooti	pooti
rino	rino
ruia	ruia
takahanga	takahaNa
torotika	torotika
tāngia	taNia
tārai	tara
uauatanga	uauataNa
whakamarumaru	fakamarumaru
whakamaua	fakamaua
whakaminenga	fakamineNa
whakamoemiti	fakamwemiti
whakarawe	fakarawe
whakarerea	fakarerea
whakarērea	fakarerea
whakawā	fakawa
Ōtākou	otakou
Hāmoa	hamoa
Hōne	hone
Hūrae	hura
Irirangi	iriraNi
Katorika	katorika
Kawerau	kawerau
Korimako	korimako
Kāreti	kareti
Rāwhitiroa	rafitiroa
Rāwiri	rawiri
Tangohia	taNohia
Tumu	tumu
Whiro	firo
Whātua	fatua
aitanga	ataNa
haepapa	hapapa
hakari	hakari
hihiri	hihiri
huakita	huakita
kaimoana	kamoana
kari	kari
mangai	maNa
manuka	manuka
matawhānui	matafanui
maui	maui
mena	mena
moku	moku
māku	maku
nanakia	nanakia
ngata	Nata
pane	pane
penapena	penapena
pōro	poro
rätou	ratou
their	their
tote	tote
tuanui	tuanui
tāra	tara
tī	ti
tītī	titi
waiwai	wawa
whakaaroaro	fakaaroaro
whakamataku	fakamataku
whakaoranga	fakaraNa
whakawhanakehia	fakafanakehia
Āpirana	apirana
Ahuriri	ahuriri
Paremata	paremata
Puta	puta
Raumati	raumati
Tāwhirimātea	tafirimatea
arahina	arahina
arohaehae	arohaha
heihei	heihei
henemita	henemita
it	it
kanga	kaNa
kingi	kiNi
kohikohinga	kohikohiNa
maranga	maraNa
mirumiru	mirumiru
morehu	morehu
mātaitai	matata
mātaki	mataki
ngaarara	Naarara
pakiaka	pakiaka
papatipu	papatipu
paremata	paremata
poropiti	poropiti
pītara	pitara
pūrua	purua
tauākī	tauaki
tio	tio
totoka	totoka
unahi	unahi
whakaarahia	fakaarahia
whakahe	fakahe
whakamahara	fakamahara
whitinga	fitiNa
Kawiti	kawiti
Pakihi	pakihi
Piki	piki
Roopu	roopu
Tamanuiterā	tamanuitera
Tiamana	tiamana
Tūhuratia	tuhuratia
Uru	uru
Whakapā	fakapa
aranga	araNa
hitori	hitori
huakina	huakina
hāereere	haereere
kererū	kereru
kākāriki	kakariki
motoka	motoka
mätauranga	matauraNa
pangia	paNia
pauna	pauna
pānuihia	panuihia
taimaha	tamaha
toronga	toroNa
tupeka	tupeka
tāpiritia	tapiritia
tātaki	tataki
tāutuhia	tautuhia
tēra	tera
whakamanaia	fakamanaa
whakamatau	fakamatau
whakamāoritanga	fakamaoritaNa
whakararu	fakararu
whakareatia	fakareatia
whakatauria	fakatauria
whakatūnga	fakatuNa
whakaurunga	fakauruNa
whakawhitia	fakafitia
āporo	aporo
Hana	hana
Hononga	honoNa
Hānuere	hanuere
Moriori	moriori
Māngai	maNa
Ngoi	No
Pakiwaitara	pakiwatara
Rangatiratanga	raNatirataNa
Ropu	ropu
Tahiti	tahiti
Tautake	tautake
Toku	toku
Waru	waru
Whakaputanga	fakaputaNa
Wikitōria	wikitoria
haruru	haruru
hawhe	hafe
kawenata	kawenata
keri	keri
maakete	maakete
maatou	maatou
mārika	marika
patunga	patuNa
pihikete	pihikete
piko	piko
poupou	poupou
rapunga	rapuNa
rōpu	ropu
takotoranga	takotoraNa
tokorima	tokorima
tunua	tunua
tōraro	toraro
whakamanatia	fakamanatia
whakaoho	fakaho
whakapuakina	fakapuakina
whakawehi	fakawehi
whata	fata
whāriki	fariki
Ūpoko	upoko
ūngeri	uNeri
Hēmi	hemi
Ihipa	ihipa
Manawa	manawa
Naku	naku
Nama	nama
One	one
Pari	pari
Pewhairangi	pefaraNi
Pātai	pata
What	fat
angitū	aNitu
hiakai	hiaka
kaingākau	kaNakau
kaipatu	kapatu
karaihe	karahe
kīrehe	kirehe
matakite	matakite
meinga	meiNa
muru	muru
mä	ma
naianei	naanei
naku	naku
niupepa	niupepa
paipa	papa
piriti	piriti
piro	piro
pātītī	patiti
taihoa	tahoa
taokete	takete
waatea	waatea
whakamāoritia	fakamaoritia
whakaruruhau	fakaruruhau
whakawhetai	fakafeta
wheua	feua
wē	we
Ahu	ahu
Aotea	atea
Kae	ka
Kawenata	kawenata
Koroni	koroni
Mahuika	mahuika
Mārama	marama
Peretānia	peretania
Pūtea	putea
Tāpiripiri	tapiripiri
Tāpiritanga	tapiritaNa
Wherowhero	ferofero
anei	anei
anōtia	anotia
hae	ha
hangai	haNa
hapai	hapa
hauota	hauota
kiromita	kiromita
kuhuna	kuhuna
kīngi	kiNi
kōhao	koha
mahanga	mahaNa
moheni	moheni
motumotu	motumotu
mārire	marire
ohaoha	ohaha
pipi	pipi
ranga	raNa
raupapatanga	raupapataNa
rongohia	roNohia
rōpinepine	ropinepine
tuarā	tuara
tui	tui
tukituki	tukituki
tuumomo	tuumomo
tōpito	topito
whaka	faka
whakahiato	fakahiato
whakapaetia	fakapatia
Akoranga	akoraNa
Hoko	hoko
Iharaira	iharara
Makaawhio	makaafio
Martin	martin
Matau	matau
Paetae	pata
Pei	pei
Pepuere	pepuere
Purapura	purapura
Pāho	paho
Rangitukutuku	raNitukutuku
Roa	roa
Ruru	ruru
Tame	tame
Wera	wera
Whakatāne	fakatane
arohia	arohia
awangawanga	awaNawaNa
haunga	hauNa
hura	hura
hōiho	hoiho
kaitakaro	katakaro
koroheke	koroheke
kōawa	koawa
kōharinga	kohariNa
maka	maka
mama	mama
matimati	matimati
moemoea	mwemwea
paihikara	pahikara
purei	purei
raukura	raukura
ririki	ririki
ruihi	ruihi
rōnaki	ronaki
taitama	tatama
tapuwae	tapuwa
tauaromahi	tauaromahi
tinihanga	tinihaNa
turakina	turakina
tātaitanga	tatataNa
whakaea	fakaa
whakarereke	fakarereke
whitianga	fitiaNa
āpōpō	apopo
Hami	hami
Kahukura	kahukura
Kaihauturu	kahauturu
Kaipara	kapara
Kawakawa	kawakawa
Mauri	mauri
Onehunga	onehuNa
Pānuihia	panuihia
Pūrongo	puroNo
Ra	ra
Tāwhiao	tafia
Whakatū	fakatu
hauauru	hauauru
hauhā	hauha
hikoi	hiko
inea	inea
kaiwhaiwhai	kafafa
korekore	korekore
mahitahi	mahitahi
maramataka	maramataka
miramira	miramira
mou	mou
nohonga	nohoNa
noke	noke
pahū	pahu
popo	popo
pāhekoheko	pahekoheko
pēhi	pehi
pēne	pene
rangimārie	raNimarie
rango	raNo
ruahine	ruahine
rīwai	riwa
taparau	taparau
tarutaru	tarutaru
taurekareka	taurekareka
tautuhia	tautuhia
whakahoutia	fakahoutia
whakarara	fakarara
whakarāpopoto	fakarapopoto
whakawhānau	fakafanau
wharekai	fareka
whiria	firia
Ake	ake
Hori	hori
Irawaru	irawaru
Moe	mwe
Moutere	moutere
Ngatoro	Natoro
Rangihaeata	raNihaata
Rewi	rewi
Rukuwai	rukuwa
Takurua	takurua
Taniwha	tanifa
Whakaarohia	fakaarohia
Wharekauri	farekauri
White	fite
Wāhi	wahi
anahe	anahe
haupū	haupu
hohou	hohou
hāngī	haNi
kaiwaiata	kawaata
kauwhau	kaufau
kohu	kohu
mare	mare
marie	marie
matemate	matemate
ngētehi	Netehi
paheke	paheke
pao	pa
paua	paua
pātapa	patapa
pī	pi
rangahautanga	raNahautaNa
raupatutia	raupatutia
taona	tana
tohora	tohora
toia	toa
tātaitai	tatata
tōnā	tona
tūtū	tutu
uniana	uniana
waiora	waora
whakaawe	fakaawe
whakangaro	fakaNaro
whakatangitangi	fakataNitaNi
whakauruhia	fakauruhia
whakawhiwhi	fakafifi
wikitoria	wikitoria
ākina	akina
Ahi	ahi
Aute	aute
Hai	ha
Hau	hau
Hurinui	hurinui
King	kiN
Mātaiako	mataako
Nuku	nuku
Pōmare	pomare
Ringatū	riNatu
Rānana	ranana
Tairawhiti	tarafiti
Taraipiunara	tarapiunara
Tukutuku	tukutuku
Tuwharetoa	tufaretoa
Whakahoki	fakahoki
awaawa	awaawa
haeretia	haretia
hu	hu
hātepe	hatepe
kaiarahi	kaarahi
kao	ka
kaupeka	kaupeka
koinā	kona
koiwi	kowi
korerohia	korerohia
korerorero	korerorero
koreutu	koreutu
marire	marire
murua	murua
mākete	makete
pokohiwi	pokohiwi
pōtitia	potitia
rawakore	rawakore
tahatika	tahatika
tapanga	tapaNa
tipua	tipua
tuarima	tuarima
tuhituhia	tuhituhia
tēna	tena
tūpāpaku	tupapaku
waiu	wau
watea	watea
whakairia	fakaria
whakamīharo	fakamiharo
whakatuwheratanga	fakatuferataNa
whāea	faea
Ahurei	ahurei
Akuhata	akuhata
Home	home
Hōri	hori
Inia	inia
Māmā	mama
Nu	nu
Our	our
Paikea	pakea
Paora	para
Pāpāho	papaho
Rawa	rawa
Rawiri	rawiri
Rēkohu	rekohu
Tatau	tatau
Tomo	tomo
Tāpiri	tapiri
Whiriwhiria	firifiria
Whā	fa
awheawhe	afeafe
hauā	haua
heru	heru
hukarere	hukarere
io	io
itiiti	itiiti
kaiwhakaatu	kafakaatu
kātua	katua
mihimihi	mihimihi
ngaua	Naua
nāwai	nawa
ohanga	ohaNa
ohu	ohu
peia	peia
pihi	pihi
puhia	puhia
pēpē	pepe
rano	rano
rīhi	rihi
taetae	tata
tanumia	tanumia
tauparapara	tauparapara
taupānga	taupaNa
tuemi	tuemi
tōpū	topu
whakaemi	fakami
whakamiharo	fakamiharo
whakaraerae	fakarara
whakawai	fakawa
wāwāhitanga	wawahitaNa
Āhua	ahua
Anga	aNa
Haratua	haratua
Herewini	herewini
Ihu	ihu
Ira	ira
Karahipi	karahipi
Karaka	karaka
Māku	maku
Papahurihia	papahurihia
Patāriana	patariana
Poihākena	pohakena
Pāpā	papa
Taketake	taketake
Takoto	takoto
Tamaiti	tamati
Tiki	tiki
Toru	toru
Tātou	tatou
War	war
Wā	wa
Wīwī	wiwi
aorangi	araNi
haumanu	haumanu
hautekau	hautekau
hākona	hakona
hāngi	haNi
kaupapahere	kaupapahere
kuare	kuare
manomano	manomano
mapi	mapi
marara	marara
ngaku	Naku
panaia	panaa
parakuihi	parakuihi
pare	pare
pikitanga	pikitaNa
potiki	potiki
purua	purua
pāhotanga	pahotaNa
pātene	patene
ro	ro
rātaka	rataka
tapere	tapere
tatai	tata
tauhohe	tauhohe
taunekeneke	taunekeneke
taurewa	taurewa
titonga	titoNa
tohi	tohi
torongū	toroNu
tënei	tenei
tāruarua	taruarua
tēina	teina
tūkino	tukino
whakaarotanga	fakaarotaNa
whakaekenga	fakakeNa
whakarāpopototanga	fakarapopototaNa
whakatuwheratia	fakatuferatia
ārahina	arahina
Airani	arani
Aratakina	aratakina
Ati	ati
Hanga	haNa
Hemi	hemi
Hikurangi	hikuraNi
Ingarani	iNarani
Kaa	kaa
Kī	ki
Manukau	manukau
Maoritanga	maritaNa
Maungapōhatu	mauNapohatu
More	more
Māu	mau
Pōtae	pota
Pūhipi	puhipi
Pūtahi	putahi
Taiwhanga	tafaNa
Tarawera	tarawera
Toitū	totu
Tokorua	tokorua
Whakaritenga	fakariteNa
Whakawhiti	fakafiti
Whangarei	faNarei
Whatu	fatu
autō	auto
haurangi	hauraNi
heria	heria
hohipera	hohipera
hohonu	hohonu
hokia	hokia
hopi	hopi
huahua	huahua
hēkeretari	hekeretari
irahiko	irahiko
itinga	itiNa
katia	katia
kohanga	kohaNa
kohikohia	kohikohia
kotahitanga	kotahitaNa
körero	korero
kōhauhau	kohauhau
kōmihana	komihana
maunu	maunu
moa	moa
mätou	matou
mārena	marena
nōhanga	nohaNa
orokohanga	orokohaNa
porohita	porohita
potae	pota
pupu	pupu
pūmotu	pumotu
taiora	taora
takurua	takurua
taupoki	taupoki
tauwhāinga	taufaiNa
toetoe	twetwe
tuari	tuari
waiū	wau
wana	wana
whakamahuki	fakamahuki
whakapaua	fakapaua
whakapuakanga	fakapuakaNa
whakarerekētanga	fakarereketaNa
whakawhanaunga	fakafanauNa
whawhati	fafati
whāwhā	fafa
āku	aku
Aperira	aperira
Ata	ata
Hapori	hapori
Hongi	hoNi
Horowhenua	horofenua
Hēnare	henare
Kurī	kuri
Matauranga	matauraNa
MāoriHe	maori he
Māoritanga	maoritaNa
Pātaka	pataka
Rangahaua	raNahaua
Rāpare	rapare
Tiireni	tiireni
Tua	tua
Tōku	toku
Tūhono	tuhono
Wahine	wahine
Wairau	warau
Whakaari	fakaari
Whakaue	fakaue
Whenu	fenu
amio	amio
heamana	heamana
honore	honore
hōhonutanga	hohonutaNa
kaitohu	katohu
kaiwhakaari	kafakaari
katau	katau
kawau	kawau
kikokiko	kikokiko
kuhunga	kuhuNa
manakohia	manakohia
mākū	maku
mātotoru	matotoru
paahitia	paahitia
pakimaero	pakimaro
pohewa	pohewa
rewharewha	refarefa
takatū	takatu
tutakina	tutakina
tīmatatanga	timatataNa
tōkena	tokena
tūroa	turoa
werawera	werawera
whakamātauria	fakamatauria
whakamōhiotia	fakamohiotia
whakaranu	fakaranu
whakatakotohia	fakatakotohia
whiriwhirihia	firifirihia
ōpaki	opaki
Ūropi	uropi
Aromatawai	aromatawa
Eramiha	eramiha
Ha	ha
Hua	hua
Kaikōura	kakoura
Kuia	kuia
Marau	marau
Mātenga	mateNa
Pahi	pahi
Paipera	papera
Paraone	parane
Parata	parata
Point	pont
Pāora	paora
Rongowhakaata	roNofakaata
Ruanui	ruanui
Tamihana	tamihana
Tipene	tipene
Tirohanga	tirohaNa
Waea	waa
Whakaatu	fakaatu
Whakamoemiti	fakamwemiti
Whakarite	fakarite
Whakatohea	fakatohea
hori	hori
korakora	korakora
koropupū	koropupu
kōeke	koeke
maero	maro
mauheretia	mauheretia
mihia	mihia
momoho	momoho
mēra	mera
nakunaku	nakunaku
nekehia	nekehia
neketai	neketa
ngohi	Nohi
ngongo	NoNo
nē	ne
panuku	panuku
porihanga	porihaNa
puawai	puawa
pueru	pueru
pukuriri	pukuriri
putunga	putuNa
pāwhiria	pafiria
rangahaua	raNahaua
rohenga	roheNa
rāhuitia	rahuitia
taiwhanga	tafaNa
takawaenga	takawaNa
tamatāne	tamatane
tauoti	tauoti
toona	toona
totohu	totohu
tuaahu	tuaahu
tukinotia	tukinotia
tupua	tupua
tōtara	totara
uia	uia
ware	ware
whakareri	fakareri
wīra	wira
wīwhara	wifara
āpiti	apiti
Ēngari	eNari
ūnga	uNa
Aka	aka
Aua	aua
Hinemoana	hinemoana
Huri	huri
Impromptu	impromptu
Karakia	karakia
Maunganui	mauNanui
Moananui	moananui
Muri	muri
Mātaatua	mataatua
Piripi	piripi
Rarawa	rarawa
Roimata	romata
Ruma	ruma
Runtime	runtime
Rākau	rakau
Taihoa	tahoa
Tiati	tiati
Tohutohu	tohutohu
Waikano	wakano
Whakaakoranga	fakaakoraNa
Whakatairanga	fakataraNa
ae	a
hakinakina	hakinakina
hauhake	hauhake
horapa	horapa
kaiwhakanoho	kafakanoho
kakā	kaka
kokiri	kokiri
kōnei	konei
maitai	mata
maringi	mariNi
marino	marino
matomato	matomato
papamahi	papamahi
patapatai	patapata
piripono	piripono
pūhiko	puhiko
pūrerehua	purerehua
rekoata	rekoata
runanga	runaNa
rūri	ruri
takapau	takapau
taumahi	taumahi
teetahi	teetahi
timu	timu
tomokanga	tomokaNa
uma	uma
ure	ure
urupā	urupa
weropepahia	weropepahia
whakahokinga	fakahokiNa
whakaniko	fakaniko
whakaorangia	fakaraNia
whakaroa	fakaroa
whakatuwhera	fakatufera
whakaute	fakaute
whatunga	fatuNa
āki	aki
ārani	arani
āwhā	afa
ēnā	ena
Ōtepoti	otepoti
Au	au
Eke	eke
Harawira	harawira
Hurae	hura
Hīkoi	hiko
Karanga	karaNa
Kawea	kawea
Kawhia	kafia
Koinā	kona
Kāpene	kapene
Kōrerohia	korerohia
Matapakia	matapakia
MauHe	mau he
Papamoa	papamoa
Peti	peti
Rapua	rapua
Tapahia	tapahia
Tikina	tikina
Tohunga	tohuNa
Tokohia	tokohia
Tuhituhi	tuhituhi
Tūrei	turei
Waihi	wahi
Waikanae	wakana
Whakatakotoria	fakatakotoria
Whetu	fetu
Wikitoria	wikitoria
anö	ano
arotakenga	arotakeNa
auahatanga	auahataNa
aue	aue
hongi	hoNi
hōrapa	horapa
kaho	kaho
kaitiakitanga	katiakitaNa
karauna	karauna
koraha	koraha
kōanga	koaNa
maioha	maoha
maioro	maoro
manatārua	manatarua
marena	marena
muna	muna
māwhitiwhiti	mafitifiti
ngenge	NeNe
nohinohi	nohinohi
oreore	oreore
paingia	paNia
pakihiwi	pakihiwi
poihau	pohau
puea	puea
pumau	pumau
pure	pure
pākete	pakete
pūoho	puoho
pūtakenga	putakeNa
raka	raka
riterite	riterite
rēhia	rehia
taima	tama
taipakeke	tapakeke
tapuhi	tapuhi
tarukino	tarukino
tatu	tatu
taukumekume	taukumekume
ti	ti
totara	totara
tāhū	tahu
tāwere	tawere
tūtohinga	tutohiNa
uha	uha
wae	wa
week	week
whakaaehia	fakaahia
whakahaua	fakahaua
whakamāherehere	fakamaherehere
whakarerekētia	fakarereketia
whakatauākī	fakatauaki
Ākuhata	akuhata
ānō	ano
ārikarika	arikarika
Air	ar
An	an
Hautau	hautau
Ingoa	iNoa
Kawariki	kawariki
Mataatua	mataatua
Meiha	meiha
Mātāwai	matawa
Paerua	parua
Pihinga	pihiNa
Rangiātea	raNiatea
Rauru	rauru
Rupe	rupe
Tuatoru	tuatoru
Tuia	tuia
Tāngia	taNia
Waharoa	waharoa
Wananga	wanaNa
Whakaaetanga	fakaataNa
Wāhine	wahine
akiakihia	akiakihia
arotakengia	arotakeNia
hangi	haNi
hangā	haNa
hautaka	hautaka
hinonga	hinoNa
hore	hore
huarākau	huarakau
kaa	kaa
kahui	kahui
kaieke	kaeke
kaitoi	kato
kaiwhakawa	kafakawa
kawana	kawana
kemu	kemu
kiriuhi	kiriuhi
kēkē	keke
kōpū	kopu
mamao	mama
matataunga	matatauNa
mohoa	mohoa
māhunga	mahuNa
māuiui	mauiui
nehu	nehu
ohia	ohia
paetuku	patuku
parenga	pareNa
paruparu	paruparu
pātiki	patiki
raa	raa
rāwekeweke	rawekeweke
taiopenga	taopeNa
tokoono	tokoono
tokotoko	tokotoko
too	too
tuaina	tuana
tungane	tuNane
tuunga	tuuNa
tōmuri	tomuri
uiuitanga	uiuitaNa
uka	uka
waku	waku
whakahaerea	fakaharea
whakahīhī	fakahihi
whakapumautia	fakapumautia
whakapākehātanga	fakapakehataNa
whakatairitea	fakataritea
whakatinanahia	fakatinanahia
whao	fa
wini	wini
Āperira	aperira
Ōrākei	orakei
Akuanei	akuanei
Here	here
Hereturikōkā	hereturikoka
Hutt	hutt
Kaihautū	kahautu
Kaiwhakawā	kafakawa
Kare	kare
Koianei	koanei
Kororāreka	kororareka
Korowaitanga	korowataNa
Kā	ka
Matakite	matakite
Mokopuna	mokopuna
Mōhio	mohio
Nohotima	nohotima
Pikiao	pikia
Puke	puke
Tuwhakairiora	tufakariora
Waaka	waaka
Wehea	wehea
Whakaako	fakaako
Wī	wi
aki	aki
autaia	autaa
ha	ha
harakoa	harakoa
haumarutanga	haumarutaNa
hikareti	hikareti
hoea	hwea
hōpara	hopara
kaitoro	katoro
kakama	kakama
kakano	kakano
kapahaka	kapahaka
karamu	karamu
karapoti	karapoti
makau	makau
mei	mei
moata	moata
mīhana	mihana
mīti	miti
nehera	nehera
new	new
nōhia	nohia
onamata	onamata
otiia	otiia
pupuritia	pupuritia
pāho	paho
pēhia	pehia
pūmua	pumua
pūrama	purama
raima	rama
roia	roa
taiwhenua	tafenua
takaia	takaa
takina	takina
takitini	takitini
tuatara	tuatara
tārewa	tarewa
tātahi	tatahi
urutomo	urutomo
utanga	utaNa
whakamā	fakama
whakamāmā	fakamama
whakamāramahia	fakamaramahia
whakanohoia	fakanohoa
whakapuakitanga	fakapuakitaNa
whakapūmautia	fakapumautia
whakarei	fakarei
whakataka	fakataka
whakatutukihia	fakatutukihia
whakatūngia	fakatuNia
whakawhanaungatanga	fakafanauNataNa
whakawhāiti	fakafaiti
wharepaku	farepaku
whatumanawa	fatumanawa
wä	wa
Āhia	ahia
ārahitanga	arahitaNa
Aoraki	araki
Aronui	aronui
Hato	hato
Haumaru	haumaru
Huinga	huiNa
Hītori	hitori
In	in
Kaimahi	kamahi
Keepa	keepa
Koi	ko
Kokiri	kokiri
Mike	mike
Māna	mana
N	n
Panguru	paNuru
Parore	parore
Pīpī	pipi
Rongopai	roNopa
Ruatapu	ruatapu
Rāmere	ramere
Tamati	tamati
Tiwhikete	tifikete
Tupu	tupu
Tāmati	tamati
Tāpirihia	tapirihia
Tīhema	tihema
Tūturu	tuturu
Whakauru	fakauru
Whangaroa	faNaroa
Whetū	fetu
akuanei	akuanei
haehae	haha
hopukanga	hopukaNa
horoia	horoa
huawhenua	huafenua
kaaore	kaare
kaiwhakarato	kafakarato
kanorau	kanorau
kirikiti	kirikiti
kuini	kuini
kīa	kia
kōtui	kotui
mango	maNo
mangu	maNu
mania	mania
matikara	matikara
mauhere	mauhere
mm	mm
mōrehu	morehu
oi	o
oko	oko
onāianei	onaianei
ota	ota
paetahi	patahi
paparau	paparau
pereti	pereti
pohehe	pohehe
pouaru	pouaru
pōkākā	pokaka
rangirua	raNirua
rangitahi	raNitahi
ranunga	ranuNa
reinga	reiNa
reri	reri
rïroa	riroa
tauaro	tauaro
tauhono	tauhono
taumahatanga	taumahataNa
taurua	taurua
tuaono	tuano
tunga	tuNa
tuu	tuu
tīmataria	timataria
tīpakohia	tipakohia
tūao	tua
tūwhera	tufera
tūāhuatanga	tuahuataNa
warea	warea
weheruatanga	weheruataNa
whaa	faa
whakamohio	fakamohio
whano	fano
wāwāhia	wawahia
āhuahanga	ahuahaNa
Aha	aha
Anau	anau
Ani	ani
Apa	apa
Ataata	ataata
Eruera	eruera
Haane	haane
Kaitaia	kataa
Kaitirotiro	katirotiro
Manahi	manahi
Mataira	matara
Mātai	mata
Pango	paNo
Patupaiarehe	patupaarehe
Peehi	peehi
Pīngao	piNa
Pūkenga	pukeNa
Rakiura	rakiura
Rāhina	rahina
TE	te
TTR	ttr
Takitimu	takitimu
Tapuika	tapuika
Tui	tui
Tīkina	tikina
Tīmoti	timoti
Uropi	uropi
Wahi	wahi
Wanganui	waNanui
Whakangungu	fakaNuNu
Whakapono	fakapono
Whakareatia	fakareatia
Whiriwhiri	firifiri
ahupūngao	ahupuNa
amotai	amota
arawhata	arafata
autōhiko	autohiko
ekore	ekore
hauāuru	hauauru
heipū	heipu
hihiko	hihiko
hinaki	hinaki
huhu	huhu
hukihuki	hukihuki
ianei	ianei
ihiihi	ihiihi
inanga	inaNa
kaitā	kata
kaiwhakamāori	kafakamaori
kaiwhakatairanga	kafakataraNa
kapohia	kapohia
kaupare	kaupare
koorero	koorero
kopu	kopu
kākā	kaka
kāpehu	kapehu
kāti	kati
matatapu	matatapu
mauritau	mauritau
mohiotanga	mohiotaNa
mokomoko	mokomoko
nge	Ne
nukunuku	nukunuku
nāku	naku
pukumahi	pukumahi
pāhekeheke	pahekeheke
pāpāhua	papahua
pāua	paua
pōtiki	potiki
pūkahukahu	pukahukahu
pūkeko	pukeko
rara	rara
rei	rei
reiti	reiti
rūmaki	rumaki
takahuri	takahuri
takitaki	takitaki
tauria	tauria
tauwhitiwhiti	taufitifiti
tonuhia	tonuhia
tuohu	tuohu
turu	turu
tāpaea	tapaa
tūhurangia	tuhuraNia
uiuia	uiuia
ururua	ururua
whakapehapeha	fakapehapeha
whakapiria	fakapiria
whakarauoratanga	fakarauorataNa
whakarōpūtanga	fakaroputaNa
whakawhitihia	fakafitihia
whatitoka	fatitoka
whiunga	fiuNa
whātoro	fatoro
Āhuatanga	ahuataNa
āhukahuka	ahukahuka
Aitanga	ataNa
Aue	aue
Hainamana	hanamana
Hoa	hoa
Ian	ian
Ipukarea	ipukarea
Kanawa	kanawa
Kauaka	kauaka
Kohai	koha
Kīhai	kiha
Materoa	materoa
Matihiko	matihiko
Moemiti	mwemiti
Māhaki	mahaki
Mākarini	makarini
Nāu	nau
Otautahi	otautahi
Pīhopa	pihopa
Rahui	rahui
Raukura	raukura
Riro	riro
Roto	roto
Ruatara	ruatara
Tamatea	tamatea
Tātaihia	tatahia
Tō	to
Uri	uri
Wairaka	waraka
Whaitere	fatere
Whaitiri	fatiri
Whakairo	fakaro
Whakapapa	fakapapa
Wharehuia	farehuia
Whata	fata
Wi	wi
Wāwāhi	wawahi
aata	aata
angawaho	aNawaho
anā	ana
aratakina	aratakina
hapainga	hapaNa
hotoke	hotoke
huamoni	huamoni
hāpaitia	hapatia
iraoho	iraho
karetao	kareta
karoro	karoro
kinaki	kinaki
kēhi	kehi
kīhini	kihini
kōtuitui	kotuitui
māhere	mahere
mātātuhi	matatuhi
ngari	Nari
ngāwhā	Nafa
nuka	nuka
p	p
pakipaki	pakipaki
papatuhituhi	papatuhituhi
parea	parea
petihana	petihana
pirihi	pirihi
piringa	piriNa
piu	piu
puaki	puaki
pukepuke	pukepuke
pupuru	pupuru
pātaihia	patahia
pēhanga	pehaNa
raorao	rara
roroa	roroa
rēhitatia	rehitatia
taero	taro
tahuhu	tahuhu
tahā	taha
tapiri	tapiri
tutū	tutu
tāima	taima
tēwhea	tefea
tīkiti	tikiti
tōiriiri	toiriiri
tūmau	tumau
unu	unu
wairehu	warehu
wehewehenga	weheweheNa
weu	weu
whakaaraara	fakaaraara
whakairoiro	fakaroro
whakakai	fakaka
whakakāhore	fakakahore
whakamaherehere	fakamaherehere
whakarewatanga	fakarewataNa
whakaroto	fakaroto
whakato	fakato
wharangi	faraNi
wharau	farau
whāki	faki
āhea	ahea
āputa	aputa
Awakairangi	awakaraNi
ERO	ero
H	h
Hinemoa	hinemoa
Hoahoatia	hoahoatia
Horo	horo
Katikati	katikati
Kumeroa	kumeroa
Maku	maku
Matene	matene
Matt	matt
Mutunga	mutuNa
MāoriTe	maori te
Ngoingoi	NoNo
Papatuanuku	papatuanuku
Parahaki	parahaki
Paratene	paratene
Pare	pare
Pipi	pipi
Po	po
Pokapū	pokapu
Puhiwahine	puhiwahine
Puketapu	puketapu
Pēhi	pehi
Rapu	rapu
Tahua	tahua
Taiwhenua	tafenua
Tana	tana
Taonui	tanui
Taranga	taraNa
Tere	tere
Tini	tini
Tuhinga	tuhiNa
Tāpiria	tapiria
Tōna	tona
Tūtira	tutira
Whakamahi	fakamahi
Whakangahau	fakaNahau
akau	akau
anamata	anamata
apataki	apataki
apu	apu
eenei	eenei
haerea	harea
hahi	hahi
hangarua	haNarua
hauwaru	hauwaru
hiringa	hiriNa
huapae	huapa
huatau	huatau
hāngaitanga	haNataNa
hōro	horo
inarā	inara
kaiahuwhenua	kaahufenua
kaimātai	kamata
kaipūtaiao	kaputaa
kakau	kakau
karawhiu	karafiu
kopa	kopa
kotuku	kotuku
kāmera	kamera
kāpia	kapia
kōhinu	kohinu
kōwhaiwhai	kofafa
maera	mara
manomita	manomita
matatika	matatika
matawai	matawa
matika	matika
matā	mata
moka	moka
muramura	muramura
namata	namata
ngeri	Neri
ngeru	Neru
ngū	Nu
peenei	peenei
punaha	punaha
pōkai	poka
pūoru	puoru
rawaka	rawaka
riihi	riihi
rimu	rimu
ringatoi	riNato
riwai	riwa
ränei	ranei
rārangitanga	raraNitaNa
rēmana	remana
taa	taa
taau	taau
tahitanga	tahitaNa
taiaki	taaki
takahurihuri	takahurihuri
tanga	taNa
tangihia	taNihia
taumāhekeheke	taumahekeheke
tautōhito	tautohito
tea	tea
tohuhia	tohuhia
totika	totika
tuki	tuki
turaki	turaki
tāmi	tami
tāneke	taneke
tāpoi	tapo
tātaihia	tatahia
tītaha	titaha
tōrunga	toruNa
waero	waro
waihotia	wahotia
wairangi	waraNi
warewaretia	warewaretia
wawa	wawa
whakahōnore	fakahonore
whangaia	faNaa
wheketere	feketere
Āperahama	aperahama
Āwherika	aferika
āio	aio
ōnā	ona
Araroa	araroa
Art	art
Hahi	hahi
Haki	haki
Hape	hape
Horomona	horomona
Itari	itari
Karekau	karekau
Kawau	kawau
Mārire	marire
Napier	napier
Noa	noa
Oho	oho
Pani	pani
Patapātai	patapata
Pomare	pomare
Poronihana	poronihana
Pānga	paNa
Pōtitanga	potitaNa
RTM	rtm
Raihania	rahania
Ratana	ratana
Rauropi	rauropi
Rerenga	rereNa
Rotoiti	rototi
Taake	taake
Taite	tate
Tangohanga	taNohaNa
Tawhiao	tafia
Tina	tina
Tirani	tirani
Tāke	take
Waikaremoana	wakaremoana
Whiringa	firiNa
Whiwhi	fifi
aroā	aroa
aru	aru
hamama	hamama
hoihoi	hoho
hokihoki	hokihoki
kaikai	kaka
kaipakihi	kapakihi
kaiwhakangungu	kafakaNuNu
kakī	kaki
kiato	kiato
konihi	konihi
kotia	kotia
kuputuhi	kuputuhi
kutikuti	kutikuti
kutu	kutu
kāo	kao
kōhua	kohua
kōkuhu	kokuhu
mako	mako
makutu	makutu
manuwhiri	manufiri
muia	muia
mātātoa	matatoa
paihamu	pahamu
pakarutanga	pakarutaNa
pakiwaituhi	pakiwatuhi
papatahi	papatahi
paraihe	parahe
peha	peha
pewhea	pefea
pipiri	pipiri
piunga	piuNa
pokanoa	pokanoa
poupoutanga	poupoutaNa
pune	pune
purakau	purakau
pūtirotiro	putirotiro
rekereke	rekereke
riringi	ririNi
ritamano	ritamano
rito	rito
rongopai	roNopa
rīki	riki
taikaha	takaha
takiuru	takiuru
tautau	tautau
tautono	tautono
tohutoro	tohutoro
tupono	tupono
tōnga	toNa
tūhuratia	tuhuratia
unuhia	unuhia
utunga	utuNa
wehewehea	wehewehea
whakaawhiwhi	fakaafifi
whakaharatau	fakaharatau
whakamamae	fakamama
whakamatea	fakamatea
whakamaumahara	fakamaumahara
whakamaumaharatanga	fakamaumaharataNa
whakatoko	fakatoko
whakatōpū	fakatopu
whakatūhia	fakatuhia
whariki	fariki
whitiki	fitiki
whitiwhiti	fitifiti
whānako	fanako
wira	wira
wähi	wahi
wūru	wuru
Ārai	ara
Amorangi	amoraNi
Aperahama	aperahama
Aranga	araNa
Hapū	hapu
Hera	hera
Hika	hika
Hinewhaitiri	hinefatiri
Hokowhitu	hokofitu
Hotunui	hotunui
II	ii
Ine	ine
Kaitohutohu	katohutohu
Kao	ka
Kimi	kimi
Kopu	kopu
Korea	korea
Kāterina	katerina
Kōwhiria	kofiria
Manaaki	manaaki
Moehau	mwehau
Moeraki	mweraki
Moni	moni
Muriwai	muriwa
Paari	paari
Paeroa	paroa
Patariana	patariana
Piri	piri
Port	port
Potatau	potatau
Puoro	puoro
Pō	po
Pūreta	pureta
Rahi	rahi
Rangihiroa	raNihiroa
Rāniera	raniera
Rūaumoko	ruaumoko
Tahuri	tahuri
Takitahi	takitahi
Tamatoa	tamatoa
Tauanga	tauaNa
Tauaromahi	tauaromahi
Tom	tom
Toroa	toroa
Tuakana	tuakana
Tuhi	tuhi
Tuna	tuna
Ua	ua
Union	union
Waihangatia	wahaNatia
Whakamahinga	fakamahiNa
Whakamātauria	fakamatauria
ahumoana	ahumoana
arahau	arahau
haerehia	harehia
honi	honi
huritau	huritau
hēoi	heo
ihotanga	ihotaNa
iramutu	iramutu
kaitarai	katara
kame	kame
katakata	katakata
kereme	kereme
keria	keria
kōpaka	kopaka
kōpiro	kopiro
kōrari	korari
matao	mata
mawhiti	mafiti
momona	momona
moohio	moohio
moroiti	moroti
motupaika	motupaka
moumou	moumou
mōkito	mokito
mōku	moku
ngatahi	Natahi
ngira	Nira
noaiho	noaho
nohanga	nohaNa
ohonga	ohoNa
ohooho	ohooho
onepū	onepu
orite	orite
paea	paa
patupaiarehe	patupaarehe
poke	poke
poutū	poutu
pākeke	pakeke
pīrangitia	piraNitia
pōhara	pohara
pōhiri	pohiri
pūkei	pukei
rarau	rarau
rea	rea
repe	repe
riki	riki
ripa	ripa
taapiri	taapiri
takai	taka
tanu	tanu
tapatahi	tapatahi
taratara	taratara
taria	taria
tatahi	tatahi
tekoteko	tekoteko
tiamana	tiamana
toha	toha
tohia	tohia
tope	tope
tuatahitanga	tuatahitaNa
tuawhitu	tuafitu
tuia	tuia
tukatuka	tukatuka
tungāne	tuNane
turuki	turuki
turuturu	turuturu
tākina	takina
tākupu	takupu
tāruke	taruke
urutau	urutau
waina	wana
werohanga	werohaNa
whakaaotanga	fakaataNa
whakahekea	fakahekea
whakakao	fakaka
whakakāhoretia	fakakahoretia
whakamutua	fakamutua
whakanikoniko	fakanikoniko
whakapainga	fakapaNa
whakarau	fakarau
whakarewahia	fakarewahia
whakarārangitia	fakararaNitia
whakatakariri	fakatakariri
whakatītina	fakatitina
wiri	wiri
wānaka	wanaka
wētahi	wetahi
Ötautahi	otautahi
ënei	enei
Atiawa	atiawa
Awherika	aferika
Erima	erima
Herenga	hereNa
Hiranga	hiraNa
Hunga	huNa
Hākinakina	hakinakina
Karihi	karihi
Kīia	kiia
Mata	mata
Miro	miro
Muturangi	muturaNi
Nawai	nawa
Papaioea	papawea
Pau	pau
Pono	pono
Prime	prime
Pōkiha	pokiha
Raka	raka
Raupapahia	raupapahia
Rawinia	rawinia
Rongoā	roNoa
Ruawharo	ruafaro
Taha	taha
Taro	taro
Tatauria	tatauria
Tauihu	tauihu
Tianara	tianara
Tokomaha	tokomaha
Toro	toro
Tākaro	takaro
Tāngata	taNata
Tīmata	timata
Tūhura	tuhura
Wahanga	wahaNa
Waimate	wamate
Waiora	waora
Whakautua	fakautua
Whatatutu	fatatutu
Whatuiapiti	fatuiapiti
Whitinga	fitiNa
akohia	akohia
amorangi	amoraNi
arotau	arotau
haau	haau
hamumu	hamumu
haukoti	haukoti
haukāinga	haukaiNa
hautū	hautu
houhia	houhia
hīkoikoi	hikoko
hūnga	huNa
ioio	ioo
kahawai	kahawa
kaipāmu	kapamu
kaipūrongo	kapuroNo
katinga	katiNa
km	km
kokoti	kokoti
kuru	kuru
käore	kare
manahau	manahau
matamua	matamua
mataora	matara
mauhia	mauhia
mitamano	mitamano
moo	moo
mānuka	manuka
mārakerake	marakerake
māti	mati
mātāwaka	matawaka
nanao	nana
ngutuawa	Nutuawa
noku	noku
pahemo	pahemo
paiheretia	paheretia
pakipūmeka	pakipumeka
patohanga	patohaNa
pekanga	pekaNa
pekapeka	pekapeka
pereki	pereki
pokea	pokea
purākau	purakau
pänui	panui
pītau	pitau
pūranga	puraNa
pūtaketanga	putaketaNa
pūāhua	puahua
rerehua	rerehua
rongomau	roNomau
ru	ru
rumakina	rumakina
rērere	rerere
taatou	taatou
taihemahema	tahemahema
takiri	takiri
taotū	tatu
tautohua	tautohua
tauā	taua
teretere	teretere
toanga	toaNa
tohea	tohea
tohetohe	tohetohe
tākiri	takiri
tāonga	taoNa
tātaritanga	tataritaNa
umere	umere
wahapū	wahapu
wahia	wahia
waiariki	waariki
weherua	weherua
weka	weka
whakahaumako	fakahaumako
whakahoungia	fakahouNia
whakahāwea	fakahawea
whakahōu	fakahou
whakakotahitanga	fakakotahitaNa
whakamaheretia	fakamaheretia
whakamate	fakamate
whakaohooho	fakahooho
whakapaitanga	fakapataNa
whakapaparanga	fakapaparaNa
whakaratoa	fakaratoa
whakatikaina	fakatikana
whakatupuria	fakatupuria
whakatūturu	fakatuturu
whawhaitia	fafatia
wherawhera	ferafera
āniwhaniwha	anifanifa
īnoi	ino
Arapeta	arapeta
Area	area
Hakinakina	hakinakina
Hao	ha
Hawaii	hawai
Heamana	heamana
Hoi	ho
Hon	hon
Hoturoa	hoturoa
Ihenga	iheNa
Kaiapoi	kaapo
Kamo	kamo
Kiekie	kiekie
Kōhure	kohure
Maaui	maaui
Manuka	manuka
Matenga	mateNa
Matewhawhati	matefafati
Mauao	maua
Murihiku	murihiku
Network	network
Ngāruawāhia	Naruawahia
Pere	pere
Pitopito	pitopito
PōtiNgāwari	poti Nawari
Rangatahi	raNatahi
Rarohenga	raroheNa
Rito	rito
Ruatepupuke	ruatepupuke
Rārangihia	raraNihia
Teitei	teitei
Tokotoru	tokotoru
Tāhūhū	tahuhu
Tāmakimakaurau	tamakimakaurau
Tē	te
Tīpene	tipene
Wehi	wehi
Whakaae	fakaa
Whakatōhea	fakatohea
Wēteriana	weteriana
aianei	aanei
arotahinga	arotahiNa
hahana	hahana
hapūtanga	haputaNa
haurima	haurima
hautipua	hautipua
hewa	hewa
hinganga	hiNaNa
hukahuka	hukahuka
hīkaka	hikaka
hīkina	hikina
ikeike	ikeike
kaihaka	kahaka
kaingakau	kaNakau
kaingārahu	kaNarahu
kaiwhakamārama	kafakamarama
kaiwhakaora	kafakara
kaiwhakarite	kafakarite
kariri	kariri
karukaru	karukaru
kawekawe	kawekawe
kohine	kohine
kopae	kopa
kuaore	kuare
kï	ki
kāpene	kapene
kētanga	ketaNa
kūaha	kuaha
mahaki	mahaki
manawataki	manawataki
matarau	matarau
miihini	miihini
mirimiri	mirimiri
mokete	mokete
mānu	manu
mātārere	matarere
nekenekehanga	nekenekehaNa
ngahoro	Nahoro
ngoi	No
ngunguru	NuNuru
not	not
oona	oona
paerua	parua
pania	pania
paoho	paho
parai	para
parepare	parepare
patipati	patipati
patuki	patuki
piupiu	piupiu
pokai	poka
pürongo	puroNo
pāwera	pawera
pōtaka	potaka
pōuriuri	pouriuri
pūhia	puhia
pūira	puira
pūkana	pukana
pūkohu	pukohu
rangimarie	raNimarie
rarauhe	rarauhe
rerewhenua	rerefenua
taara	taara
takohanga	takohaNa
tapahanga	tapahaNa
tiaho	tiaho
tikaka	tikaka
tokowhitu	tokofitu
tuaiwi	tuawi
tuarongo	tuaroNo
tuke	tuke
tukia	tukia
tāruatia	taruatia
tūhonotanga	tuhonotaNa
up	up
whakahauhau	fakahauhau
whakahī	fakahi
whakairihia	fakarihia
whakakake	fakakake
whakamanatanga	fakamanataNa
whakamoe	fakamwe
whakamomori	fakamomori
whakanuitanga	fakanuitaNa
whakaputu	fakaputu
whakaranua	fakaranua
whakaratonga	fakaratoNa
whakarewaina	fakarewana
whakarākei	fakarakei
whakatahi	fakatahi
whakatipuria	fakatipuria
whakatōkia	fakatokia
whakawehea	fakawehea
whakawhitiwhitinga	fakafitifitiNa
whutuporo	futuporo
Ākene	akene
Ōpango	opaNo
AUT	aut
Aku	aku
Anā	ana
Aorangi	araNi
Aromātai	aromata
Ataarangi	ataaraNi
Emma	emma
Haria	haria
Hatupatu	hatupatu
Horouta	horouta
Inea	inea
Ipu	ipu
Kaipōti	kapoti
Kaiwhakaako	kafakaako
Kapene	kapene
Kauwhata	kaufata
Koe	kwe
Kohanga	kohaNa
Kuaka	kuaka
Makau	makau
Mano	mano
Maraenui	maranui
Mokoia	mokoa
Mātua	matua
Nōna	nona
Paengawhāwhā	paNafafa
Paraihe	parahe
Pera	pera
Ponga	poNa
Pūnaha	punaha
Rangitaiki	raNitaki
Rereroa	rereroa
Roera	rwera
Rēhita	rehita
Taiopenga	taopeNa
Tangaere	taNare
Tirikātene	tirikatene
Tokowhā	tokofa
Turei	turei
Tīmatanga	timataNa
Tūhurahia	tuhurahia
Wero	wero
Whakaminenga	fakamineNa
Whakanui	fakanui
Whakataetae	fakatata
angaanga	aNaaNa
anuanu	anuanu
aria	aria
aute	aute
haehaea	hahaa
haupapa	haupapa
heri	heri
hina	hina
hiriwa	hiriwa
ho	ho
huata	huata
hōpua	hopua
kahakina	kahakina
kaihautu	kahautu
kaihoahoa	kahoahoa
kaitātaki	katataki
kaiwhakautu	kafakautu
kohua	kohua
konganuku	koNanuku
konohete	konohete
koti	koti
kuao	kua
kānapanapa	kanapanapa
maharatanga	maharataNa
mahau	mahau
maheni	maheni
manapori	manapori
marere	marere
marika	marika
marumaru	marumaru
mere	mere
māhita	mahita
māka	maka
mātāpuna	matapuna
ngēnei	Nenei
nohonoho	nohonoho
nou	nou
oati	oati
our	our
pahua	pahua
papā	papa
parae	para
parera	parera
pati	pati
piua	piua
poipoia	popoa
potaka	potaka
poutokomanawa	poutokomanawa
pukana	pukana
punahiko	punahiko
pūata	puata
pūrēhua	purehua
pūtoro	putoro
raiti	rati
raweketia	raweketia
rehita	rehita
retireti	retireti
takuta	takuta
taraipiunara	tarapiunara
taumau	taumau
taunaha	taunaha
taurea	taurea
tawai	tawa
tohutō	tohuto
tokowha	tokofa
tumanakohia	tumanakohia
tö	to
tāniko	taniko
tāruatanga	taruataNa
tīwhiri	tifiri
tōtā	tota
tūkinotia	tukinotia
tūtata	tutata
tūī	tui
uaratanga	uarataNa
urutā	uruta
weera	weera
wetekina	wetekina
whakahekenga	fakahekeNa
whakamaheretanga	fakamaheretaNa
whakamaramatia	fakamaramatia
whakamaroke	fakamaroke
whakamātao	fakamata
whakataungia	fakatauNia
whakatinanatia	fakatinanatia
whakatūtū	fakatutu
whakawera	fakawera
whakawāteatia	fakawateatia
wharepuni	farepuni
whitia	fitia
whārua	farua
whēnā	fena
wāpu	wapu
Āhuahanga	ahuahaNa
Ākona	akona
Ōpōtiki	opotiki
Aotaki	ataki
Hakawau	hakawau
Hapanihi	hapanihi
Hauiti	hauiti
Hineteiwaiwa	hineteiwawa
Hopa	hopa
Hurihia	hurihia
Hīroa	hiroa
It	it
Iāri	iari
KKM	kkm
Kaiwhakarite	kafakarite
Katerina	katerina
Kohitātea	kohitatea
Kōmiti	komiti
Maihi	mahi
Manawatu	manawatu
Maria	maria
Matahiko	matahiko
Matapihi	matapihi
Mōteatea	moteatea
Nene	nene
Ngārimu	Narimu
Nōku	noku
Perohuka	perohuka
Punarua	punarua
Putanga	putaNa
Pōtiki	potiki
Rangitihi	raNitihi
Rehunga	rehuNa
Rite	rite
Rokohanga	rokohaNa
Rongomaraeroa	roNomararoa
Roopū	roopu
Ruapehu	ruapehu
Rāhiri	rahiri
Rōpata	ropata
TEETH	teeth
TMoA	t mo a
TTT	ttt
Takirua	takirua
Taria	taria
Taumārere	taumarere
Tawhiti	tafiti
Team	team
Tetahi	tetahi
Tiro	tiro
Tuwhakararo	tufakararo
Tāmihana	tamihana
Tātaki	tataki
Tūmanako	tumanako
Tūrangawaewae	turaNawawa
Tūrongo	turoNo
Tūtarawānanga	tutarawanaNa
Uia	uia
Uniana	uniana
Ururoa	ururoa
Whakaora	fakara
Whakapakari	fakapakari
Whakatūria	fakaturia
Whakawhanake	fakafanake
Whiting	fitiN
aio	ao
araa	araa
areare	areare
aromatawaitia	aromatawatia
hauwai	hauwa
heeki	heeki
hikina	hikina
hoenga	hweNa
hohonutanga	hohonutaNa
houra	houra
huaketo	huaketo
hupa	hupa
hāngū	haNu
hōmai	homa
imu	imu
irāmutu	iramutu
ite	ite
kaitōrangapū	katoraNapu
kakari	kakari
karaitiana	karatiana
kikī	kiki
kitehia	kitehia
koira	kora
koiri	kori
kokoraho	kokoraho
kora	kora
koronga	koroNa
kororia	kororia
kuaha	kuaha
kāpō	kapo
kōtiti	kotiti
mahita	mahita
mangere	maNere
matara	matara
matarua	matarua
mauru	mauru
mene	mene
miti	miti
mōmona	momona
mōrahi	morahi
nehua	nehua
ngaiotanga	NaotaNa
ngarahu	Narahu
ngaronga	NaroNa
ngarongaro	NaroNaro
nunumi	nunumi
onepu	onepu
paetara	patara
pahore	pahore
paihana	pahana
paoa	paa
paparinga	papariNa
pm	pm
powhiri	pofiri
püoru	puoru
pākawa	pakawa
pākiki	pakiki
pāpaka	papaka
pāpaku	papaku
pāpono	papono
pātengi	pateNi
pātere	patere
pōwhiritia	pofiritia
pūhihi	puhihi
pūkaha	pukaha
pūmatua	pumatua
pūtahitanga	putahitaNa
raihi	rahi
rakuraku	rakuraku
rarahi	rarahi
raupo	raupo
rehe	rehe
rehu	rehu
t	t
tahitahi	tahitahi
takuhe	takuhe
taratahi	taratahi
tarau	tarau
tarea	tarea
tareka	tareka
tatanga	tataNa
temepara	temepara
tepe	tepe
tuaiwa	tuawa
tuatangata	tuataNata
tukitukia	tukitukia
tukurua	tukurua
tutua	tutua
tānekaha	tanekaha
tātea	tatea
tēneti	teneti
tūpuhi	tupuhi
tūtakitanga	tutakitaNa
tūātipu	tuatipu
unga	uNa
ura	ura
wairewa	warewa
wairuatanga	waruataNa
wewete	wewete
whaikorero	fakorero
whakaahuru	fakaahuru
whakaawhiwhia	fakaafifia
whakakite	fakakite
whakakorikori	fakakorikori
whakamoea	fakamwea
whakangungua	fakaNuNua
whakangā	fakaNa
whakapaingia	fakapaNia
whakapānga	fakapaNa
whakarauika	fakarauika
whakaruru	fakaruru
whakataua	fakataua
whakatauritea	fakatauritea
whakatikanga	fakatikaNa
whakatina	fakatina
whakau	fakau
whakaupoko	fakaupoko
whakawahia	fakawahia
whakawaho	fakawaho
whakawākanga	fakawakaNa
whanatu	fanatu
wiwi	wiwi
Āpiti	apiti
ēra	era
ōritenga	oriteNa
Arikinui	arikinui
Aupouri	aupouri
Erihana	erihana
Erueti	erueti
Hari	hari
Heikōkō	heikoko
Hinetūāhōanga	hinetuahoaNa
Hira	hira
Hunia	hunia
Hāre	hare
Hēni	heni
Hōhepa	hohepa
Ihoa	ihoa
Inaianei	inaanei
Kererū	kereru
Kirihi	kirihi
Kite	kite
Kohia	kohia
Korowai	korowa
Koutu	koutu
Kui	kui
Kō	ko
Mareikura	mareikura
Mauria	mauria
Mete	mete
Moerewa	mwerewa
Māhuri	mahuri
Māramatanga	maramataNa
Ngahiwi	Nahiwi
Ngohi	Nohi
Paetahi	patahi
Panui	panui
Papakura	papakura
Parker	parker
Patu	patu
Poroporoaki	poroporoaki
Power	power
Putea	putea
Pākeha	pakeha
Pātiti	patiti
Pīra	pira
Pōkai	poka
Pōkeka	pokeka
Rangitāke	raNitake
Rangiwewehi	raNiwewehi
Rikiriki	rikiriki
Rīpeka	ripeka
Tahupōtiki	tahupotiki
Takiwā	takiwa
Tawhiuau	tafiuau
Tikitiki	tikitiki
Topeora	topeora
Totara	totara
Tree	tree
Tuini	tuini
Tāwhaki	tafaki
Tūhourangi	tuhouraNi
Waihanga	wahaNa
Waihou	wahou
Whakarewarewa	fakarewarewa
Whanui	fanui
Whawhai	fafa
Whāiti	faiti
ahurewa	ahurewa
aia	aa
arongia	aroNia
arumoni	arumoni
atamai	atama
aukatia	aukatia
hapuu	hapuu
hikaka	hikaka
hikohiko	hikohiko
hirahira	hirahira
hiraka	hiraka
hoahoatia	hoahoatia
hope	hope
hukapapa	hukapapa
humarie	humarie
huripoki	huripoki
hāwhe	hafe
hēki	heki
hīanga	hiaNa
hōhā	hoha
hōtoke	hotoke
kaati	kaati
kahikatea	kahikatea
kaikanikani	kakanikani
kairūri	karuri
kaitakawaenga	katakawaNa
kaiārahitanga	kaarahitaNa
kaiāwhina	kaafina
kapiheihana	kapiheihana
kawakawa	kawakawa
kee	kee
koka	koka
kokowai	kokowa
konutai	konuta
kāreti	kareti
kōhari	kohari
kōhine	kohine
kōkiritia	kokiritia
kōkopu	kokopu
kōrerotanga	korerotaNa
maminga	mamiNa
matawhenua	matafenua
methamphetamine	methamphetamine
mira	mira
motukore	motukore
mōwhiti	mofiti
ngare	Nare
ngohengohe	NoheNohe
ngātahitia	Natahitia
nohopuku	nohopuku
nuitanga	nuitaNa
paihere	pahere
panonitanga	panonitaNa
papapaki	papapaki
pararopi	pararopi
pataka	pataka
pato	pato
pehi	pehi
porowini	porowini
puiaki	puiaki
putaputa	putaputa
pütaiao	putaa
pāhotia	pahotia
pēneitia	peneitia
pūataata	puataata
pūtahi	putahi
rakatira	rakatira
ramarama	ramarama
rangahautia	raNahautia
rapuhia	rapuhia
rauna	rauna
raupua	raupua
rerewē	rerewe
ripi	ripi
ruaki	ruaki
ruinga	ruiNa
rupeke	rupeke
rāpoi	rapo
taewa	tawa
tare	tare
tataunga	tatauNa
tatua	tatua
tauārai	tauara
teenaa	teenaa
teetehi	teetehi
tete	tete
tiakareti	tiakareti
tikiake	tikiake
tikitiki	tikitiki
tipi	tipi
tiwai	tiwa
tuatini	tuatini
tuituia	tuituia
turituri	turituri
tāhae	taha
tāporowhita	taporofita
tāraia	taraa
tāroa	taroa
tātā	tata
tūmatarau	tumatarau
tūruhi	turuhi
urutaunga	urutauNa
waaawa	waaawa
wahapu	wahapu
waihoe	wahwe
whakaahuatanga	fakaahuataNa
whakaihiihi	fakahiihi
whakakotahitia	fakakotahitia
whakakīia	fakakiia
whakanao	fakana
whakanohonoho	fakanohonoho
whakaotinga	fakatiNa
whakapakoko	fakapakoko
whakapaoho	fakapaho
whakatairangahia	fakataraNahia
whakatōngia	fakatoNia
whakawhanaketia	fakafanaketia
whanako	fanako
whatiwhati	fatifati
where	fere
whirinaki	firinaki
whēnei	fenei
wānangahia	wanaNahia
Āpitihanga	apitihaNa
āraia	araa
ūhia	uhia
Ahurea	ahurea
Emepaea	emepaa
Haramai	harama
Hare	hare
Haumiatiketike	haumiatiketike
Hauāuru	hauauru
Hikareia	hikareia
Hikitia	hikitia
Hiruharama	hiruharama
Huakina	huakina
Huka	huka
Hōnore	honore
Intent	intent
Kaati	kaati
Kainga	kaNa
Karen	karen
Karuwhā	karufa
Kate	kate
Kim	kim
Koina	kona
Koira	kora
Kuri	kuri
Kōhungahunga	kohuNahuNa
Matahi	matahi
Matangi	mataNi
Mataora	matara
Maungapohatu	mauNapohatu
Morehu	morehu
Muriwhenua	murifenua
Mātakitaki	matakitaki
Mātanga	mataNa
Mātāpono	matapono
Mōhiotanga	mohiotaNa
NEMP	nemp
Ngawai	Nawa
Ohu	ohu
Opening	openiN
Pa	pa
Paenga	paNa
Paepae	papa
Paki	paki
Pitiroi	pitiro
Poraka	poraka
Poutūterangi	poututeraNi
Pūmotu	pumotu
Rakera	rakera
Raraunga	rarauNa
Rawhiti	rafiti
Rewa	rewa
Riki	riki
Riri	riri
Rāngai	raNa
Rāpata	rapata
Tamure	tamure
Tapere	tapere
Tapuwae	tapuwa
Taute	taute
Tawhirimatea	tafirimatea
Tono	tono
Torere	torere
Tura	tura
Tānerore	tanerore
Tītokowaru	titokowaru
Uiui	uiui
Waimarie	wamarie
Whakaaturanga	fakaaturaNa
Whakahirahira	fakahirahira
Whakahētanga	fakahetaNa
Whakarawea	fakarawea
Whakarewa	fakarewa
Whanga	faNa
Wiwi	wiwi
Wātaka	wataka
Wātene	watene
anu	anu
arohaina	arohana
arotakehia	arotakehia
auē	aue
haea	haa
haeretanga	haretaNa
hanumi	hanumi
haurau	haurau
her	her
hiako	hiako
hianga	hiaNa
hikitia	hikitia
hokomaha	hokomaha
horekau	horekau
horomia	horomia
horonga	horoNa
hunaia	hunaa
huti	huti
hīkoitanga	hikotaNa
inanahi	inanahi
iriiri	iriiri
kaiaka	kaaka
kaiora	kaora
kaioraora	kaorara
kaiparau	kaparau
kaitaka	kataka
kaiwhakarongo	kafakaroNo
kaiwhakataetae	kafakatata
kakaho	kakaho
karangaranga	karaNaraNa
karawhiua	karafiua
kauneke	kauneke
kautia	kautia
kea	kea
kekeno	kekeno
kit	kit
kitakita	kitakita
kohukohu	kohukohu
kohurutia	kohurutia
koretake	koretake
koromatua	koromatua
kukune	kukune
kāuta	kauta
kōingo	koiNo
kōpura	kopura
kūpapa	kupapa
m	m
maatauranga	maatauraNa
maipi	mapi
man	man
maramatanga	maramataNa
matahuhua	matahuhua
matewai	matewa
miniti	miniti
mākutu	makutu
ne	ne
ngoikoretanga	NokoretaNa
nāu	nau
omanga	omaNa
paa	paa
paamu	paamu
papare	papare
papariki	papariki
papatono	papatono
perana	perana
pi	pi
pirinoa	pirinoa
pohutukawa	pohutukawa
porangi	poraNi
poutāpeta	poutapeta
puihi	puihi
pupuhihia	pupuhihia
pākehā	pakeha
pāpātanga	papataNa
pīrori	pirori
pūhui	puhui
raau	raau
rekareka	rekareka
rika	rika
rikarika	rikarika
rimurapa	rimurapa
ripo	ripo
roha	roha
rongonga	roNoNa
taane	taane
takitoru	takitoru
tamata	tamata
tangotango	taNotaNo
tapoko	tapoko
tapuae	tapua
tarāwaho	tarawaho
tauhohenga	tauhoheNa
tauihu	tauihu
tautohetia	tautohetia
tauwhāiti	taufaiti
tawa	tawa
tawhio	tafio
tepu	tepu
tipuranga	tipuraNa
tirotirohanga	tirotirohaNa
titaha	titaha
tokarewa	tokarewa
tokowaru	tokowaru
tupunga	tupuNa
two	two
tä	ta
tākihi	takihi
tāwara	tawara
tīhi	tihi
tīmatahia	timatahia
tīpune	tipune
tōia	toia
utauta	utauta
were	were
whakaatungia	fakaatuNia
whakae	faka
whakahouhia	fakahouhia
whakakitea	fakakitea
whakakīa	fakakia
whakakīkī	fakakiki
whakanekeneke	fakanekeneke
whakangau	fakaNau
whakaotia	fakatia
whakapuakihia	fakapuakihia
whakapākehātia	fakapakehatia
whakarerenga	fakarereNa
whakarārangitanga	fakararaNitaNa
whakatairangatia	fakataraNatia
whakatangihia	fakataNihia
whakatetonga	fakatetoNa
whakatikatikahia	fakatikatikahia
whakawhiwhinga	fakafifiNa
whakawhānuitia	fakafanuitia
whatinga	fatiNa
whia	fia
whāngaia	faNaa
whāngaihia	faNahia
whēkau	fekau
winika	winika
Āhea	ahea
Ākina	akina
Āwhinatia	afinatia
āpitihanga	apitihaNa
Apiata	apiata
Apopo	apopo
Arahura	arahura
Aro	aro
Erangi	eraNi
Himi	himi
Himiona	himiona
Hongongoi	hoNoNo
Huhuti	huhuti
Huringa	huriNa
Hāpai	hapa
Hēkeretari	hekeretari
Io	io
Itāriana	itariana
Iwikau	iwikau
Kaihoko	kahoko
Kaihokohoko	kahokohoko
Kairēhita	karehita
Kani	kani
Kararaina	kararana
Karipori	karipori
Kawa	kawa
Kawenga	kaweNa
Kiritaki	kiritaki
Komene	komene
Kānata	kanata
Kōhine	kohine
Kōkiritia	kokiritia
Kōpae	kopa
Mahue	mahue
Maia	maa
Maioha	maoha
MakaawhioTe	makaafio te
Maketū	maketu
Mango	maNo
Manukura	manukura
Maranga	maraNa
Meri	meri
Mihingare	mihiNare
Muaūpoko	muaupoko
Māehe	maehe
Mīharo	miharo
NIWA	niwa
Nepia	nepia
Ngahue	Nahue
Ngaro	Naro
Ngatiporou	Natiporou
Nōema	noema
Nōu	nou
Oro	oro
Pahiatua	pahiatua
Pehea	pehea
Penei	penei
Pine	pine
Poronīhia	poronihia
Porourangi	porouraNi
Prominent	prominent
Pukemiro	pukemiro
Punga	puNa
Puritia	puritia
Pāti	pati
Pēhia	pehia
Pēnei	penei
Pēnā	pena
Pūkeko	pukeko
Pūrehuroa	purehuroa
Raina	rana
Rangihoua	raNihoua
Rima	rima
Ringa	riNa
Ruahine	ruahine
Ruatoki	ruatoki
Rukupō	rukupo
Rātou	ratou
Rīpera	ripera
Taane	taane
Takuta	takuta
Tarahiti	tarahiti
Taraia	taraa
Tatū	tatu
Taupiri	taupiri
Tauwhao	taufa
Tiamani	tiamani
Timoti	timoti
Tomoana	tomoana
Tuhoro	tuhoro
Tupai	tupa
Tutekohi	tutekohi
Tāmanuhiri	tamanuhiri
Tūmatanui	tumatanui
Waitohi	watohi
Whakatika	fakatika
Whakawhitiwhitinga	fakafitifitiNa
Whangaparaoa	faNaparaa
Wharekahika	farekahika
Whero	fero
Whāingaroa	faiNaroa
Whārangi	faraNi
Women	women
anana	anana
angitūtanga	aNitutaNa
atarau	atarau
aunoa	aunoa
haereere	hareere
haha	haha
hakahaka	hakahaka
hapuku	hapuku
haukū	hauku
hoehoe	hwehwe
hoha	hoha
huatanga	huataNa
huru	huru
hāpiripiri	hapiripiri
hēhē	hehe
hīnau	hinau
inumia	inumia
iro	iro
kahupapa	kahupapa
kaiao	kaa
kaihāpai	kahapa
kaiurungi	kauruNi
kaiwhakauru	kafakauru
kapukapu	kapukapu
kapuni	kapuni
karengo	kareNo
kauhanga	kauhaNa
kauruku	kauruku
kauwae	kauwa
kurikuri	kurikuri
kë	ke
kēne	kene
kōmiti	komiti
maharahara	maharahara
maharatia	maharatia
maihi	mahi
maire	mare
makuku	makuku
mataitai	matata
matakuikui	matakuikui
matapōkere	matapokere
mauiui	mauiui
maungārongo	mauNaroNo
mawehe	mawehe
meremere	meremere
minenga	mineNa
mohoao	mohoa
mumura	mumura
murunga	muruNa
māhanga	mahaNa
mānukanuka	manukanuka
mārie	marie
mātinitini	matinitini
nahanaha	nahanaha
ngakia	Nakia
ngangahau	NaNahau
ngaunga	NauNa
noti	noti
nukua	nukua
nupepa	nupepa
other	other
pakapaka	pakapaka
panana	panana
papakāinga	papakaiNa
parapara	parapara
peeke	peeke
pihanga	pihaNa
pikopiko	pikopiko
poapoa	poapoa
pohatu	pohatu
poitarawhiti	potarafiti
pokanga	pokaNa
puha	puha
punarua	punarua
puoru	puoru
pä	pa
pāmahana	pamahana
pāti	pati
pīkau	pikau
pūmautanga	pumautaNa
rahaki	rahaki
raho	raho
rangitaki	raNitaki
rapea	rapea
raupapahia	raupapahia
raupō	raupo
rawekehia	rawekehia
rehurehu	rehurehu
riha	riha
rātonga	ratoNa
rēhitatanga	rehitataNa
taitapa	tatapa
takahitanga	takahitaNa
takakino	takakino
tanuku	tanuku
taramea	taramea
tautō	tauto
tieki	tieki
titikaha	titikaha
tohenga	toheNa
tohumate	tohumate
toke	toke
tuahu	tuahu
tukuruatia	tukuruatia
tukutahi	tukutahi
tumau	tumau
tuuturu	tuuturu
tāhuna	tahuna
tāpaetia	tapatia
tēneki	teneki
tīni	tini
tōmuatanga	tomuataNa
uriuri	uriuri
urungi	uruNi
wahangote	wahaNote
wahangū	wahaNu
waireka	wareka
wani	wani
wawahi	wawahi
weri	weri
weriweri	weriweri
whae	fa
whaiti	fati
whakaangi	fakaaNi
whakahihi	fakahihi
whakahuahua	fakahuahua
whakahuihui	fakahuihui
whakakapinga	fakakapiNa
whakakaupapa	fakakaupapa
whakakā	fakaka
whakamanawa	fakamanawa
whakamaru	fakamaru
whakamihia	fakamihia
whakangaromia	fakaNaromia
whakaparahako	fakaparahako
whakapokenga	fakapokeNa
whakaputahia	fakaputahia
whakarereketanga	fakarereketaNa
whakarihariha	fakarihariha
whakatautau	fakatautau
whakatematau	fakatematau
whakatikahia	fakatikahia
whakatoi	fakato
whakatokia	fakatokia
whakawaiwai	fakawawa
whakawhiu	fakafiu
whakawhānuihia	fakafanuihia
whiwhia	fifia
whänui	fanui
whāngote	faNote
wähanga	wahaNa
wāhitau	wahitau
āhuru	ahuru
ēhara	ehara
ētita	etita
Īhu	ihu
ōkiko	okiko
Ama	ama
Anaru	anaru
Arihia	arihia
Arowhenua	arofenua
Awatere	awatere
Ema	ema
Europe	europe
Hautanga	hautaNa
Hea	hea
Heeni	heeni
Hekenukumai	hekenukuma
Hemana	hemana
Hohepa	hohepa
Hokinga	hokiNa
Honoa	honoa
Horror	horror
Huarahi	huarahi
Huata	huata
Hērangi	heraNi
Hētana	hetana
Hōtaka	hotaka
Irihāpeti	irihapeti
Itāria	itaria
Kahawai	kahawa
Kaikoura	kakoura
Kano	kano
Kaporeihana	kaporeihana
Kapua	kapua
Kaumātua	kaumatua
Kerikeri	kerikeri
Kino	kino
Koata	koata
Koutou	koutou
Kāo	kao
Kēnana	kenana
Mahinga	mahiNa
Maiharanui	maharanui
Makere	makere
Mangu	maNu
Maraea	maraa
Marangai	maraNa
Maritime	maritime
Matuku	matuku
Meinga	meiNa
Mokena	mokena
Motueka	motueka
Mt	mt
Mōmona	momona
NIR	nir
Nainoa	nanoa
Ngahere	Nahere
Ngaiterangi	NateraNi
Niho	niho
Nina	nina
Nukutaurua	nukutaurua
Nāhinara	nahinara
Pangarau	paNarau
Patua	patua
Peihopa	peihopa
Pem	pem
Poroumata	poroumata
Porowini	porowini
Poutāpeta	poutapeta
Puka	puka
Pāpori	papori
Rapanga	rapaNa
Rongomaurikura	roNomaurikura
Roroa	roroa
Ruataupare	ruataupare
Taika	taka
Takiura	takiura
Tamarau	tamarau
Tarakawa	tarakawa
Taumarere	taumarere
Tautohua	tautohua
Teko	teko
Tikipunga	tikipuNa
Tona	tona
Two	two
Tāhū	tahu
Tūranganui	turaNanui
Uawa	uawa
Uhia	uhia
Wahawaha	wahawaha
Waihau	wahau
Waiomatatini	waomatatini
We	we
Weka	weka
Whaanga	faaNa
Whaia	faa
Whaitua	fatua
Whakahau	fakahau
Whakapiki	fakapiki
Whakarapa	fakarapa
Whakaruruhau	fakaruruhau
Whakarōpūhia	fakaropuhia
Whakarōpūngia	fakaropuNia
Whakatairitea	fakataritea
Whakataki	fakataki
Whakatō	fakato
Whakawhitinga	fakafitiNa
Whangamata	faNamata
Wharepukapuka	farepukapuka
Whatahoro	fatahoro
akina	akina
am	am
aromatawaia	aromatawaa
arorangi	aroraNi
arowhai	arofa
auare	auare
awhikiri	afikiri
awhinatia	afinatia
ekea	ekea
h	h
haeata	haata
hahae	haha
haratau	haratau
haua	haua
haumano	haumano
hauwarea	hauwarea
hekaheka	hekaheka
hiwa	hiwa
hoake	hoake
hoi	ho
hoka	hoka
hongere	hoNere
huanui	huanui
hukea	hukea
hungawai	huNawa
hīmene	himene
hōanga	hoaNa
ihumanea	ihumanea
inaki	inaki
inati	inati
inihua	inihua
into	into
kaikauwhau	kakaufau
kaikerēme	kakereme
kaimātakitaki	kamatakitaki
kaiuru	kauru
kaiwhakaputa	kafakaputa
kakenga	kakeNa
kamera	kamera
karaipiture	karapiture
karakiatia	karakiatia
kaurori	kaurori
ketia	ketia
kiki	kiki
kirikā	kirika
kirīmi	kirimi
kohuke	kohuke
koke	koke
koranehe	koranehe
koroke	koroke
koroputa	koroputa
korou	korou
kuhua	kuhua
kukupa	kukupa
kukuti	kukuti
kuwaha	kuwaha
kāika	kaika
kārangaranga	karaNaraNa
kōhi	kohi
kōhuru	kohuru
kōpu	kopu
kūare	kuare
kūhuka	kuhuka
maaka	maaka
maara	maara
mahora	mahora
maikuku	makuku
maina	mana
matemateaone	matemateane
matewhawhati	matefafati
meake	meake
mekemeke	mekemeke
mete	mete
moemoehia	mwemwehia
moohiotia	moohiotia
mounu	mounu
māhorahora	mahorahora
māwhaiwhai	mafafa
nawai	nawa
ngaherehere	Naherehere
ngakinga	NakiNa
ngawha	Nafa
ngawhere	Nafere
ngāherehere	Naherehere
ngāngara	NaNara
niu	niu
notemea	notemea
nōku	noku
nōu	nou
ohinga	ohiNa
okiokinga	okiokiNa
onge	oNe
orokati	orokati
orooro	orooro
pakaruhia	pakaruhia
pangarau	paNarau
paopao	papa
papaneke	papaneke
paraharaha	paraharaha
parau	parau
parehe	parehe
parekareka	parekareka
pikau	pikau
piripiri	piripiri
pitomata	pitomata
poriro	poriro
poutiriao	poutiria
pākia	pakia
pāorooro	paorooro
pātū	patu
pūare	puare
pūeru	pueru
pūhou	puhou
rangatū	raNatu
rarua	rarua
rauawa	rauawa
rimurimu	rimurimu
roko	roko
rāpihi	rapihi
rārangitia	raraNitia
rīriri	ririri
taana	taana
tahia	tahia
tahora	tahora
takaroa	takaroa
tamarikitanga	tamarikitaNa
tapatapahi	tapatapahi
tapawha	tapafa
taraute	taraute
tauaki	tauaki
taupua	taupua
taupū	taupu
tautiaki	tautiaki
tauwehe	tauwehe
tene	tene
three	three
tiakarete	tiakarete
tiima	tiima
titia	titia
tohutao	tohuta
tohutoa	tohutoa
topuni	topuni
tuakiritanga	tuakiritaNa
tuawha	tuafa
tunutunu	tunutunu
turia	turia
tāea	taea
tāiri	tairi
tākai	taka
tākoha	takoha
tāruaruatia	taruaruatia
tātua	tatua
tāwharau	tafarau
tēnehi	tenehi
tūmanakohia	tumanakohia
tūtohutanga	tutohutaNa
tūwatawata	tuwatawata
waehere	wahere
waharoa	waharoa
waimeha	wameha
waitohua	watohua
werowero	werowero
whakaatangia	fakaataNia
whakahawea	fakahawea
whakahihiri	fakahihiri
whakairotia	fakarotia
whakakeke	fakakeke
whakakorenga	fakakoreNa
whakamanamana	fakamanamana
whakamaramatanga	fakamaramataNa
whakamatauria	fakamatauria
whakamohiotia	fakamohiotia
whakapaea	fakapaa
whakapeto	fakapeto
whakarangatira	fakaraNatira
whakarata	fakarata
whakaraupapahia	fakaraupapahia
whakareka	fakareka
whakarua	fakarua
whakatūwhera	fakatufera
wikitōria	wikitoria
Āhitana	ahitana
āniwaniwa	aniwaniwa
ātanga	ataNa
āteha	ateha
ātārangi	ataraNi
āwhio	afio
Ahau	ahau
Ahia	ahia
Ahumahi	ahumahi
Akona	akona
ApiTrak	api trak
Haimona	hamona
Hapani	hapani
Haumia	haumia
Haunga	hauNa
Herangi	heraNi
Heteroptera	heteroptera
Hineahuone	hineahuone
Hinerangi	hineraNi
Hinewai	hinewa
Hoahoa	hoahoa
Hopukina	hopukina
Hurihuri	hurihuri
K	k
KO	ko
Kahui	kahui
Kaimai	kama
Kaitātaki	katataki
Kanikani	kanikani
Kapu	kapu
Kaumatua	kaumatua
Kea	kea
Keri	keri
Kerēme	kereme
Kiki	kiki
Korokī	koroki
Koura	koura
Kuaha	kuaha
Kumara	kumara
Kunenga	kuneNa
Kāpehu	kapehu
Kōrerotia	korerotia
MMP	mmp
Maimoatanga	mamoataNa
Manakotanga	manakotaNa
Mangakāhia	maNakahia
Mangere	maNere
Maramataka	maramataka
Matthew	matthew
Mina	mina
Momo	momo
Moteatea	moteatea
Māmoe	mamwe
Mātāmua	matamua
NA	na
Nathan	nathan
Ngahuru	Nahuru
Ngaitai	Nata
Ngāmotu	Namotu
Nihoniho	nihoniho
Niwa	niwa
Norman	norman
Ohia	ohia
Opera	opera
Oreore	oreore
Paeko	pako
Panuku	panuku
Paraparaumu	paraparaumu
Part	part
Pehi	pehi
Pena	pena
Pene	pene
Pipitea	pipitea
Poihana	pohana
Puia	puia
Pāwhiri	pafiri
Pēke	peke
Rakaumangamanga	rakaumaNamaNa
Ratapu	ratapu
Reri	reri
Ripoata	ripoata
Rona	rona
Rongomai	roNoma
Rongomātāne	roNomatane
Ruka	ruka
Rāapa	raapa
Rākaipaaka	rakapaaka
Taiaroa	taaroa
Tangihōro	taNihoro
Tangotango	taNotaNo
Tararua	tararua
Tarata	tarata
Tatou	tatou
Taurahere	taurahere
Tautoru	tautoru
Tawhito	tafito
Teira	teira
Tiakina	tiakina
Tihei	tihei
Tira	tira
Tireiniamu	tireiniamu
Toia	toa
Tokaanu	tokaanu
Tokorima	tokorima
Tokowhitu	tokofitu
Tonu	tonu
Tuahiwi	tuahiwi
Tumatauenga	tumataueNa
Tāwhai	tafa
Tēna	tena
UN	un
Uara	uara
Uira	uira
Wa	wa
Waimakariri	wamakariri
Waitematā	watemata
Wanaka	wanaka
Whakanoho	fakanoho
Whakarae	fakara
Whakawhetai	fakafeta
Whena	fena
Whiria	firia
Whiu	fiu
Work	work
aana	aana
ahopae	ahopa
ahotakakame	ahotakakame
angiangi	aNiaNi
arapū	arapu
aromatawaihia	aromatawahia
hahau	hahau
haoa	haa
harakore	harakore
hoari	hoari
hopua	hopua
horu	horu
hotu	hotu
huraina	hurana
hurumanu	hurumanu
hängai	haNa
hāpara	hapara
hēkona	hekona
hōngere	hoNere
hōtera	hotera
ihupuku	ihupuku
ita	ita
kahanga	kahaNa
kaiarataki	kaarataki
kaiuiui	kauiui
kaiwawao	kawawa
kaiwhaiwāhi	kafawahi
kaiwhakatakoto	kafakatakoto
kakahi	kakahi
kakapa	kakapa
kakati	kakati
kaokao	kaka
kapakapa	kapakapa
kapene	kapene
kaporeihana	kaporeihana
karakara	karakara
kauanga	kauaNa
kawai	kawa
kaweake	kaweake
kina	kina
kinotia	kinotia
koanga	koaNa
koeko	kweko
koikoi	koko
konumohe	konumohe
kotikoti	kotikoti
koukou	koukou
kunenga	kuneNa
kāpā	kapa
kōwhatu	kofatu
mahea	mahea
mahuetanga	mahuetaNa
mahuta	mahuta
maiangi	maaNi
makatea	makatea
manatū	manatu
manukanuka	manukanuka
mapu	mapu
marohi	marohi
matamata	matamata
matawā	matawa
mauherea	mauherea
maurea	maurea
mimi	mimi
motuhenga	motuheNa
māhaki	mahaki
māraurau	maraurau
māro	maro
ngao	Na
ngārahu	Narahu
niao	nia
oanahi	oanahi
oioi	oo
ori	ori
oropuare	oropuare
paari	paari
pahūtanga	pahutaNa
paitia	patia
paitini	patini
pakia	pakia
panuitia	panuitia
paparahi	paparahi
papānga	papaNa
paramanawa	paramanawa
piritahi	piritahi
poitūkohu	potukohu
poutama	poutama
pukai	puka
puranga	puraNa
purere	purere
puri	puri
pāhi	pahi
pāuna	pauna
pēhitanga	pehitaNa
pīpīwai	pipiwa
pōnānā	ponana
pōuritanga	pouritaNa
pūhuruhurutanga	puhuruhurutaNa
pūtoi	puto
raparapa	raparapa
ratarata	ratarata
raupatunga	raupatuNa
remu	remu
rerekore	rerekore
rewena	rewena
ronaki	ronaki
ruirui	ruirui
rukuruku	rukuruku
taaea	taaa
tahuritanga	tahuritaNa
tainga	taNa
takatāpui	takatapui
takinga	takiNa
takune	takune
taote	tate
tapae	tapa
tapoi	tapo
taupā	taupa
tautika	tautika
tauāki	tauaki
tawatawa	tawatawa
tawhiri	tafiri
teneti	teneti
tineia	tineia
tioro	tioro
tiria	tiria
tiu	tiu
tokohia	tokohia
tongi	toNi
tonohia	tonohia
torea	torea
torokaha	torokaha
totohe	totohe
tuarangi	tuaraNi
tuhipoka	tuhipoka
tukupū	tukupu
tutukitanga	tutukitaNa
tërä	tera
tāmia	tamia
tāmure	tamure
tātarihia	tatarihia
tāwhai	tafa
tōpūtanga	toputaNa
tūemi	tuemi
tūhāhā	tuhaha
tūmāia	tumaia
tūrama	turama
tūtae	tuta
waikura	wakura
warowaihā	warowaha
wawetia	wawetia
whaanau	faanau
whaanui	faanui
whaikiko	fakiko
whakaahuahanga	fakaahuahaNa
whakaakongia	fakaakoNia
whakahihiko	fakahihiko
whakahoa	fakahoa
whakahuatanga	fakahuataNa
whakahēngia	fakaheNia
whakairohia	fakarohia
whakangao	fakaNa
whakanoa	fakanoa
whakanōhia	fakanohia
whakapiripiri	fakapiripiri
whakapotonga	fakapotoNa
whakapāho	fakapaho
whakapākehā	fakapakeha
whakarōpūtia	fakaroputia
whakatara	fakatara
whakatatū	fakatatu
whakatenatenahia	fakatenatenahia
whakateraki	fakateraki
whakatupatohia	fakatupatohia
whakatuu	fakatuu
whakawhenumi	fakafenumi
whawha	fafa
whawhaitanga	fafataNa
whākōkī	fakoki
witi	witi
¾	
ïnanga	inaNa
āwhinatanga	afinataNa
ē	e
īpae	ipa
ōritetanga	oritetaNa
Akaroa	akaroa
Akau	akau
Akomanga	akomaNa
Amohau	amohau
Anahera	anahera
Anne	anne
Aoniwaho	aniwaho
Ararau	ararau
Arataki	arataki
Arthur	arthur
Awanui	awanui
Awanuiārangi	awanuiaraNi
Awhina	afina
Haami	haami
Harata	harata
Hekeretari	hekeretari
Hema	hema
Hore	hore
Horoi	horo
Hāpara	hapara
Hāpuku	hapuku
Hāriata	hariata
Hēoi	heo
IT	it
Iron	iron
Karu	karu
Katia	katia
Kereama	kereama
Kereone	kereone
Kohimarama	kohimarama
Konohi	konohi
Koohi	koohi
Koroki	koroki
Kuhuna	kuhuna
Kākāriki	kakariki
Kōwae	kowa
Mahaki	mahaki
Manaakitanga	manaakitaNa
Manawanui	manawanui
Mangōroa	maNoroa
Mapi	mapi
Marangaranga	maraNaraNa
Marine	marine
Matatika	matatika
Maungatautari	mauNatautari
Mereana	mereana
Miramar	miramar
Mita	mita
Moko	moko
Moore	moore
Murirangawhenua	muriraNafenua
Māia	maia
Ngaa	Naa
Ngarimu	Narimu
Ngaruawahia	Naruawahia
Ngātoroirangi	NatororaNi
Ngāwai	Nawa
Niue	niue
Nohinohi	nohinohi
Nākahi	nakahi
Orion	orion
Paerau	parau
Panoni	panoni
Panuitia	panuitia
Para	para
Patea	patea
Pirīmia	pirimia
Poto	poto
Pouherenga	pouhereNa
Pourangahua	pouraNahua
Pumi	pumi
Pārongo	paroNo
Pōwhiri	pofiri
Rahoroi	rahoro
Rangihīroa	raNihiroa
Rangimarie	raNimarie
Rangitukia	raNitukia
Rangitīkei	raNitikei
Rangiuru	raNiuru
Rapa	rapa
Raukōkore	raukokore
Ripeka	ripeka
Riu	riu
Ruapekapeka	ruapekapeka
Ruatāhuna	ruatahuna
Rukuhia	rukuhia
Runga	ruNa
TP	tp
Taiohi	taohi
Taipa	tapa
Tamehana	tamehana
Tangihanga	taNihaNa
Tatari	tatari
Tekapo	tekapo
Temara	temara
Temi	temi
Tinana	tinana
Tipa	tipa
Tipu	tipu
Tirotiro	tirotiro
Tohaina	tohana
Tohutoro	tohutoro
Toihau	tohau
Tokowaru	tokowaru
Tomokanga	tomokaNa
Turanganui	turaNanui
Turangawaewae	turaNawawa
Tāia	taia
Tōia	toia
UK	uk
Waahi	waahi
Waikare	wakare
Waimamaku	wamamaku
Waiorua	waorua
Whaiaro	faaro
Whakaingoatia	fakaNoatia
Whakairia	fakaria
Whakatauiratia	fakatauiratia
Whakatauritea	fakatauritea
Whakatu	fakatu
Whakaurua	fakaurua
Wheke	feke
Whenuanui	fenuanui
Whitireia	fitireia
Whitu	fitu
Whāngārei	faNarei
Whāngārā	faNara
Winiata	winiata
akitu	akitu
aromatawaitanga	aromatawataNa
ati	ati
awenga	aweNa
awhitia	afitia
ei	ei
hainahia	hanahia
haumako	haumako
haurongo	hauroNo
hauropi	hauropi
hekeretari	hekeretari
hoahoatanga	hoahoataNa
hohoko	hohoko
huakore	huakore
hunuku	hunuku
hēneti	heneti
hūmarie	humarie
hūware	huware
iana	iana
iranga	iraNa
iringa	iriNa
iroiro	iroro
ito	ito
kaikiri	kakiri
kaingia	kaNia
kaipāho	kapaho
kaitango	kataNo
kaitaunaki	kataunaki
kaituhituhi	katuhituhi
kaitukumahi	katukumahi
kani	kani
kapia	kapia
kapiti	kapiti
kapoa	kapoa
kaponga	kapoNa
kareti	kareti
karia	karia
katipoo	katipoo
kauaka	kauaka
kauta	kauta
kirirarau	kirirarau
koeke	kweke
kongakonga	koNakoNa
kono	kono
koropuku	koropuku
koropupu	koropupu
koru	koru
ku	ku
kōhure	kohure
kōkiritanga	kokiritaNa
kōkōwai	kokowa
kōnui	konui
kōtahi	kotahi
maamaa	maamaa
mahimahi	mahimahi
mahingia	mahiNia
maihea	mahea
manaia	manaa
manomanotia	manomanotia
marathon	marathon
mariko	mariko
matapakia	matapakia
matapakihia	matapakihia
mataurangamaori	matauraNamari
maumaharatanga	maumaharataNa
miere	miere
mitia	mitia
mohe	mohe
mokowhiti	mokofiti
märama	marama
māhana	mahana
ngangahu	NaNahu
ngangare	NaNare
ngangau	NaNau
ngaringari	NariNari
ngeetehi	Neetehi
ngote	Note
ngoto	Noto
ngāhau	Nahau
ngō	No
noo	noo
oha	oha
paiheneti	paheneti
paina	pana
pakitau	pakitau
pakoko	pakoko
papaka	papaka
papaku	papaku
papatau	papatau
parakatihi	parakatihi
pehia	pehia
pekepeke	pekepeke
penihana	penihana
piana	piana
pine	pine
pokapu	pokapu
pokepoke	pokepoke
poroa	poroa
porohe	porohe
porotaka	porotaka
pukohu	pukohu
pukuhohe	pukuhohe
pumanawa	pumanawa
punanga	punaNa
pungapunga	puNapuNa
pura	pura
purenga	pureNa
purotu	purotu
purutia	purutia
pütea	putea
pāka	paka
pātahi	patahi
pērātia	peratia
pīataata	piataata
pōraruraru	poraruraru
pūmahara	pumahara
rangapū	raNapu
raumata	raumata
raurau	raurau
raurēkau	raurekau
rautō	rauto
reia	reia
rengarenga	reNareNa
rongona	roNona
rore	rore
rīpeka	ripeka
rōpere	ropere
taera	tara
tahanga	tahaNa
tahere	tahere
tahuti	tahuti
taitai	tata
taituarā	tatuara
takakau	takakau
takatakahi	takatakahi
takupu	takupu
taotu	tatu
tapiritia	tapiritia
tapā	tapa
tarewa	tarewa
taumanu	taumanu
taumarumaru	taumarumaru
tauraro	tauraro
tautitotito	tautitotito
tauwhitiwhitinga	taufitifitiNa
tewhatewha	tefatefa
tiimata	tiimata
tiko	tiko
toheroa	toheroa
topa	topa
tukupara	tukupara
tumeke	tumeke
tupuranga	tupuraNa
tāpiripiri	tapiripiri
tētē	tete
tūhonoa	tuhonoa
tūtei	tutei
tūtuki	tutuki
tūturutanga	tuturutaNa
ukauka	ukauka
waahana	waahana
waerehe	warehe
waihonga	wahoNa
wairākau	warakau
wanawana	wanawana
wawatatia	wawatatia
we	we
weroa	weroa
wetereo	wetereo
whaihanga	fahaNa
whaiāipo	faaipo
whakahautia	fakahautia
whakahere	fakahere
whakahiki	fakahiki
whakairinga	fakariNa
whakamaoritanga	fakamaritaNa
whakamauru	fakamauru
whakamātūtū	fakamatutu
whakamōmona	fakamomona
whakapakaritia	fakapakaritia
whakapoke	fakapoke
whakapumau	fakapumau
whakapāha	fakapaha
whakapūmautanga	fakapumautaNa
whakarerekēngia	fakarerekeNia
whakarākai	fakaraka
whakatapu	fakatapu
whakatapua	fakatapua
whakatenetene	fakatenetene
whakatepe	fakatepe
whakaterea	fakaterea
whakatewhatewha	fakatefatefa
whakatūpatotanga	fakatupatotaNa
whakatūranga	fakaturaNa
whakawaia	fakawaa
whakawehenga	fakaweheNa
whakawhāitihia	fakafaitihia
whakawākia	fakawakia
whakawāngia	fakawaNia
whanautanga	fanautaNa
wharepukapuka	farepukapuka
whika	fika
wiriwiri	wiriwiri
wākena	wakena
wānangatia	wanaNatia
Ānō	ano
āhuarangi	ahuaraNi
ākene	akene
āmati	amati
āraitia	aratia
īmera	imera
Ōhinemutu	ohinemutu
