di	di
e	e
cu	ku
ta	ta
a	a
pa	pa
y	igrEk
un	uN
na	na
den	deN
nan	naN
tin	tiN
no	no
Aruba	aruba
por	por
lo	lo
aki	aki
nos	nos
E	e
riba	riba
su	su
mas	mas
tabata	tabata
tur	tur
mester	mester
bay	bay
wordo	wordo
tambe	tambe
haci	hasi
esaki	esaki
haya	haya
hopi	hopi
pero	pero
otro	otro
keda	keda
hende	hende
bo	bo
of	of
asina	asina
a単a	a5a
persona	persona
mes	mes
duna	duna
si	si
tuma	tuma
sigui	sigy
como	komo
bisa	bisa
ora	ora
pasa	pasa
Minister	minister
bin	biN
for	for
ORANJESTAD	oranyestad
AAN	aN
dia	dya
nobo	nobo
Na	na
yega	yega
caso	kaso
manera	manera
Hulanda	hulanda
kier	kyer
Gobierno	gobyerno
prome	prome
loke	loke
unda	unda
cas	kas
el	el
Pa	pa
pais	pas
grandi	grandi
situacion	sitwasyoN
drenta	drenta
caminda	kaminda
momento	momento
Esaki	esaki
Den	deN
bon	boN
cual	kwal
forma	forma
traha	traha
bira	bira
te	te
parti	parti
Ta	ta
gobierno	gobyerno
dos	dos
mira	mira
Nos	nos
Un	uN
durante	durante
despues	despwes
pone	pone
con	koN
diferente	diferente
pasobra	pasobra
siman	simaN
pueblo	pweblo
sin	siN
caba	kaba
entre	entre
polis	polis
awor	awor
anochi	anoCi
yuda	yuda
biaha	byaha
cuminsa	kuminsa
sa	sa
importante	importante
Polis	polis
tempo	tempo
El	el
informacion	informasyoN
trata	trata
presenta	presenta
habri	habri
Parlamento	parlamento
mundo	mundo
comunidad	komunidad
auto	auto
sitio	sityo
pidi	pidi
luna	luna
esnan	esnan
algun	alguN
placa	plaka
segun	seguN
ainda	anda
esey	esey
mustra	mustra
dilanti	dilanti
mi	mi
problema	problema
ricibi	risibi
tene	tene
crisis	krisis
Croes	krus
DIARIO	dyaryo
splica	splika
paga	paga
A	a
indica	indika
ya	ya
Pero	pero
logra	logra
mainta	manta
hunto	hunto
mucha	muCa
door	dor
sali	sali
kico	kiko
ley	ley
atende	atende
contra	kontra
trece	trese
total	total
papia	papya
cada	kada
Prome	prome
ultimo	ultimo
lugar	lugar
cantidad	kantidad
motibo	motibo
Si	si
mesora	mesora
financiero	finansyero
yama	yama
grupo	grupo
informa	informa
conoce	konose
ningun	ninguN
ey	ey
entrega	entrega
banda	banda
publico	publiko
algo	algo
patruya	patruya
bek	bek
sigur	sigur
famia	famya
para	para
homber	homber
scol	skol
laga	laga
awe	awe
casonan	kasonan
varios	varyos
dirigi	dirixi
trabao	trabao
via	vya
trabou	trabow
busca	buska
tanto	tanto
cumpli	kumpli
solamente	solamente
test	test
personanan	personanan
de	de
cuenta	kwenta
economia	ekonomya
cera	sera
Nan	naN
baha	baha
cos	kos
Segun	seguN
Departamento	departamento
base	base
Tambe	tambe
compania	kompanya
virus	virus
muchanan	muCanan
dicidi	disidi
No	no
ser	ser
informe	informe
bida	bida
positivo	positivo
Tur	tur
wak	wak
man	maN
Hues	hwes
entrada	entrada
miyon	miyoN
social	sosyal
Ministro	ministro
nota	nota
Hulandes	hulandes
posibel	posibel
manda	manda
salud	salud
Tin	tiN
proyecto	proyekto
Maduro	maduro
hasta	hasta
maneho	maneho
menos	menos
ni	ni
Merca	merka
necesario	nesesaryo
cuido	kuydo
mesun	mesuN
en	eN
Reino	reno
acuerdo	akwerdo
bishita	biSita
crea	krea
servicio	servisyo
personal	personal
dje	je
prensa	prensa
conoci	konosi
mantene	mantene
reunion	rewnyoN
minister	minister
Y	igrEk
futuro	futuro
menciona	mensyona
local	lokal
luga	luga
rond	rond
basta	basta
Mike	mike
AZV	azv
proceso	proseso
hendenan	hendenan
Cu	ku
caya	kaya
registra	rexistra
evita	evita
spera	spera
coronavirus	koronavirus
cay	kay
bou	bow
accidente	aksidente
Evelyn	eveliN
economico	ekonomiko
florin	floriN
dal	dal
mandatario	mandataryo
yegada	yegada
isla	isla
debi	debi
henter	henter
cambia	kambya
prepara	prepara
medidanan	medidanan
nada	nada
AVP	avp
Durante	durante
investigacion	investigasyoN
pandemia	pandemya
medico	mediko
semper	semper
tabatin	tabatiN
Despues	despwes
politico	politiko
chauffeur	Cauffewr
uza	uza
Oduber	oduber
dificil	difisil
sistema	sistema
cuminza	kuminza
Diabierna	dyabyerna
cla	kla
brinda	brinda
subi	subi
tereno	tereno
Nicolas	nikolas
poco	poko
mientras	myentras
tres	tres
Pues	pwes
compronde	kompronde
halto	halto
awa	awa
Dialuna	dyaluna
conta	konta
cambio	kambyo
cerca	serka
causa	kausa
Publico	publiko
fin	fiN
dama	dama
hospital	hospital
locual	lokwal
contacto	kontakto
sector	sektor
uno	uno
Esey	esey
Ora	ora
decision	desisyoN
biba	biba
atardi	atardi
Por	por
turismo	turismo
perde	perde
relaciona	relasyona
herida	herida
core	kore
expresa	ekspresa
negoshi	negoSi
warda	warda
Hospital	hospital
Parlamentario	parlamentaryo
control	kontrol
medio	medyo
Di	di
detene	detene
Eman	emaN
topa	topa
area	area
Fiscal	fiskal
anuncia	anunsya
resultado	resultado
saca	saka
afecta	afekta
mundial	mundyal
San	saN
candela	kandela
percura	perkura
desaroyo	desaroyo
Venezuela	venezwela
hiba	hiba
serio	seryo
sosten	sosteN
ehempel	ehempel
ayudo	ayudo
DVG	devege
cliente	klyente
Diahuebs	dyahwebs
paisnan	pasnan
exigi	eksixi
momentonan	momentonan
edad	edad
pregunta	pregunta
final	final
peticion	petisyoN
van	vaN
Diasabra	dyasabra
sosode	sosode
nifica	nifika
reglanan	reglanan
pago	pago
atencion	atensyoN
actual	aktwal
ariba	ariba
partido	partido
Mi	mi
bini	bini
chikito	Cikito
internacional	internasyonal
desde	desde
oportunidad	oportunidad
pues	pwes
conferencia	konferensya
punto	punto
bolbe	bolbe
introduci	introdusi
bao	bao
plan	plaN
permiti	permiti
aworaki	aworaki
esta	esta
remarca	remarka
cierto	syerto
programa	programa
controla	kontrola
Awe	awe
Ministerio	ministeryo
purba	purba
pashent	paSent
salario	salaryo
fuerte	fwerte
meta	meta
sumamente	sumamente
berdad	berdad
kende	kende
medida	medida
Diamars	dyamars
companianan	kompanyanan
nomber	nomber
gastonan	gastonan
dianan	dyanan
Coronavirus	koronavirus
so	so
trahando	trahando
cune	kune
pensa	pensa
Presidente	presidente
hecho	heCo
hoben	hobeN
Riba	riba
Diadomingo	dyadomingo
Salud	salud
firma	firma
sinti	sinti
nunca	nunka
turista	turista
nivel	nivel
cualkier	kwalkyer
sr	EsEr
number	number
tocante	tokante
Awor	awor
yiu	yyu
Caribe	karibe
esun	esuN
periodo	peryodo
kere	kere
sinta	sinta
miembronan	myembronan
tipo	tipo
atrobe	atrobe
realidad	realidad
resulta	resulta
cumpra	kumpra
prueba	prweba
general	xeneral
activo	aktivo
cuminda	kuminda
interes	interes
mirando	mirando
Manera	manera
departamento	departamento
temporada	temporada
Citgo	sitgo
impacto	impakto
tawata	tawata
team	team
ofrece	ofrese
participa	partisipa
regla	regla
Asina	asina
largo	largo
porta	porta
kibra	kibra
pasando	pasando
palabra	palabra
duro	duro
presente	presente
Mester	mester
yena	yena
desea	desea
Pesey	pesey
tras	tras
contesta	kontesta
bienestar	byenestar
propio	propyo
malesa	malesa
miembro	myembro
carta	karta
online	online
Florin	floriN
ciudadano	syudadano
gradici	gradisi
guia	gya
hobennan	hobennan
victima	viktima
asistencia	asistensya
special	spesyal
siguiente	sigyente
clientenan	klyentenan
mihor	mihor
derecho	dereCo
suma	suma
ku	ku
malo	malo
worde	worde
cana	kana
Bo	bo
arma	arma
boto	boto
Fundacion	fundasyoN
lama	lama
necesidad	nesesidad
kita	kita
gobernacion	gobernasyoN
usa	usa
bista	bista
eleccion	eleksyoN
Dia	dya
falta	falta
anterior	anteryor
recupera	rekupera
Cuerpo	kwerpo
trafico	trafiko
uzo	uzo
atras	atras
proyectonan	proyektonan
puntra	puntra
lanta	lanta
mucho	muCo
mayoria	mayorya
normal	normal
a単anan	a5anan
miho	miho
frontera	frontera
oficial	ofisyal
contento	kontento
tampoco	tampoko
debe	debe
Pais	pas
lista	lista
pronto	pronto
sostene	sostene
compara	kompara
demostra	demostra
esakinan	esakinan
vacuna	vakuna
Toque	tokwe
rapport	rapport
Aki	aki
dialuna	dyaluna
cubri	kubri
mil	mil
droga	droga
pashentnan	paSentnan
seguridad	seguridad
agrega	agrega
condicionnan	kondisyonnan
Betico	betiko
Como	komo
mescos	meskos
tema	tema
abuso	abuso
For	for
morto	morto
awo	awo
hasi	hasi
trahadornan	trahadornan
cuadro	kwadro
scolnan	skolnan
problemanan	problemanan
solucion	solusyoN
declara	deklara
Marisol	marisol
opinion	opinyoN
vehiculo	vehikulo
lucha	luCa
proximo	proksimo
cifranan	sifranan
distancia	distansya
Sinembargo	sinembargo
bunita	bunita
ki	ki
Ademas	ademas
eynan	eynan
Policial	polisyal
actua	aktwa
masha	maSa
maximo	maksimo
acepta	asepta
mayornan	mayornan
aden	adeN
gana	gana
basa	basa
fecha	feCa
Diaranson	dyaransoN
Corte	korte
responsabilidad	responsabilidad
riesgo	ryesgo
stop	stop
gran	graN
oficina	ofisina
Arubiano	arubyano
unico	uniko
cuarentena	kwarentena
merdia	merdya
casi	kasi
completo	kompleto
facil	fasil
poni	poni
Kico	kiko
aplica	aplika
peliger	pelixer
Arubano	arubano
Covid	kovid
autoridad	autoridad
diabierna	dyabyerna
scucha	skuCa
confirma	konfirma
constata	konstata
encarga	enkarga
haciendo	hasyendo
presupuesto	presupwesto
principal	prinsipal
aumenta	aumenta
Hopi	hopi
Colegio	kolexyo
bandona	bandona
hunga	hunga
rato	rato
Bikker	bikker
cuida	kuyda
mayor	mayor
permiso	permiso
proteha	proteha
mercado	merkado
edificio	edifisyo
completamente	kompletamente
corda	korda
empleadonan	empleadonan
fase	fase
mama	mama
Maart	mart
pm	peEm
Knops	knops
curpa	kurpa
Husticia	hustisya
bai	ba
posibilidad	posibilidad
cambionan	kambyonan
extra	ekstra
protocol	protokol
realisa	realisa
asunto	asunto
cosnan	kosnan
sea	sea
MEP	mep
depende	depende
acaso	akaso
Dangui	dangy
Santa	santa
cooperacion	koperasyoN
oranan	oranan
refineria	refinerya
ambulans	ambulans
hinca	hinka
mata	mata
pesey	pesey
actividad	aktividad
accion	aksyoN
publica	publika
sra	sra
direccion	direksyoN
sera	sera
se単ala	se5ala
trahador	trahador
uso	uso
Club	klub
Crisis	krisis
Premier	premyer
over	over
studiantenan	studyantenan
suficiente	sufisyente
estado	estado
FASE	fase
campa単a	kampa5a
djis	jis
dor	dor
maart	mart
nacional	nasyonal
website	website
Team	team
polisnan	polisnan
tira	tira
Pueblo	pweblo
historia	historya
tratamento	tratamento
danki	danki
lunanan	lunanan
sospechoso	sospeCoso
Lo	lo
benta	benta
conseho	konseho
preocupacion	preokupasyoN
director	direktor
islanan	islanan
Gabinete	gabinete
calidad	kalidad
leynan	leynan
pafo	pafo
Bank	bank
Cruz	kruz
disponibel	disponibel
full	full
or	or
se単ora	se5ora
Sr	EsEr
bati	bati
considera	konsidera
digital	dixital
mesa	mesa
net	net
toch	toC
comparti	komparti
fondo	fondo
gasto	gasto
paso	paso
estudio	estudyo
vuelo	vwelo
December	desember
cura	kura
do単o	do5o
sino	sino
desaroya	desaroya
acudi	akudi
contribui	kontribuy
lubida	lubida
priva	priva
bayendo	bayendo
carga	karga
comercio	komersyo
Juli	yuli
November	november
Social	sosyal
destrui	destruy
humano	humano
juli	yuli
importancia	importansya
Tromp	tromp
actualmente	aktwalmente
fundacion	fundasyoN
Nacional	nasyonal
Wever	wever
articulo	artikulo
aproba	aproba
condicion	kondisyoN
instancia	instansya
liber	liber
muher	muher
responsabel	responsabel
rotonde	rotonde
Beach	beaC
September	september
continua	kontinwa
testnan	testnan
pisa	pisa
uni	uni
hala	hala
termina	termina
stipula	stipula
boso	boso
celebra	selebra
comision	komisyoN
bende	bende
i	i
leu	lew
madruga	madruga
maneha	maneha
reuni	rewni
studiante	studyante
trahado	trahado
turistanan	turistanan
plama	plama
produci	produsi
puntonan	puntonan
Te	te
keto	keto
experiencia	eksperyensya
paden	padeN
subraya	subraya
inclui	inkluy
October	oktober
cita	sita
Queda	kweda
Juni	yuni
Partido	partido
ambiente	ambyente
Ley	ley
Tabata	tabata
capacidad	kapasidad
cuanto	kwanto
espacio	espasyo
bario	baryo
empleado	empleado
garantisa	garantisa
Central	sentral
abogado	abogado
ambulance	ambulanse
organisacion	organisasyoN
reduci	redusi
castigo	kastigo
chens	Cens
fiesta	fyesta
parlamentario	parlamentaryo
pega	pega
seguro	seguro
deteni	deteni
sintoma	sintoma
Pasobra	pasobra
organisa	organisa
pasado	pasado
sigura	sigura
tiki	tiki
Banco	banko
Mientras	myentras
afo	afo
autonomia	autonomya
confronta	konfronta
recuperacion	rekuperasyoN
Mas	mas
bisti	bisti
donacion	donasyoN
Mei	me
abou	abow
dolor	dolor
Aparte	aparte
enfatisa	enfatisa
pia	pya
Polisnan	polisnan
Serlimar	serlimar
adapta	adapta
prijs	pres
China	Cina
POR	por
SVb	Esvebe
check	Cekk
ne	ne
Desde	desde
aumento	aumento
entrante	entrante
pakico	pakiko
subsidio	subsidyo
luz	luz
video	video
Loke	loke
Status	status
comercial	komersyal
ciudadanonan	syudadanonan
mal	mal
aspecto	aspekto
transporta	transporta
fondonan	fondonan
mei	me
proteccion	proteksyoN
boet	but
evalua	evalwa
Gobernador	gobernador
corta	korta
marduga	marduga
negativo	negativo
presencia	presensya
banco	banko
material	materyal
diasabra	dyasabra
enfrenta	enfrenta
menasa	menasa
ense単ansa	ense5ansa
noticia	notisya
Curacao	kurakao
declaracion	deklarasyoN
etc	etk
hotel	hotel
si単a	si5a
caida	kada
famianan	famyanan
Sra	sra
invita	invita
potret	potret
Endy	endi
impuesto	impwesto
lider	lider
pakete	pakete
sala	sala
Centro	sentro
Impuesto	impwesto
region	rexyoN
relacion	relasyoN
tata	tata
cacho	kaCo
contagio	kontaxyo
documento	dokumento
ilegal	ilegal
poder	poder
yiunan	yyunan
Banda	banda
horta	horta
pasahero	pasahero
ripara	ripara
barco	barko
directiva	direktiva
combati	kombati
Colombia	kolombya
politica	politika
presidente	presidente
produccion	produksyoN
solo	solo
exterior	eksteryor
ken	keN
buki	buki
centro	sentro
conclui	konkluy
dokter	dokter
lihe	lihe
resultadonan	resultadonan
yudansa	yudansa
Facebook	fasebok
ayera	ayera
consecuencia	konsekwensya
ehecuta	ehekuta
juni	yuni
otronan	otronan
legal	legal
balor	balor
detencion	detensyoN
mara	mara
tumando	tumando
fisico	fisiko
Censo	senso
Con	koN
efecto	efekto
higiena	hixyena
in	iN
pareha	pareha
producto	produkto
productonan	produktonan
bes	bes
desaroyonan	desaroyonan
limita	limita
basico	basiko
diahuebs	dyahwebs
negoshinan	negoSinan
reto	reto
unidad	unidad
yamada	yamada
pendiente	pendyente
Augustus	augustus
acerca	aserka
directamente	direktamente
Dr	deEr
altura	altura
ambos	ambos
diamars	dyamars
laboral	laboral
tey	tey
fraccion	fraksyoN
kiermen	kyermeN
Lampe	lampe
coriente	koryente
diaranson	dyaransoN
prison	prisoN
sufri	sufri
Carnaval	karnaval
Januari	yanwari
Noord	nord
contagia	kontaxya
costa	kosta
Cada	kada
Conseho	konseho
bishitante	biSitante
directo	direkto
documentonan	dokumentonan
envolvi	envolvi
forsa	forsa
and	and
bishitantenan	biSitantenan
evento	evento
mental	mental
topico	topiko
trahadonan	trahadonan
november	november
augustus	augustus
december	desember
vota	vota
Turismo	turismo
instancianan	instansyanan
interna	interna
parce	parse
tarea	tarea
St	Este
pisca	piska
raporta	raporta
telefon	telefoN
Costa	kosta
diadomingo	dyadomingo
inicia	inisya
Director	direktor
Xiomara	zyomara
actividadnan	aktividadnan
adicional	adisyonal
sirbi	sirbi
corecto	korekto
crece	krese
deporte	deporte
lamenta	lamenta
retonan	retonan
cobra	kobra
come	kome
influencia	inflwensya
keho	keho
pagina	paxina
siguridad	siguridad
Oranjestad	oranyestad
Uni	uni
emergencia	emerxensya
enorme	enorme
ex	eks
incluyendo	inkluyendo
prevencion	prevensyoN
profesional	profesyonal
da単o	da5o
ela	ela
ocasion	okasyoN
reconoce	rekonose
tera	tera
Mericano	merikano
avion	avyoN
comunicacion	komunikasyoN
confiansa	konfyansa
dato	dato
Caya	kaya
Europa	ewropa
alarma	alarma
fayece	fayese
abao	abao
educacion	edukasyoN
presentacion	presentasyoN
residente	residente
Trump	trump
notifica	notifika
protocolnan	protokolnan
recorda	rekorda
start	start
Benny	benni
Maarten	marteN
corupcion	korupsyoN
expertonan	ekspertonan
fabor	fabor
lesa	lesa
posicion	posisyoN
Algemene	alxemene
cara	kara
representa	representa
careda	kareda
demanda	demanda
encera	ensera
existi	eksisti
April	april
NV	Enve
isola	isola
les	les
meter	meter
promer	promer
specialmente	spesyalmente
tende	tende
DIMP	dimp
Stichting	stiCting
enfoca	enfoka
september	september
central	sentral
decisionnan	desisyonnan
indicacion	indikasyoN
industria	industrya
remedi	remedi
surgi	surxi
color	kolor
mensahe	mensahe
Parke	parke
anto	anto
deshaci	deSasi
parlamento	parlamento
sushi	suSi
Diaranzon	dyaranzoN
politiconan	politikonan
rekeri	rekeri
rol	rol
De	de
Rekenkamer	rekenkamer
preguntanan	preguntanan
atraco	atrako
email	emal
sindicato	sindikato
Algun	alguN
Arends	arends
isolacion	isolasyoN
papel	papel
studia	studya
DIMAS	dimas
camber	kamber
minimo	minimo
transporte	transporte
TdQ	tede ki
duda	duda
intencion	intensyoN
investiga	investiga
cifra	sifra
mehora	mehora
NO	no
am	am
simannan	simannan
Corona	korona
DIP	dip
alumnonan	alumnonan
ladronicia	ladronisya
peligroso	peligroso
preocupa	preokupa
wega	wega
Europeo	ewropeo
formulario	formularyo
idea	idea
Lopez	lopez
distanciamento	distansyamento
Cas	kas
Raad	rad
drecha	dreCa
funciona	funsyona
musica	musika
practica	praktika
servicionan	servisyonan
Esnan	esnan
opcion	opsyoN
ordo	ordo
turistico	turistiko
Plan	plaN
inverti	inverti
rijbewijs	rebewes
yen	yeN
Cultura	kultura
amplio	amplyo
aunke	aunke
queda	kweda
DOW	dow
lansa	lansa
muri	muri
o	o
premio	premyo
premira	premira
blanco	blanko
cabes	kabes
consisti	konsisti
dedica	dedika
entrevista	entrevista
operacion	operasyoN
Ban	baN
Mirando	mirando
KIA	kya
Su	su
abo	abo
canando	kanando
consideracion	konsiderasyoN
limpi	limpi
pensamento	pensamento
Ense単ansa	ense5ansa
Lotto	lotto
contenido	kontenido
drumi	drumi
grandinan	grandinan
adres	adres
construccion	konstruksyoN
splicacion	splikasyoN
Debi	debi
alumno	alumno
habitantenan	habitantenan
januari	yanwari
mr	EmEr
pasonan	pasonan
Tanki	tanki
antes	antes
pariba	pariba
toque	tokwe
training	traning
Corsow	korsow
WEB	web
atento	atento
muhe	muhe
representante	representante
urgencia	urxensya
Dios	dyos
Tjon	tyoN
empresa	empresa
esfuerso	esfwerso
acusa	akusa
gruponan	gruponan
mocion	mosyoN
prestamo	prestamo
stroba	stroba
coleganan	koleganan
implementa	implementa
preveni	preveni
sentencia	sentensya
concerni	konserni
enfermedad	enfermedad
aglomeracion	aglomerasyoN
naturalesa	naturalesa
cua	kwa
piso	piso
reacciona	reaksyona
regresa	regresa
prioridad	pryoridad
trabounan	trabownan
Afl	afl
Koolman	kolmaN
Otro	otro
miedo	myedo
real	real
AHATA	ahata
exitoso	eksitoso
funcion	funsyoN
gara	gara
inicio	inisyo
sindicatonan	sindikatonan
voto	voto
Pasco	pasko
Savaneta	savaneta
comete	komete
docentenan	dosentenan
elabora	elabora
palo	palo
reaccion	reaksyoN
sexual	sekswal
amplia	amplya
bezig	bezig
determina	determina
encontra	enkontra
supervision	supervisyoN
tal	tal
vision	visyoN
Aeropuerto	aeropwerto
Mesora	mesora
akinan	akinan
alcohol	alkohol
andando	andando
apertura	apertura
exito	eksito
stimula	stimula
yegando	yegando
palabranan	palabranan
termino	termino
vigor	vigor
Arubianonan	arubyanonan
La	la
conhuntamente	konhuntamente
cuadra	kwadra
denuncia	denunsya
entidad	entidad
integridad	integridad
marca	marka
planea	planea
ATA	ata
candidato	kandidato
comerciante	komersyante
diferencia	diferensya
kizas	kizas
respeta	respeta
valido	valido
abusa	abusa
bisando	bisando
boca	boka
dentro	dentro
elimina	elimina
scoge	skoxe
vuelonan	vwelonan
caha	kaha
coriendo	koryendo
cultura	kultura
escolar	eskolar
huur	hir
klas	klas
prohibi	prohibi
referi	referi
Kiwanis	kiwanis
peso	peso
poblacion	poblasyoN
procedura	prosedura
temponan	temponan
Andin	andiN
amigo	amigo
beach	beaC
bebe	bebe
cinco	sinko
discusion	diskusyoN
februari	febrwari
informacionnan	informasyonnan
moderno	moderno
nenga	nenga
policial	polisyal
profesionalnan	profesyonalnan
relato	relato
acceso	akseso
encuesta	enkwesta
excepcion	ekssepsyoN
mag	mag
reduccion	reduksyoN
respet	respet
safe	safe
viola	vyola
Seroe	seru
alcansa	alkansa
aporte	aporte
condena	kondena
contene	kontene
esencial	esensyal
preparacion	preparasyoN
rumbo	rumbo
Asuntonan	asuntonan
areanan	areanan
defende	defende
laboratorio	laboratoryo
orario	oraryo
participacion	partisipasyoN
planta	planta
Cuido	kuydo
Playa	playa
confisca	konfiska
docter	dokter
interesa	interesa
orguyoso	orgyoso
patras	patras
sintomanan	sintomanan
the	the
Recientemente	resyentemente
Venezolano	venezolano
buscando	buskando
comienso	komyenso
obligatorio	obligatoryo
Februari	febrwari
Hunto	hunto
comprende	komprende
disfruta	disfruta
fronteranan	fronteranan
gasta	gasta
mishi	miSi
porciento	porsyento
Cuba	kuba
Howell	howell
anual	anwal
docente	dosente
examen	eksameN
familiar	familyar
Tourism	towrism
asuntonan	asuntonan
minuut	minit
Bonaire	bonare
Internacional	internasyonal
Siman	simaN
demas	demas
exigencia	eksixensya
nace	nase
recientemente	resyentemente
sconde	skonde
sostenibel	sostenibel
Actualmente	aktwalmente
Aworaki	aworaki
Salubridad	salubridad
The	the
ademas	ademas
comportacion	komportasyoN
plataforma	plataforma
presion	presyoN
analisa	analisa
asisti	asisti
autoridadnan	autoridadnan
conocemento	konosemento
consulta	konsulta
husticia	hustisya
posible	posible
presta	presta
retiro	retiro
Comision	komisyoN
Cura巽ao	kurasao
aporta	aporta
comunica	komunika
establecimento	establesimento
importa	importa
iniciativa	inisyativa
recomenda	rekomenda
retira	retira
Rutte	rutte
fiscal	fiskal
hayando	hayando
het	het
suplica	suplika
Authority	authoriti
inscribi	inskribi
Danki	danki
Sindicato	sindikato
Ya	ya
acto	akto
admiti	admiti
haber	haber
patruyanan	patruyanan
pe	pe
Mundial	mundyal
aeropuerto	aeropwerto
inversion	inversyoN
maestro	maestro
organiza	organiza
toca	toka
En	eN
categoria	kategorya
conseha	konseha
departamentonan	departamentonan
dunando	dunando
orden	ordeN
petroleo	petroleo
ruman	rumaN
se単al	se5al
socede	sosede
Bureau	bureau
Oficina	ofisina
brote	brote
casa	kasa
ekipo	ekipo
experto	eksperto
idioma	idyoma
organizacion	organizasyoN
pickup	pikkup
salida	salida
situacionnan	sitwasyonnan
tremendo	tremendo
Sint	sint
Virus	virus
adulto	adulto
hotelnan	hotelnan
realmente	realmente
rosea	rosea
satisfecho	satisfeCo
strategia	stratexya
ticket	tikket
trankilidad	trankilidad
Directiva	direktiva
President	president
aire	are
apelacion	apelasyoN
apesar	apesar
aprobacion	aprobasyoN
media	medya
principalmente	prinsipalmente
skirbi	skirbi
Cora	kora
SKOA	skoa
alrededor	alrededor
bringa	bringa
debidamente	debidamente
habitante	habitante
impone	impone
intensivo	intensivo
lugarnan	lugarnan
maestronan	maestronan
structura	struktura
Desaroyo	desaroyo
SIMAR	simar
competencia	kompetensya
computer	komputer
disciplina	dissiplina
ha単a	ha5a
menor	menor
sectornan	sektornan
violando	vyolando
Palm	palm
Sin	siN
Universidad	universidad
asumi	asumi
ban	baN
detecta	detekta
hacie	hasye
oficialmente	ofisyalmente
reapertura	reapertura
surpasa	surpasa
vigila	vixila
Hotel	hotel
concepto	konsepto
destinacion	destinasyoN
la	la
otorga	otorga
trempan	trempaN
Center	senter
Personal	personal
coalicion	koalisyoN
colega	kolega
conexion	koneksyoN
dollar	dollar
laba	laba
lomba	lomba
sinembargo	sinembargo
teniendo	tenyendo
urgi	urxi
wowo	wowo
Romero	romero
biahe	byahe
celebracion	selebrasyoN
conduci	kondusi
curso	kurso
descubri	deskubri
eherce	eherse
falso	falso
finalisa	finalisa
Aunke	aunke
Door	dor
cuestiona	kwestyona
dialogo	dyalogo
domina	domina
exigencianan	eksixensyanan
felicita	felisita
gubernamental	gubernamental
promove	promove
risico	risiko
scapa	skapa
curason	kurasoN
perhudica	perhudika
siendo	syendo
sobrevivi	sobrevivi
vigente	vixente
Nacionnan	nasyonnan
claridad	klaridad
consecuencianan	konsekwensyanan
democratico	demokratiko
par	par
trabaonan	trabaonan
weekend	wekend
Locual	lokwal
abordo	abordo
areglo	areglo
averahe	averahe
deficit	defisit
deseo	deseo
independiente	independyente
mey	mey
midi	midi
nombra	nombra
resto	resto
Health	health
Rosa	rosa
Warda	warda
adverti	adverti
bar	bar
consciente	konssyente
cortico	kortiko
emiti	emiti
incertidumbre	insertidumbre
october	oktober
scondi	skondi
solicita	solisita
Airport	arport
Scol	skol
amor	amor
energia	enerxya
gratis	gratis
ocupacion	okupasyoN
perdida	perdida
proba	proba
restaurant	restaurant
sentido	sentido
America	amerika
bula	bula
colaboracion	kolaborasyoN
ganador	ganador
medionan	medyonan
residentenan	residentenan
truck	trukk
cabez	kabez
laat	lat
plachi	plaCi
preferencia	preferensya
sorpresa	sorpresa
Economico	ekonomiko
Leendert	lendert
alivio	alivyo
ataca	ataka
experencia	eksperensya
protesta	protesta
tapa	tapa
tecnologia	teknoloxya
update	update
Advies	advyes
Pos	pos
Respaldo	respaldo
Union	unyoN
aviso	aviso
belasting	belasting
construi	konstruy
menaza	menaza
seyo	seyo
stima	stima
storia	storya
victimanan	viktimanan
Van	vaN
ami	ami
brandweer	brandwer
comerciantenan	komersyantenan
dura	dura
estatal	estatal
hudicial	hudisyal
mondi	mondi
motor	motor
partidonan	partidonan
tempran	tempraN
vulnerabel	vulnerabel
Sevinger	sevinxer
Varios	varyos
beneficio	benefisyo
concreto	konkreto
crecemento	kresemento
derechonan	dereConan
dunador	dunador
libertad	libertad
ola	ola
Deporte	deporte
casnan	kasnan
club	klub
conforme	konforme
custumber	kustumber
datonan	datonan
existente	eksistente
negocia	negosya
preto	preto
registracion	rexistrasyoN
Miyon	miyoN
Online	online
apenas	apenas
confianza	konfyanza
detaye	detaye
resumen	resumeN
reunionnan	rewnyonnan
screening	skrening
venidero	venidero
Guardacosta	gwardakosta
Thijsen	theseN
alerta	alerta
colmo	kolmo
coopera	kopera
dushi	duSi
gusta	gusta
obliga	obliga
popular	popular
reforma	reforma
specifico	spesifiko
subida	subida
A単a	a5a
Papiamento	papyamento
espera	espera
grave	grave
identifica	identifika
metanan	metanan
obstante	obstante
tapaboca	tapaboka
Dakota	dakota
Hende	hende
SETAR	setar
amigonan	amigonan
april	april
huridico	huridiko
instala	instala
move	move
ocupa	okupa
principio	prinsipyo
severo	severo
trayecto	trayekto
velocidad	velosidad
New	new
Paradera	paradera
bolter	bolter
brug	brug
cancer	kanser
controlnan	kontrolnan
cuestionario	kwestyonaryo
saludabel	saludabel
virtual	virtwal
BBO	bbo
Corsou	korsow
aspectonan	aspektonan
autonan	autonan
dispuesto	dispwesto
dunado	dunado
efectonan	efektonan
generacion	xenerasyoN
hogar	hogar
instruccion	instruksyoN
interno	interno
motibonan	motibonan
op	op
priminti	priminti
urgente	urxente
Dos	dos
Fraccion	fraksyoN
Glenbert	glenbert
Kock	kokk
actonan	aktonan
critica	kritika
desconoci	deskonosi
diripiente	diripyente
organo	organo
relata	relata
revela	revela
Candelaria	kandelarya
Mescos	meskos
cancela	kansela
corto	korto
crusada	krusada
encuanto	enkwanto
enfasis	enfasis
fayecimento	fayesimento
forza	forza
genera	xenera
haltura	haltura
transmision	transmisyoN
transparencia	transparensya
Comercio	komersyo
Directie	direktye
Se単ora	se5ora
brommer	brommer
contract	kontrakt
esunnan	esunnan
lamentablemente	lamentablemente
serca	serka
tarifa	tarifa
vakantie	vakantye
yudanza	yudanza
Alto	alto
Robert	robert
SMOA	smoa
acusacion	akusasyoN
avisa	avisa
back	bakk
bieu	byew
boluntario	boluntaryo
deber	deber
discuti	diskuti
esfuerzo	esfwerzo
exactamente	eksaktamente
panico	paniko
rekisitonan	rekisitonan
reserva	reserva
CAft	se aft
airport	arport
contribucion	kontribusyoN
costo	kosto
cuatro	kwatro
existencia	eksistensya
maltrato	maltrato
mundialmente	mundyalmente
pasaheronan	pasaheronan
pensioen	pensyuN
precaucion	prekausyoN
treci	tresi
Dominicana	dominikana
Elmar	elmar
Famia	famya
Labor	labor
Macuarima	makwarima
claro	klaro
infecta	infekta
ranca	ranka
representantenan	representantenan
seccion	seksyoN
wanta	wanta
Casino	kasino
Entre	entre
KPA	kpa
analisis	analisis
aparato	aparato
basha	baSa
clave	klave
empresanan	empresanan
facilita	fasilita
guera	gera
pabao	pabao
pagonan	pagonan
proposicion	proposisyoN
articulonan	artikulonan
demasiado	demasyado
gremionan	gremyonan
historico	historiko
invitacion	invitasyoN
partner	partner
plannan	plannan
profundo	profundo
ruta	ruta
union	unyoN
violencia	vyolensya
AAA	aa
Corda	korda
Entrante	entrante
Rocco	rokko
SVB	Esvebe
aplicacion	aplikasyoN
dado	dado
estricto	estrikto
fiansa	fyansa
manifesta	manifesta
multa	multa
practicamente	praktikamente
reparti	reparti
sospechosonan	sospeCosonan
EPI	epi
General	xeneral
School	sCol
Vos	vos
Watty	watti
bastante	bastante
comenta	komenta
creativo	kreativo
robes	robes
tristo	tristo
Republica	republika
completa	kompleta
crucero	krusero
electoral	elektoral
honra	honra
mediano	medyano
mondkapje	mondkapye
nacionalidad	nasyonalidad
natural	natural
penal	penal
rapido	rapido
rapportnan	rapportnan
recien	resyeN
COVID	kovid
Comisario	komisaryo
Comunidad	komunidad
Guarda	gwarda
Meza	meza
Statuut	statit
democracia	demokrasya
evaluacion	evalwasyoN
factor	faktor
infeccion	infeksyoN
infrastructura	infrastruktura
kiko	kiko
logro	logro
ocasiona	okasyona
portanan	portanan
scenario	ssenaryo
veld	veld
Donald	donald
Eagle	eagle
contrario	kontraryo
drastico	drastiko
ministerio	ministeryo
soluciona	solusyona
supermercado	supermerkado
Bubali	bubali
Pakico	pakiko
Tanto	tanto
afspraak	afsprak
bien	byeN
condolencia	kondolensya
cuater	kwater
entradanan	entradanan
tog	tog
Ayera	ayera
CAFT	kaft
Foundation	fowndatyoN
Sabana	sabana
apoyo	apoyo
bisi単a	bisi5a
burachi	buraCi
decada	dekada
destruccion	destruksyoN
efectivo	efektivo
haye	haye
introduccion	introduksyoN
niun	nyuN
trankil	trankil
Besaril	besaril
CITGO	sitgo
Grandi	grandi
Tjin	tyiN
arte	arte
desaster	desaster
edicion	edisyoN
ehemplo	ehemplo
enfoke	enfoke
etapa	etapa
grado	grado
hamas	hamas
helicopter	helikopter
mita	mita
opta	opta
realiza	realiza
simplemente	simplemente
CEO	seo
Juan	ywaN
alabes	alabes
bibando	bibando
buskeda	buskeda
combersacion	kombersasyoN
dedicacion	dedikasyoN
diario	dyaryo
discurso	diskurso
gasolin	gasoliN
intento	intento
legalmente	legalmente
localidad	lokalidad
reitera	retera
salubridad	salubridad
sano	sano
situa	sitwa
speransa	speransa
Reina	rena
Richard	riCard
automaticamente	automatikamente
calamidad	kalamidad
cuestion	kwestyoN
deal	deal
ense単anza	ense5anza
fastioso	fastyoso
modelo	modelo
participante	partisipante
preparando	preparando
procesa	prosesa
publicacion	publikasyoN
refleha	refleha
Infrastructura	infrastruktura
Setar	setar
cocaina	kokana
extende	ekstende
hefe	hefe
horcan	horkaN
opera	opera
pilar	pilar
school	sCol
Subsidio	subsidyo
Wardacosta	wardakosta
corona	korona
cumpliendo	kumplyendo
ilustra	ilustra
internet	internet
los	los
perspectiva	perspektiva
surplus	surplus
Rey	rey
bashi	baSi
comprension	komprensyoN
constantemente	konstantemente
cultural	kultural
facebook	fasebok
kendenan	kendenan
to	to
transmiti	transmiti
viahe	vyahe
Association	assosyatyoN
International	internatyonal
Sneek	snek
al	al
aparentemente	aparentemente
comienzo	komyenzo
container	kontaner
cora	kora
honor	honor
husto	husto
levemente	levemente
segundo	segundo
seis	ses
turno	turno
Alan	alaN
Boulevard	bowlevard
Caribbean	karibbeaN
Mientrastanto	myentrastanto
Recherche	reCerCe
actitud	aktitud
ahusta	ahusta
atendi	atendi
calcula	kalkula
carchi	karCi
compromiso	kompromiso
dak	dak
destina	destina
detenido	detenido
finalmente	finalmente
gerencia	xerensya
huy	huy
mantencion	mantensyoN
reclama	reklama
webinar	webinar
Ambulance	ambulanse
Ningun	ninguN
Raymond	raymond
Resort	resort
fe	fe
importacion	importasyoN
nissan	nissaN
pabien	pabyeN
participantenan	partisipantenan
perdi	perdi
remarke	remarke
Ainda	anda
Chauffeur	Cauffewr
ICU	iku
aprecia	apresya
bahando	bahando
critico	kritiko
hustamente	hustamente
innovacion	innovasyoN
negociacion	negosyasyoN
obligacion	obligasyoN
observa	observa
oro	oro
rabia	rabya
ripiti	ripiti
Apesar	apesar
Code	kode
Codigo	kodigo
Economia	ekonomya
Otmar	otmar
Plaza	plaza
Sigur	sigur
York	york
balansa	balansa
kiebro	kyebro
porfin	porfiN
recauda	rekauda
weganan	weganan
Brazil	brazil
DPL	depeEl
ImSan	im saN
Salario	salaryo
atene	atene
femenino	femenino
financiamento	finansyamento
gabinete	gabinete
huma	huma
misa	misa
pa単a	pa5a
pida	pida
preventivo	preventivo
regular	regular
sistemanan	sistemanan
Marlon	marloN
Mundo	mundo
TDQ	tedeki
bestia	bestya
comun	komuN
conclusion	konklusyoN
covid	kovid
debenan	debenan
igual	igwal
serie	serye
stra単o	stra5o
wardando	wardando
Chikito	Cikito
comunicado	komunikado
dus	dus
empleo	empleo
establecimentonan	establesimentonan
imagen	imaxeN
lidernan	lidernan
merece	merese
pecho	peCo
pio	pyo
prefera	prefera
preocupante	preokupante
se単or	se5or
specialista	spesyalista
Ambiente	ambyente
Lamentablemente	lamentablemente
advertencia	advertensya
conocido	konosido
crimen	krimeN
divulga	divulga
educa	eduka
encuentro	enkwentro
especialmente	espesyalmente
garantia	garantya
interesante	interesante
malesanan	malesanan
panort	panort
parada	parada
sorto	sorto
tarda	tarda
up	up
Blanco	blanko
Boekhoudt	bukhowdt
Camacuri	kamakuri
Chris	Cris
Huez	hwez
Sero	sero
avansa	avansa
biento	byento
compra	kompra
describi	deskribi
drechi	dreCi
movecion	movesyoN
negociacionnan	negosyasyonnan
probecha	probeCa
pusha	puSa
sigi	sixi
totalmente	totalmente
Alabes	alabes
Kelly	kelli
KvK	kave ka
Mucha	muCa
Vrolijk	vrolek
awendia	awendya
conciente	konsyente
consumidor	konsumidor
criminalidad	kriminalidad
desinfecta	desinfekta
ehecucion	ehekusyoN
expande	ekspande
fuente	fwente
hisa	hisa
individual	individwal
ladron	ladroN
laman	lamaN
mehoracion	mehorasyoN
recherche	reCerCe
revisa	revisa
sanger	sanxer
sociedad	sosyedad
Intensivo	intensivo
Patrishi	patriSi
Sharline	Sarline
artista	artista
aun	auN
bombero	bombero
estilo	estilo
molester	molester
normalmente	normalmente
pan	paN
pelea	pelea
stress	stress
tarheta	tarheta
yobida	yobida
Ambos	ambos
Happy	happi
IPA	ipa
Parlamentarionan	parlamentaryonan
acusacionnan	akusasyonnan
agenda	axenda
dignatario	dignataryo
draai	dray
edificionan	edifisyonan
musical	musikal
normanan	normanan
oido	oydo
pasenshi	pasenSi
procedente	prosedente
roadservice	roadservise
College	kollexe
Estado	estado
Finalmente	finalmente
Geerman	xermaN
UPP	upp
afor	afor
anuncio	anunsyo
baranca	baranka
cartera	kartera
drs	deErEs
duradero	duradero
hyundai	hyunda
informantenan	informantenan
keri	keri
materia	materya
origen	orixeN
regula	regula
Algo	algo
Defensa	defensa
Esakinan	esakinan
Hasta	hasta
Homber	homber
Mark	mark
Mayoria	mayorya
Relaciona	relasyona
bijstand	bestand
biyon	biyoN
conecta	konekta
defensa	defensa
dune	dune
humanitario	humanitaryo
kima	kima
maltrata	maltrata
ministernan	ministernan
peligro	peligro
titulo	titulo
transparente	transparente
Airlines	arlines
Arikok	arikok
Asunto	asunto
Rijkswet	rekswet
Secretario	sekretaryo
Semper	semper
Servicio	servisyo
US	us
agente	axente
berde	berde
condicional	kondisyonal
institui	instituy
mustrando	mustrando
reactiva	reaktiva
reconoci	rekonosi
regalo	regalo
scohe	skohe
tanten	tanteN
viaha	vyaha
violacion	vyolasyoN
vocero	vosero
zona	zona
Brandweer	brandwer
Camara	kamara
Group	growp
Medio	medyo
Sociaal	sosyal
adicto	adikto
aparece	aparese
apartamento	apartamento
ceremonia	seremonya
cupo	kupo
epoca	epoka
finaliza	finaliza
garantiza	garantiza
vivienda	vivyenda
App	app
Awo	awo
Jamaica	yamaka
celular	selular
contact	kontakt
criminal	kriminal
cuminsando	kuminsando
dicho	diCo
do単onan	do5onan
formal	formal
hand	hand
herencia	herensya
normalidad	normalidad
oportunidadnan	oportunidadnan
oposicion	oposisyoN
papiando	papyando
place	plase
show	Sow
stranhero	stranhero
tankinan	tankinan
tareanan	tareanan
totalidad	totalidad
usando	usando
Cuanto	kwanto
Island	island
Kamer	kamer
Maria	marya
activa	aktiva
alma	alma
ciudad	syudad
codigo	kodigo
continuamente	kontinwamente
cuerpo	kwerpo
decreto	dekreto
destino	destino
feliz	feliz
lesnan	lesnan
liher	liher
lora	lora
mascota	maskota
pabou	pabow
particular	partikular
procesonan	prosesonan
rueda	rweda
Dowers	dowers
Eddy	eddi
Grupo	grupo
MANA	mana
aerolinea	aerolinea
asiento	asyento
ciere	syere
circula	sirkula
civil	sivil
claramente	klaramente
convenci	konvensi
establece	establese
inmediatamente	inmedyatamente
limite	limite
ma単an	ma5aN
padilanti	padilanti
partinan	partinan
primario	primaryo
propone	propone
resumi	resumi
santo	santo
stakeholders	stakeholders
temanan	temanan
unicamente	unikamente
vehiculonan	vehikulonan
Muchanan	muCanan
PPP	pepepe
Piedra	pyedra
Ponton	pontoN
alegria	alegrya
cancion	kansyoN
carnaval	karnaval
dificultad	difikultad
enfatiza	enfatiza
facilidad	fasilidad
faya	faya
inscripcion	inskripsyoN
paz	paz
peticionnan	petisyonnan
porcentahe	porsentahe
probablemente	probablemente
progreso	progreso
saco	sako
secreto	sekreto
solucionnan	solusyonnan
tranche	tranCe
transcurso	transkurso
Boneiro	bonero
Dienst	dyenst
Haag	hag
MFA	mfa
PCR	peseEr
RdA	Erde a
capta	kapta
causando	kausando
corte	korte
expresion	ekspresyoN
fia	fya
grita	grita
kisas	kisas
maske	maske
pafor	pafor
parlamentarionan	parlamentaryonan
prolonga	prolonga
similar	similar
stuur	stir
testigo	testigo
Bar	bar
Ense単anza	ense5anza
Lacle	lakle
Latino	latino
Paso	paso
Rijbewijs	rebewes
apoya	apoya
carera	karera
constitucion	konstitusyoN
cruzada	kruzada
insisti	insisti
kilo	kilo
lockdown	lokkdowN
oficialnan	ofisyalnan
organisacionnan	organisasyonnan
plachinan	plaCinan
post	post
prohibicion	prohibisyoN
proyecta	proyekta
record	rekord
strategico	stratexiko
tas	tas
tienda	tyenda
waf	waf
Arubahuis	arubahuys
Dollar	dollar
Florida	florida
Ombudsman	ombudsmaN
ambulante	ambulante
app	app
atendiendo	atendyendo
awanan	awanan
baby	babi
combina	kombina
culpa	kulpa
curashi	kuraSi
es	es
funda	funda
goberna	goberna
implementacion	implementasyoN
indice	indise
motiva	motiva
oferta	oferta
seno	seno
solido	solido
tiro	tiro
Plat	plat
aplaudi	aplaudi
beslag	beslag
biniendo	binyendo
canta	kanta
colecta	kolekta
consehonan	konsehonan
da単a	da5a
debido	debido
defini	defini
desastre	desastre
diabetes	dyabetes
disculpa	diskulpa
emocional	emosyonal
escala	eskala
esfuersonan	esfwersonan
hamber	hamber
loonsubsidie	lonsubsidye
meld	meld
muestra	mwestra
norma	norma
on	oN
pelicula	pelikula
personalmente	personalmente
promedio	promedyo
sospecha	sospeCa
tropical	tropikal
zorg	zorg
Canada	kanada
Eynan	eynan
Horacio	horasyo
Rudy	rudi
Staten	stateN
compras	kompras
consumo	konsumo
contribuyente	kontribuyente
dunadornan	dunadornan
eleccionnan	eleksyonnan
estadia	estadya
facilidadnan	fasilidadnan
formacion	formasyoN
kwartaal	kwartal
linea	linea
nocturno	nokturno
pospone	pospone
renoba	renoba
salba	salba
saliendo	salyendo
sanitizer	sanitizer
tercer	terser
Arthur	arthur
Hoben	hobeN
Iran	iraN
Museo	museo
Ponson	ponsoN
bancario	bankaryo
bomberonan	bomberonan
cadena	kadena
crucial	krusyal
custumbra	kustumbra
diariamente	dyaryamente
enberdad	enberdad
exposicion	eksposisyoN
eyden	eydeN
formula	formula
gobernantenan	gobernantenan
graba	graba
horario	horaryo
inversionista	inversyonista
investigacionnan	investigasyonnan
march	marC
maritimo	maritimo
monitor	monitor
muraya	muraya
planificacion	planifikasyoN
propiedad	propyedad
scur	skur
sentimento	sentimento
sesion	sesyoN
so単o	so5o
tecnico	tekniko
tendencia	tendensya
Biyon	biyoN
Docter	dokter
Hecho	heCo
Park	park
Parkietenbos	parkyetenbos
Ronella	ronella
Sector	sektor
Sinterklaas	sinterklas
Transporte	transporte
World	world
bancarota	bankarota
confia	konfya
data	data
encurasha	enkuraSa
informativo	informativo
inicial	inisyal
manifestacion	manifestasyoN
masculino	maskulino
mitiga	mitiga
naturalmente	naturalmente
staciona	stasyona
temporalmente	temporalmente
unidadnan	unidadnan
Arubus	arubus
Biblioteca	biblyoteka
DNM	deEnEm
Finanzas	finanzas
Inglatera	inglatera
Kiermen	kyermeN
Miami	myami
Ni	ni
Promer	promer
adelanta	adelanta
apunta	apunta
atake	atake
caro	karo
cende	sende
combersa	kombersa
conscientisacion	konssyentisasyoN
contracto	kontrakto
culpable	kulpable
equipo	ekwipo
eventonan	eventonan
fayecido	fayesido
grandemente	grandemente
gremio	gremyo
impresion	impresyoN
incluso	inkluso
inversionistanan	inversyonistanan
ladronnan	ladronnan
lagando	lagando
miles	miles
pazuid	pazuyd
promesa	promesa
radio	radyo
recomendacion	rekomendasyoN
talento	talento
varia	varya
vecindario	vesindaryo
voluntario	voluntaryo
CBS	sebeEs
Cacique	kasikwe
Caribense	karibense
Chines	Cines
FADA	fada
Madiki	madiki
One	one
Prensa	prensa
Uno	uno
accionnan	aksyonnan
alternativa	alternativa
anticipa	antisipa
barconan	barkonan
bentana	bentana
bibo	bibo
candidatonan	kandidatonan
constitucional	konstitusyonal
copia	kopya
cushina	kuSina
dr	deEr
fuera	fwera
keha	keha
marihuana	marihwana
page	paxe
piedra	pyedra
pinta	pinta
pronostica	pronostika
reconocimento	rekonosimento
renobacion	renobasyoN
separa	separa
transferi	transferi
valioso	valyoso
voor	vor
Asociacion	asosyasyoN
Bombero	bombero
Democratico	demokratiko
Lago	lago
Mansur	mansur
agradecido	agradesido
awacero	awasero
banconan	bankonan
cachonan	kaConan
creatividad	kreatividad
cuchiu	kuCyu
fantasia	fantasya
financia	finansya
mascara	maskara
mente	mente
moral	moral
obra	obra
positivity	positiviti
prijsnan	presnan
prima	prima
regimen	reximeN
restaurantnan	restaurantnan
sangura	sangura
shelter	Selter
sikiera	sikyera
simpel	simpel
sindical	sindikal
spaar	spar
specificamente	spesifikamente
sucedido	susedido
television	televisyoN
Ami	ami
DAO	dao
FPNA	fpna
Guaid坦	gwado
Ministernan	ministernan
Renaissance	renassanse
anda	anda
bari	bari
caracter	karakter
complica	komplika
corant	korant
cronico	kroniko
escoge	eskoxe
ideanan	ideanan
indicando	indikando
instituto	instituto
lanza	lanza
piscadornan	piskadornan
programanan	programanan
raport	raport
resalta	resalta
seriedad	seryedad
speranza	speranza
temporal	temporal
topiconan	topikonan
Bushiri	buSiri
Cosecha	koseCa
Festival	festival
Figaroa	figaroa
Hooiberg	hoyberg
Italia	italya
Kruis	kruys
Kustwacht	kustwaCt
Lejuez	leywez
Manager	manaxer
Medico	mediko
Nelson	nelsoN
Nissan	nissaN
Real	real
Rusia	rusya
Sea	sea
Task	task
agentenan	axentenan
anteriormente	anteryormente
autonomo	autonomo
barionan	baryonan
comentario	komentaryo
educativo	edukativo
fruta	fruta
glas	glas
gobiernonan	gobyernonan
goza	goza
hereda	hereda
hulandes	hulandes
limitacion	limitasyoN
localnan	lokalnan
mitar	mitar
persigui	persigy
suministra	suministra
Amsterdam	amsterdam
Keda	keda
Personanan	personanan
Reclassering	reklassering
Restaurant	restaurant
Santo	santo
Tene	tene
Tweede	twede
adecua	adekwa
anja	anya
atrae	atrae
boter	boter
botica	botika
cama	kama
contribuyentenan	kontribuyentenan
dump	dump
eficiente	efisyente
financieramente	finansyeramente
fundeshi	fundeSi
mask	mask
necesidadnan	nesesidadnan
pare	pare
piloto	piloto
problematica	problematika
recurso	rekurso
representacion	representasyoN
resolve	resolve
sacrificio	sakrifisyo
secundario	sekundaryo
sugeri	suxeri
tini	tini
yabi	yabi
Avenida	avenida
Boneiru	boneru
Diferente	diferente
Euro	ewro
HOH	hoh
Investigacion	investigasyoN
SMFA	smfa
STA	sta
Vanessa	vanessa
acompa単a	akompa5a
acorda	akorda
bez	bez
bruto	bruto
capital	kapital
cauteloso	kauteloso
cometi	kometi
continuo	kontinwo
crusero	krusero
cumbre	kumbre
delibera	delibera
diploma	diploma
drasticamente	drastikamente
exacto	eksakto
hues	hwes
link	link
musico	musiko
otorgamento	otorgamento
paketenan	paketenan
pesar	pesar
petrolero	petrolero
posiblemente	posiblemente
redaccion	redaksyoN
reformanan	reformanan
registro	rexistro
riesgonan	ryesgonan
rij	re
sincero	sinsero
solidaridad	solidaridad
sorprendi	sorprendi
tiramento	tiramento
FTA	fta
Lions	lyons
Master	master
SADA	sada
WHO	who
aglomera	aglomera
ancra	ankra
bus	bus
casino	kasino
cientifico	syentifiko
destaho	destaho
estableci	establesi
factornan	faktornan
ga単a	ga5a
lus	lus
mercadonan	merkadonan
mortal	mortal
naci	nasi
plamamento	plamamento
potretnan	potretnan
solidario	solidaryo
sorteo	sorteo
structural	struktural
APA	apa
Akinan	akinan
Ambulans	ambulans
FPNC	EfpeEnse
Frank	frank
Pabien	pabyeN
Presupuesto	presupwesto
RED	red
Ultimo	ultimo
accident	aksident
agresivo	agresivo
bandera	bandera
bendi	bendi
beneficionan	benefisyonan
cash	kaS
concentra	konsentra
contexto	konteksto
desmenti	desmenti
domestico	domestiko
echo	eCo
expone	ekspone
fiha	fiha
instrumento	instrumento
likides	likides
pidiendo	pidyendo
potencial	potensyal
schedule	sCedule
todo	todo
Atraco	atrako
Boso	boso
City	siti
Companianan	kompanyanan
Dellanire	dellanire
Food	fod
Force	forse
Hof	hof
Hubenil	hubenil
Importante	importante
Primario	primaryo
SVOA	svoa
Vista	vista
bisto	bisto
caduca	kaduka
canto	kanto
comporta	komporta
ehecutivo	ehekutivo
enfrente	enfrente
fungi	funxi
instante	instante
intermedia	intermedya
inversionnan	inversyonnan
mannan	mannan
oktober	oktober
pagando	pagando
partnernan	partnernan
preocupacionnan	preokupasyonnan
rason	rasoN
reanuda	reanuda
remedinan	remedinan
temperatura	temperatura
tradicional	tradisyonal
vacacion	vakasyoN
DAS	das
Guera	gera
Plenipotenciario	plenipotensyaryo
Se単or	se5or
Solamente	solamente
Tres	tres
acuerdonan	akwerdonan
beneficia	benefisya
berguensa	bergensa
bicicleta	bisikleta
boga	boga
canal	kanal
clima	klima
delito	delito
dialoga	dyaloga
disponible	disponible
eligi	elixi
gobernante	gobernante
hustifica	hustifika
inspira	inspira
labor	labor
palabracion	palabrasyoN
relacionnan	relasyonnan
sernan	sernan
traspasa	traspasa
AO	ao
Finansa	finansa
Informacion	informasyoN
Kibrahacha	kibrahaCa
Linda	linda
Of	of
SABA	saba
Shelter	Selter
Toyota	toyota
adaptacion	adaptasyoN
agricultura	agrikultura
birando	birando
borchi	borCi
calor	kalor
capaz	kapaz
dise単a	dise5a
forensico	forensiko
ganashi	ganaSi
golpi	golpi
imposibel	imposibel
inmediato	inmedyato
kedando	kedando
kehonan	kehonan
labora	labora
leve	leve
likidez	likidez
li単a	li5a
mando	mando
operacional	operasyonal
plasma	plasma
portal	portal
pro	pro
responsable	responsable
security	sekuriti
vocifera	vosifera
AWG	awg
American	amerikaN
BCA	bka
Berdad	berdad
Biden	bideN
Green	greN
Lider	lider
Marriott	marryott
OPPA	oppa
Patruya	patruya
Renny	renni
Rooi	roy
SPA	spa
Vocero	vosero
Voz	voz
acumula	akumula
ambtenaar	ambtenar
biblioteca	biblyoteka
capitan	kapitaN
clase	klase
confirmacion	konfirmasyoN
cualifica	kwalifika
debito	debito
despedi	despedi
dicta	dikta
directora	direktora
era	era
fortifica	fortifika
getest	xetest
is	is
nanishi	naniSi
notificacion	notifikasyoN
operacionnan	operasyonnan
pertenece	pertenese
ppt	pepete
salvaguardia	salvagwardya
scan	skaN
spanta	spanta
takelwagen	takelwaxeN
taxi	taksi
tormenta	tormenta
vigilancia	vixilansya
Carnival	karnival
Cifranan	sifranan
CoronaVirus	korona virus
Democrata	demokrata
John	yohN
Laga	laga
Ling	ling
Toch	toC
Wit	wit
acelera	aselera
adecuado	adekwado
adelante	adelante
aniversario	aniversaryo
aplicabel	aplikabel
aserca	aserka
aya	aya
bebida	bebida
bisi単anan	bisi5anan
certificado	sertifikado
compila	kompila
desvia	desvya
eleva	eleva
funcionamento	funsyonamento
generacionnan	xenerasyonnan
global	global
inespera	inespera
intercepta	intersepta
internacionalmente	internasyonalmente
localidadnan	lokalidadnan
memey	memey
monitorea	monitorea
naturaleza	naturaleza
obtenibel	obtenibel
ordena	ordena
ponencia	ponensya
rapidamente	rapidamente
sla	sla
stap	stap
supermarket	supermarket
teni	teni
tension	tensyoN
toyota	toyota
Civil	sivil
Clientenan	klyentenan
DTI	dti
GKMB	gekaEmbe
Helicopter	helikopter
Hunta	hunta
KLM	kaElEm
Mexico	meksiko
Misa	misa
Organisacion	organisasyoN
Ras	ras
asalto	asalto
blauw	blauw
cai	ka
ehercicio	ehersisyo
keintura	kentura
liderazgo	liderazgo
ma	ma
militar	militar
minimalisa	minimalisa
papelnan	papelnan
pober	pober
purbando	purbando
recomendacionnan	rekomendasyonnan
siguiendo	sigyendo
taxista	taksista
tayer	tayer
terminal	terminal
vence	vense
ATIA	atya
Albertus	albertus
Estadistica	estadistika
Happiness	happiness
Informantenan	informantenan
Ingles	ingles
Jan	yaN
Mama	mama
OCCA	okka
Proteccion	proteksyoN
Siglo	siglo
Supermarket	supermarket
Total	total
Unda	unda
Wardakosta	wardakosta
alivia	alivya
amiga	amiga
bise	bise
cansa	kansa
captura	kaptura
carni	karni
cayente	kayente
chauffeurnan	Cauffewrnan
consehero	konsehero
der	der
dinamico	dinamiko
encargo	enkargo
escenario	essenaryo
famoso	famoso
fenomeno	fenomeno
fiho	fiho
finanzas	finanzas
fout	fowt
fresco	fresko
futbol	futbol
geel	xel
griep	gryep
hit	hit
inspeccion	inspeksyoN
luganan	luganan
matanan	matanan
musiconan	musikonan
poniendo	ponyendo
pronostico	pronostiko
proposito	proposito
reconstrui	rekonstruy
regularmente	regularmente
sperando	sperando
status	status
suerte	swerte
supera	supera
terminacion	terminasyoN
tire	tire
yora	yora
Balashi	balaSi
Care	kare
Flip	flip
Ki	ki
Maneho	maneho
Mayornan	mayornan
Naturalmente	naturalmente
Obispo	obispo
Rasmijn	rasmeN
Sindicatonan	sindikatonan
Taxi	taksi
Willemstad	willemstad
adultonan	adultonan
airco	arko
berdura	berdura
birada	birada
corectamente	korektamente
coy	koy
dicon	dikoN
entiero	entyero
exporta	eksporta
festival	festival
gas	gas
gosa	gosa
incidente	insidente
jong	yong
labamento	labamento
mericano	merikano
nort	nort
orguyo	orgyo
pleno	pleno
publicidad	publisidad
pulmon	pulmoN
rementa	rementa
specialisa	spesyalisa
stricto	strikto
tratado	tratado
verifica	verifika
Dama	dama
Douane	dowane
Expertonan	ekspertonan
Inspector	inspektor
Isla	isla
Masha	maSa
Quota	kwota
YMCA	imka
administrativo	administrativo
alavez	alavez
aprecio	apresyo
atractivo	atraktivo
bala	bala
cercania	serkanya
cobransa	kobransa
compromete	kompromete
contratista	kontratista
duracion	durasyoN
empeora	empeora
escrito	eskrito
firme	firme
gradualmente	gradwalmente
identidad	identidad
ministerial	ministeryal
mobilisa	mobilisa
obtene	obtene
operador	operador
patruyando	patruyando
posibilidadnan	posibilidadnan
principionan	prinsipyonan
promocion	promosyoN
regional	rexyonal
relevante	relevante
repasa	repasa
restriccion	restriksyoN
Barcadera	barkadera
Bestuurskantoor	bestirskantor
Bomberonan	bomberonan
Fondo	fondo
Instituto	instituto
Jossy	yossi
Marina	marina
Obispado	obispado
Place	plase
Proyecto	proyekto
Registro	rexistro
Smith	smith
Via	vya
Vicente	visente
average	averaxe
barata	barata
concierto	konsyerto
conflicto	konflikto
conosi	konosi
contrato	kontrato
creacion	kreasyoN
credito	kredito
culmina	kulmina
curazon	kurazoN
fundamental	fundamental
inconveniencia	inkonvenyensya
interino	interino
limpiesa	limpyesa
moneda	moneda
publicamente	publikamente
puesto	pwesto
sumanan	sumanan
trayectoria	trayektorya
Ariba	ariba
Bario	baryo
Carlos	karlos
Casonan	kasonan
Claro	klaro
Edgard	edgard
Freewinds	frewinds
Futuro	futuro
Gele	xele
Industria	industrya
Jacobs	yakobs
Kizas	kizas
Meta	meta
Rancho	ranCo
Wayaca	wayaka
abase	abase
accidenta	aksidenta
animal	animal
asesinato	asesinato
basicamente	basikamente
botonan	botonan
creando	kreando
delicado	delikado
deportivo	deportivo
desconfiansa	deskonfyansa
docternan	dokternan
estrecho	estreCo
fluho	fluho
garganta	garganta
hipoteca	hipoteka
hotelero	hotelero
kia	kya
monumento	monumento
paramedico	paramediko
parkinglot	parkinglot
periodista	peryodista
posponi	posponi
proceduranan	proseduranan
proyeccion	proyeksyoN
rescata	reskata
robez	robez
shinishi	SiniSi
sink	sink
top	top
vergunning	vergunning
vital	vital
workshop	workSop
zuid	zuyd
Anto	anto
Control	kontrol
Daphne	daphne
Drive	drive
FCCA	fkka
Hefe	hefe
Himno	himno
Jurette	yurette
Pau	pau
Paul	paul
Pontilius	pontilyus
Spa単a	spa5a
acentua	asentwa
alarmante	alarmante
animo	animo
antemano	antemano
artistanan	artistanan
buraco	burako
cercano	serkano
colabora	kolabora
combinacion	kombinasyoN
considerando	konsiderando
consistiendo	konsistyendo
debate	debate
deposita	deposita
druk	druk
finansas	finansas
herment	herment
hombernan	hombernan
jega	yega
memoria	memorya
mentira	mentira
museo	museo
ocho	oCo
oficinanan	ofisinanan
paralisa	paralisa
parke	parke
pension	pensyoN
prescribi	preskribi
profesion	profesyoN
projecto	proyekto
pruebanan	prwebanan
rechasa	reCasa
reina	rena
resorta	resorta
stabilidad	stabilidad
temblor	temblor
Alex	aleks
BO	bo
Boluntario	boluntaryo
Bon	boN
Corridor	korridor
Decreto	dekreto
Fuera	fwera
Groningen	groninxeN
HH	haha
Helder	helder
Informacionnan	informasyonnan
Mega	mega
National	natyonal
Puerto	pwerto
UTV	utv
adiccion	adiksyoN
aereo	aereo
atracadornan	atrakadornan
aumentando	aumentando
centronan	sentronan
cero	sero
ciclista	siklista
clubnan	klubnan
contagionan	kontaxyonan
coregi	korexi
cuentanan	kwentanan
detayenan	detayenan
dise単o	dise5o
disparce	disparse
distrito	distrito
een	eN
frontal	frontal
instalacion	instalasyoN
matutino	matutino
mediante	medyante
mensahenan	mensahenan
mensual	menswal
mln	EmElEn
nesesario	nesesaryo
palabracionnan	palabrasyonnan
pedofil	pedofil
pic	pik
preparacionnan	preparasyonnan
ramo	ramo
relativamente	relativamente
sanitario	sanitaryo
sexo	sekso
strea	strea
terenonan	terenonan
trese	trese
trucknan	trukknan
votacion	votasyoN
yudando	yudando
Ady	adi
Air	ar
Beatrix	beatriks
Bida	bida
Bucuti	bukuti
Cuminda	kuminda
Danies	danyes
Digicel	dixisel
Distanciamento	distansyamento
Entertainment	entertanment
Francisco	fransisko
Hesus	hesus
MAVO	mavo
Musica	musika
Nobo	nobo
RDA	rda
SMAC	smak
TV	teve
Tampoco	tampoko
Teritorial	teritoryal
Trahadornan	trahadornan
Village	villaxe
Waf	waf
Whatsapp	whatsapp
actualisacion	aktwalisasyoN
art	art
bahada	bahada
baki	baki
beachnan	beaCnan
brasa	brasa
buelo	bwelo
cabesante	kabesante
cobertura	kobertura
conserva	konserva
descarta	deskarta
determinacion	determinasyoN
diaranzon	dyaranzoN
enfrentando	enfrentando
estadonan	estadonan
extenso	ekstenso
fuentenan	fwentenan
innovativo	innovativo
institutonan	institutonan
investigashon	investigaSoN
mashin	maSiN
negosacion	negosasyoN
oracion	orasyoN
organonan	organonan
piscado	piskado
pushi	puSi
respiratorio	respiratoryo
sospecho	sospeCo
supuesto	supwesto
tanda	tanda
tradicion	tradisyoN
traficacion	trafikasyoN
yaris	yaris
Accidente	aksidente
Bandera	bandera
Botica	botika
Casi	kasi
Emergencia	emerxensya
Henriquez	henrikwez
Ken	keN
March	marC
Ministerial	ministeryal
PM	peEm
Post	post
Reclasering	reklasering
Rica	rika
Romano	romano
Saba	saba
Sostenibel	sostenibel
Tabatin	tabatiN
atravez	atravez
bendemento	bendemento
boletin	boletiN
cumplimento	kumplimento
depresion	depresyoN
desastroso	desastroso
disponibilidad	disponibilidad
experticio	ekspertisyo
fianza	fyanza
formanan	formanan
fundacionnan	fundasyonnan
gratitud	gratitud
habilidad	habilidad
honda	honda
ideal	ideal
instrui	instruy
intercambio	interkambyo
intimo	intimo
jama	yama
mercadeo	merkadeo
mitad	mitad
motociclista	motosiklista
nacemento	nasemento
obvio	obvyo
pier	pyer
placer	plaser
provee	prove
resta	resta
rico	riko
salarionan	salaryonan
saldo	saldo
sosega	sosega
suavisa	swavisa
suela	swela
tolera	tolera
train	traN
tranca	tranka
transaccion	transaksyoN
trato	trato
vulnerable	vulnerable
yerba	yerba
zink	zink
Academy	akademi
GDP	gedepe
Hyundai	hyunda
IDEA	idea
Net	net
Nunca	nunka
Organization	organizatyoN
Parce	parse
TUI	tuy
administracion	administrasyoN
agencia	axensya
asociacion	asosyasyoN
avanza	avanza
balornan	balornan
bebi	bebi
berdadero	berdadero
competi	kompeti
cunukero	kunukero
cuponan	kuponan
deliberacion	deliberasyoN
detenidonan	detenidonan
districto	distrikto
download	download
enemigo	enemigo
especial	espesyal
habon	haboN
hogarnan	hogarnan
incorecto	inkorekto
ingreso	ingreso
inhusto	inhusto
magnitud	magnitud
materialnan	materyalnan
matrimonio	matrimonyo
original	orixinal
paspoort	pasport
poderoso	poderoso
precedente	presedente
provoca	provoka
realistico	realistiko
satisfaccion	satisfaksyoN
screen	skreN
sucu	suku
videonan	videonan
Blok	blok
Blvd	beElvede
Business	business
CEDE	sede
CPI	kpi
Gran	graN
Hato	hato
IVA	iva
Shaba	Saba
Sigui	sigy
Triple	triple
alimentacion	alimentasyoN
atraves	atraves
boluntarionan	boluntaryonan
castigonan	kastigonan
cellular	sellular
chevrolet	Cevrolet
compleho	kompleho
conference	konferense
documentacion	dokumentasyoN
dokternan	dokternan
ekipa	ekipa
electronicamente	elektronikamente
estudionan	estudyonan
evaluando	evalwando
flexibilisa	fleksibilisa
funcionario	funsyonaryo
intercambia	interkambya
localmente	lokalmente
machine	maCine
manager	manaxer
manipula	manipula
mentalidad	mentalidad
necesariamente	nesesaryamente
notario	notaryo
numbernan	numbernan
plantacion	plantasyoN
propaganda	propaganda
red	red
regreso	regreso
rescate	reskate
run	ruN
transferencia	transferensya
voz	voz
AUA	awa
Aduana	adwana
DEZHI	dezhi
Es	es
Garage	garaxe
Humano	humano
Mary	mari
Paisnan	pasnan
Refineria	refinerya
Ruiz	ruyz
Service	servise
TOPA	topa
Taekwondo	taekwondo
Trinidad	trinidad
Tropical	tropikal
University	universiti
Washington	waSingtoN
academico	akademiko
ameno	ameno
animalnan	animalnan
aventura	aventura
baila	bala
bordo	bordo
coleccion	koleksyoN
cunukeronan	kunukeronan
dentista	dentista
diversificacion	diversifikasyoN
encamina	enkamina
fatal	fatal
fauna	fauna
gemeente	xemente
grabacion	grabasyoN
hubenil	hubenil
instruccionnan	instruksyonnan
kiermeen	kyermeN
mientrastanto	myentrastanto
optimal	optimal
parcialmente	parsyalmente
pensionadonan	pensyonadonan
peor	peor
plastic	plastik
psicologo	psikologo
recesion	resesyoN
restaura	restaura
retraso	retraso
seriamente	seryamente
shock	Sokk
significante	signifikante
smartphone	smartphone
sufriendo	sufryendo
telefoon	telefoN
uniform	uniform
uzando	uzando
ABC	abk
Aparentemente	aparentemente
Auto	auto
Autoridad	autoridad
Derecho	dereCo
ELMAR	elmar
FM	EfEm
Fase	fase
Halto	halto
Hendenan	hendenan
Joe	yu
Michael	miCael
Onderwijs	onderwes
Peru	peru
Rico	riko
Roadservice	roadservise
Roberto	roberto
Shady	Sadi
Taskforce	taskforse
Teniendo	tenyendo
apropia	apropya
azeta	azeta
boluntad	boluntad
brindando	brindando
buska	buska
camera	kamera
cannabis	kannabis
cargamento	kargamento
circumstancianan	sirkumstansyanan
communidad	kommunidad
conocimento	konosimento
conscientisa	konssyentisa
contagioso	kontaxyoso
continuacion	kontinwasyoN
convence	konvense
creciente	kresyente
desempleo	desempleo
desicion	desisyoN
dignidad	dignidad
discriminacion	diskriminasyoN
doloroso	doloroso
drentando	drentando
expansion	ekspansyoN
ganadornan	ganadornan
graduado	gradwado
impacta	impakta
indocumenta	indokumenta
inspiracion	inspirasyoN
integral	integral
live	live
lock	lokk
miyones	miyones
mutuo	mutwo
nabega	nabega
pata	pata
permanente	permanente
piscadonan	piskadonan
president	president
primordial	primordyal
rebaho	rebaho
reconocemento	rekonosemento
rekisito	rekisito
sorprende	sorprende
stock	stokk
stoel	stul
stof	stof
suministro	suministro
teritorial	teritoryal
trapa	trapa
trimester	trimester
vez	vez
wela	wela
Activo	aktivo
Atrobe	atrobe
Consecuentemente	konsekwentemente
Fort	fort
Huis	huys
Integridad	integridad
Jose	yose
Kia	kya
Linear	linear
Matutino	matutino
Miss	miss
Ricardo	rikardo
accesibel	aksesibel
admira	admira
aerolineanan	aerolineanan
angustia	angustya
bela	bela
combersacionnan	kombersasyonnan
comosifuera	komosifwera
confusion	konfusyoN
conmemora	konmemora
conteo	konteo
costanan	kostanan
deduci	dedusi
desaparece	desaparese
devastador	devastador
electronico	elektroniko
enbes	enbes
encarcela	enkarsela
entretenimento	entretenimento
facilmente	fasilmente
fix	fiks
honesto	honesto
hospitaliza	hospitaliza
increibel	inkrebel
militarnan	militarnan
molestia	molestya
monetario	monetaryo
muda	muda
obhetivo	obhetivo
pool	pol
presidencial	presidensyal
presupuesta	presupwesta
resiliente	resilyente
stabil	stabil
supletorio	supletoryo
tanki	tanki
taxistanan	taksistanan
unit	unit
visibel	visibel
Abogado	abogado
Antes	antes
Baby	babi
Baly	bali
Digital	dixital
Divi	divi
IT	it
Josephine	yosephine
Kavel	kavel
Liber	liber
Metal	metal
Metanan	metanan
Papa	papa
Seccion	seksyoN
Spa単o	spa5o
Tara	tara
Trigt	trigt
Unidad	unidad
Valdes	valdes
Vice	vise
Werleman	werlemaN
Zodiac	zodyak
aclarea	aklarea
adkiri	adkiri
aviacion	avyasyoN
a単adi	a5adi
bos	bos
calculacion	kalkulasyoN
cendi	sendi
cobranza	kobranza
constelacion	konstelasyoN
cuero	kwero
deposito	deposito
desordo	desordo
economicamente	ekonomikamente
epidemia	epidemya
esei	ese
esencia	esensya
eyfo	eyfo
fiestanan	fyestanan
ful	ful
gesto	xesto
hancra	hankra
holo	holo
hubentud	hubentud
interogacion	interogasyoN
kg	kage
luznan	luznan
mercancia	merkansya
metodo	metodo
motorisa	motorisa
negligencia	neglixensya
peaton	peatoN
percela	persela
playa	playa
prestamonan	prestamonan
primordialmente	primordyalmente
proponi	proponi
propuesta	propwesta
recursonan	rekursonan
reemplasa	remplasa
repatriacion	repatryasyoN
respectivamente	respektivamente
seco	seko
significa	signifika
silencio	silensyo
skerpi	skerpi
slachtofferhulp	slaCtofferhulp
splika	splika
superior	superyor
supervisa	supervisa
trauma	trauma
urna	urna
visual	viswal
vooral	voral
Asamblea	asamblea
Cumana	kumana
Cura	kura
Dirks	dirks
Entrada	entrada
Fiesta	fyesta
Francia	fransya
Fun	fuN
HAVA	hava
Jenny	yenni
K嘆rsou	korsow
Mastercard	masterkard
Ministronan	ministronan
Normalmente	normalmente
Olimpico	olimpiko
PPA	ppa
Panama	panama
Parada	parada
Republicano	republikano
Scolnan	skolnan
Shark	Sark
Toezicht	tuziCt
UA	wa
actuacion	aktwasyoN
agradabel	agradabel
asegurado	asegurado
baca	baka
bom	bom
camara	kamara
canalnan	kanalnan
castigabel	kastigabel
comprobante	komprobante
conhunto	konhunto
conservacion	konservasyoN
cortamento	kortamento
corupto	korupto
costumber	kostumber
deadline	deadline
detaya	detaya
diversifica	diversifika
excepcional	ekssepsyonal
exitosamente	eksitosamente
explora	eksplora
extraordinario	ekstraordinaryo
extremo	ekstremo
eybanda	eybanda
felicidad	felisidad
gang	gang
hibe	hibe
humanidad	humanidad
hunta	hunta
instrumentonan	instrumentonan
jetBlue	yet blwe
kavel	kavel
lasonan	lasonan
logico	loxiko
mande	mande
mentor	mentor
ministro	ministro
muhernan	muhernan
obhecion	obhesyoN
plaka	plaka
practico	praktiko
pretende	pretende
privacidad	privasidad
recuperando	rekuperando
rednan	rednan
reflexiona	refleksyona
ricibiendo	risibyendo
rondona	rondona
skina	skina
sobrebibi	sobrebibi
specialistanan	spesyalistanan
tino	tino
tour	towr
transforma	transforma
traspaso	traspaso
traves	traves
Alfonso	alfonso
Antia	antya
Articulo	artikulo
Basa	basa
Bernadina	bernadina
Centraal	sentral
Defensor	defensor
Edwin	edwiN
Mahuma	mahuma
Media	medya
Miembronan	myembronan
Plas	plas
Prins	prins
SCP	Essepe
Sali	sali
Sons	sons
Studiantenan	studyantenan
Taxistanan	taksistanan
Test	test
VRA	vra
alerto	alerto
ansha	anSa
argumento	argumento
automobilistanan	automobilistanan
autorisacion	autorisasyoN
baho	baho
card	kard
cardinal	kardinal
cortesia	kortesya
cria	krya
cruel	krwel
desconfianza	deskonfyanza
desperdicio	desperdisyo
disgusto	disgusto
fisicamente	fisikamente
grafico	grafiko
hero	hero
incorpora	inkorpora
influenza	inflwenza
lamentabel	lamentabel
libremente	libremente
lidera	lidera
mandato	mandato
menu	menu
pasashi	pasaSi
pasion	pasyoN
positivismo	positivismo
reemplaza	remplaza
reglamento	reglamento
regulacion	regulasyoN
representando	representando
rumannan	rumannan
spa単o	spa5o
super	super
suspende	suspende
suspendi	suspendi
task	task
teritorio	teritoryo
testigonan	testigonan
texto	teksto
tips	tips
trailer	traler
tripulacion	tripulasyoN
ubica	ubika
worry	worri
AM	am
Abo	abo
Abuso	abuso
Alemania	alemanya
Awendia	awendya
Balentina	balentina
Bay	bay
Bijstand	bestand
DRH	deErha
Dam	dam
Departamentonan	departamentonan
Educacion	edukasyoN
Haci	hasi
Henk	henk
I	i
Inmediatamente	inmedyatamente
Inspectie	inspektye
Luna	luna
Miembro	myembro
Organizacion	organizasyoN
Palabra	palabra
Poco	poko
REOI	reoy
Ruben	rubeN
Solutions	solutyons
Stef	stef
Tchong	tCong
Teishi	teSi
Velasquez	velaskwez
Wilhelmina	wilhelmina
alaves	alaves
amienda	amyenda
aresta	aresta
automobilista	automobilista
autor	autor
avance	avanse
baile	bale
botter	botter
cautela	kautela
charla	Carla
choller	Coller
code	kode
colga	kolga
comparacion	komparasyoN
compa単a	kompa5a
complicacion	komplikasyoN
declaracionnan	deklarasyonnan
dividi	dividi
drama	drama
excelente	eksselente
frecuentemente	frekwentemente
fuertemente	fwertemente
holor	holor
huramenta	huramenta
infunda	infunda
investigando	investigando
kilometer	kilometer
logronan	logronan
luchando	luCando
machete	maCete
manipulacion	manipulasyoN
metodonan	metodonan
optimista	optimista
paki	paki
pas	pas
practicanan	praktikanan
realisacion	realisasyoN
renombra	renombra
restauracion	restaurasyoN
sagrado	sagrado
score	skore
seminario	seminaryo
siglo	siglo
sostenibilidad	sostenibilidad
standard	standard
sumo	sumo
supuestamente	supwestamente
tan	taN
unanimamente	unanimamente
wiel	wyel
CEA	sea
Catiri	katiri
Diego	dyego
Directora	direktora
Erasmus	erasmus
Eva	eva
Financiero	finansyero
Hernandez	hernandez
Horcan	horkaN
ID	id
IMF	imf
Intensive	intensive
Los	los
Nisbet	nisbet
PG	pege
Sur	sur
Unabes	unabes
United	united
Valero	valero
Willem	willem
adelanto	adelanto
aloca	aloka
artificial	artifisyal
atletanan	atletanan
bais	bas
boa	boa
call	kall
caos	kaos
circunstancia	sirkunstansya
circunstancianan	sirkunstansyanan
ciudadnan	syudadnan
confrontacion	konfrontasyoN
consensus	konsensus
datos	datos
decadanan	dekadanan
del	del
delitonan	delitonan
eficiencia	efisyensya
emocion	emosyoN
entusiasmo	entusyasmo
eror	eror
esfuerzonan	esfwerzonan
evidencia	evidensya
exportacion	eksportasyoN
fayo	fayo
focus	fokus
huicio	huysyo
incumplimento	inkumplimento
interactivo	interaktivo
interesado	interesado
interesadonan	interesadonan
kwihi	kwihi
manteniendo	mantenyendo
pensando	pensando
per	per
prolongacion	prolongasyoN
reclamo	reklamo
redobla	redobla
regala	regala
regarda	regarda
responde	responde
rifa	rifa
scrap	skrap
seleccion	seleksyoN
sponsor	sponsor
staf	staf
supermercadonan	supermerkadonan
transicion	transisyoN
vacunacion	vakunasyoN
version	versyoN
ATM	atm
Alexander	aleksander
Anne	anne
Anthony	anthoni
Caminda	kaminda
Card	kard
Cratz	kratz
Cual	kwal
Dirksz	dirksz
Eustatius	ewstatyus
Evita	evita
Gobernacion	gobernasyoN
Henter	henter
Hubentud	hubentud
Kudawecha	kudaweCa
Local	lokal
Man	maN
Masnoticia	masnotisya
MetaCorp	meta korp
Otronan	otronan
PAHO	paho
Pablo	pablo
Pedagogico	pedagoxiko
Placa	plaka
Rotary	rotari
Salazar	salazar
Tempo	tempo
Tratado	tratado
Venezolanonan	venezolanonan
actualisa	aktwalisa
benidero	benidero
bestianan	bestyanan
brainstorm	branstorm
bukinan	bukinan
center	senter
circulacion	sirkulasyoN
comproba	komproba
consenshi	konsenSi
costoso	kostoso
cuminsamento	kuminsamento
cursonan	kursonan
delivery	deliveri
dera	dera
desgracia	desgrasya
despedida	despedida
distribui	distribuy
divisa	divisa
drive	drive
ehemplar	ehemplar
embargo	embargo
empresario	empresaryo
encuentronan	enkwentronan
flexibilisacion	fleksibilisasyoN
flora	flora
fortalece	fortalese
gravedad	gravedad
imagennan	imaxennan
inaceptabel	inaseptabel
indirecto	indirekto
innecesario	innesesaryo
inseguridad	inseguridad
involucra	involukra
join	yoyN
landa	landa
meymey	meymey
monton	montoN
motivacion	motivasyoN
negosha	negoSa
oxigeno	oksixeno
pantaya	pantaya
pareu	parew
plazo	plazo
precario	prekaryo
radar	radar
razzia	razzya
resisti	resisti
resort	resort
respecto	respekto
reta	reta
rio	ryo
rudia	rudya
semanal	semanal
subsidia	subsidya
teoria	teorya
tiendanan	tyendanan
tip	tip
tratando	tratando
usuarionan	uswaryonan
Americano	amerikano
B	be
Belgica	belxika
Cualkier	kwalkyer
Desiree	desire
Fin	fiN
Haiti	hati
Jennifer	yennifer
Kapel	kapel
Kende	kende
Kleuterschool	klewtersCol
Landsbesluit	landsbesluyt
Landsrecherche	landsreCerCe
Lee	le
Management	manaxement
Meijer	meyer
Ministerraad	ministerrad
Rincon	rinkoN
Rond	rond
Services	servises
Supervision	supervisyoN
Suriname	suriname
Una	una
Veer	ver
Volksgezondheid	volksxezondhed
Youth	yowth
anciano	ansyano
apela	apela
areglonan	areglonan
bishitando	biSitando
bleki	bleki
buelonan	bwelonan
circulando	sirkulando
circular	sirkular
colectivo	kolektivo
consecuentemente	konsekwentemente
containernan	kontanernan
controlando	kontrolando
coordina	kordina
dengue	denge
desconocidonan	deskonosidonan
descuento	deskwento
destinacionnan	destinasyonnan
detenshon	detenSoN
dirigentenan	dirixentenan
disgusta	disgusta
dispone	dispone
disposicion	disposisyoN
donjo	donyo
efectua	efektwa
escogencia	eskoxensya
factura	faktura
fomenta	fomenta
gram	gram
gym	xim
ignora	ignora
inmenso	inmenso
interesnan	interesnan
internamente	internamente
lamentable	lamentable
liter	liter
logrando	logrando
mayan	mayaN
mire	mire
obligacionnan	obligasyonnan
ofreci	ofresi
pesca	peska
planeta	planeta
posesion	posesyoN
proyeccionnan	proyeksyonnan
residencia	residensya
sembra	sembra
sentimentonan	sentimentonan
substancial	substansyal
teatro	teatro
tiplijn	tipleN
traduci	tradusi
trankilo	trankilo
vloer	vlur
voluntarionan	voluntaryonan
Adicionalmente	adisyonalmente
Afdeling	afdeling
Antonio	antonyo
Arqueologico	arkweoloxiko
Aruparking	aruparking
Brasil	brasil
CDC	sedese
Ciencia	syensya
Constitucion	konstitusyoN
Dande	dande
Daniel	danyel
Dokter	dokter
Domingo	domingo
Dus	dus
Esun	esuN
Hapon	hapoN
Hogeschool	hoxesCol
IBISA	ibisa
Interino	interino
Kier	kyer
Luz	luz
MB	Embe
Maske	maske
Mental	mental
Mervin	merviN
Mil	mil
Miljard	milyard
Muhe	muhe
Nederland	nederland
Obama	obama
Orman	ormaN
Planea	planea
Politie	politye
Rotterdam	rotterdam
Sallestraat	sallestrat
Scheepvaart	sCepvart
Specialmente	spesyalmente
Tanten	tanteN
Tarabana	tarabana
Tormenta	tormenta
Tuma	tuma
Turistanan	turistanan
Weststraat	weststrat
absoluto	absoluto
accent	aksent
acomoda	akomoda
acomodacion	akomodasyoN
acompa単ante	akompa5ante
alrespecto	alrespekto
ampliacion	amplyasyoN
apart	apart
asilo	asilo
ateriza	ateriza
autorisa	autorisa
bataya	bataya
bateria	baterya
ba単o	ba5o
calma	kalma
cantante	kantante
cartanan	kartanan
castiga	kastiga
chance	Canse
circulo	sirkulo
comestibel	komestibel
confiabel	konfyabel
cunucu	kunuku
dam	dam
dat	dat
debil	debil
descripcion	deskripsyoN
detencionnan	detensyonnan
digitalisa	dixitalisa
distribucion	distribusyoN
down	dowN
electricidad	elektrisidad
eroneo	eroneo
fila	fila
firmamento	firmamento
fraude	fraude
frecuente	frekwente
gradicimento	gradisimento
habriendo	habryendo
hari	hari
huesped	hwesped
huez	hwez
humilde	humilde
imagina	imaxina
inmunologico	inmunoloxiko
integro	integro
inventa	inventa
klasnan	klasnan
laso	laso
mapa	mapa
medaya	medaya
mete	mete
motoriza	motoriza
obstaculo	obstakulo
orarionan	oraryonan
organizacionnan	organizasyonnan
parehanan	parehanan
parkeer	parker
permisonan	permisonan
pick	pikk
piki	piki
planifica	planifika
pos	pos
protehi	protehi
receta	reseta
rechaza	reCaza
reforza	reforza
rekesitonan	rekesitonan
reservanan	reservanan
semi	semi
sucursal	sukursal
sugerencia	suxerensya
tecnologico	teknoloxiko
tristeza	tristeza
veredicto	veredikto
wayanan	wayanan
yame	yame
yude	yude
ARUBIANO	arubyano
Alaves	alaves
Alivio	alivyo
Aviacion	avyasyoN
Avianca	avyanka
Bernabela	bernabela
Catolico	katoliko
Colorado	kolorado
Dicon	dikoN
EPB	epb
Empleadonan	empleadonan
FDA	fda
GNC	geEnse
Haime	hame
Hildward	hildward
Joan	yoaN
Militair	militar
Nivel	nivel
Obra	obra
Parti	parti
Pastoor	pastor
Quandt	kwandt
Rapport	rapport
Representantenan	representantenan
Resultado	resultado
Rodgers	rodxers
SDGs	EsdegeEs
SER	ser
Slachtofferhulp	slaCtofferhulp
Sport	sport
UPA	upa
West	west
acera	asera
activamente	aktivamente
agredi	agredi
agresion	agresyoN
alegre	alegre
alimento	alimento
anticurpa	antikurpa
atraccion	atraksyoN
bringando	bringando
bruha	bruha
consecutivo	konsekutivo
contestanan	kontestanan
crusa	krusa
culpabel	kulpabel
damanan	damanan
delinea	delinea
diagnostico	dyagnostiko
directornan	direktornan
discusionnan	diskusyonnan
euro	ewro
exclui	ekskluy
fada	fada
finansa	finansa
food	fod
formularionan	formularyonan
hechonan	heConan
hibando	hibando
horizonte	horizonte
independencia	independensya
indesea	indesea
inicialmente	inisyalmente
inmunidad	inmunidad
inocente	inosente
invitado	invitado
juda	yuda
km	kaEm
lancha	lanCa
landamento	landamento
lectornan	lektornan
limpieza	limpyeza
listra	listra
loco	loko
mahos	mahos
marino	marino
medicinal	medisinal
meimei	meme
nombernan	nombernan
ok	ok
opcionnan	opsyonnan
panorama	panorama
payroll	payroll
percepcion	persepsyoN
pista	pista
reconstruccion	rekonstruksyoN
reforsa	reforsa
sero	sero
socionan	sosyonan
staff	staff
stichting	stiCting
storianan	storyanan
titula	titula
tosamento	tosamento
tristesa	tristesa
turbulencia	turbulensya
usuario	uswaryo
votado	votado
waya	waya
yamado	yamado
ABV	abv
ADR	adr
ATV	atv
AVB	avb
Alavez	alavez
Avestruz	avestruz
Basico	basiko
Cacho	kaCo
Conforme	konforme
Contrario	kontraryo
Dilanti	dilanti
Dominicano	dominikano
Escudero	eskudero
Fast	fast
Fonds	fonds
Give	xive
Guillfred	gyllfred
Hotelnan	hotelnan
Libertador	libertador
Marketing	marketing
Medidanan	medidanan
OK	ok
PDVSA	pedvsa
PR	peEr
Page	paxe
Persona	persona
Ports	ports
Pronto	pronto
RIVM	rivm
Recien	resyeN
Rijksministerraad	reksministerrad
Sanicolas	sanikolas
Segunda	segunda
Tobago	tobago
Trahadonan	trahadonan
Weg	weg
WhatsApp	whats app
alternativo	alternativo
balie	balye
bendicion	bendisyoN
bendiciona	bendisyona
bono	bono
bringamento	bringamento
camindanan	kamindanan
clausura	klausura
click	klikk
confrontando	konfrontando
continente	kontinente
coordinador	kordinador
corespondiente	korespondyente
credibilidad	kredibilidad
debernan	debernan
destaca	destaka
detayes	detayes
digitalisacion	dixitalisasyoN
divisas	divisas
empuhe	empuhe
fam	fam
fechanan	feCanan
figura	figura
force	forse
funcionarionan	funsyonaryonan
genero	xenero
habrimento	habrimento
heeft	heft
intentonan	intentonan
invalido	invalido
keur	kewr
marcha	marCa
mision	misyoN
muy	muy
negosacionnan	negosasyonnan
nombracion	nombrasyoN
ofertanan	ofertanan
panel	panel
particularmente	partikularmente
perfecto	perfekto
piscanan	piskanan
ponencianan	ponensyanan
preserva	preserva
prizon	prizoN
quizas	kwizas
referente	referente
reporta	reporta
resa	resa
saludable	saludable
seccionnan	seksyonnan
sosodiendo	sosodyendo
sub	sub
testing	testing
treciendo	tresyendo
work	work
Arashi	araSi
Astec	astek
Autoridadnan	autoridadnan
BAZV	bazv
Basora	basora
Bestuur	bestir
Buki	buki
California	kalifornya
Cft	seEfte
Chevrolet	Cevrolet
Child	Cild
Comunicacion	komunikasyoN
Dentro	dentro
Djis	jis
Electoral	elektoral
Esta	esta
Exprodesk	eksprodesk
Filomena	filomena
George	xeorxe
Google	gogle
Guardian	gwardyaN
LabHOH	lab hoh
Lenny	lenni
Mes	mes
Miles	miles
Mini	mini
Moko	moko
Nada	nada
Norte	norte
Plataforma	plataforma
Politico	politiko
Prof	prof
Royal	royal
SEPPA	seppa
Senado	senado
Tienda	tyenda
Tratamento	tratamento
UNESCO	unesko
Valdez	valdez
Visa	visa
Yaris	yaris
aan	aN
adopta	adopta
afectando	afektando
artistico	artistiko
asbest	asbest
asta	asta
ata	ata
audiencia	audyensya
biahamento	byahamento
blokea	blokea
boei	buy
campa単anan	kampa5anan
capa	kapa
capacita	kapasita
cayanan	kayanan
cien	syeN
clinica	klinika
complice	komplise
constante	konstante
contacta	kontakta
crudo	krudo
desesperacion	desesperasyoN
desplega	desplega
diferencianan	diferensyanan
elementonan	elementonan
elogio	eloxyo
enfermedadnan	enfermedadnan
ensera	ensera
entidadnan	entidadnan
envez	envez
felicitacion	felisitasyoN
frena	frena
fuel	fwel
gradua	gradwa
heroe	heru
inteligencia	intelixensya
interveni	interveni
kaso	kaso
lage	laxe
lansamento	lansamento
luhoso	luhoso
moratorio	moratoryo
netamente	netamente
nivelnan	nivelnan
obviamente	obvyamente
ocacion	okasyoN
origina	orixina
plastico	plastiko
pobresa	pobresa
productivo	produktivo
profundamente	profundamente
rasa	rasa
raspa	raspa
saluda	saluda
session	sessyoN
set	set
sosteni	sosteni
studio	studyo
tosa	tosa
yamadanan	yamadanan
Argentina	arxentina
Arubalening	arubalening
Awg	awg
Back	bakk
Bao	bao
Bin	biN
Booshi	boSi
Cliente	klyente
Colombiano	kolombyano
Conferencia	konferensya
Cumpra	kumpra
David	david
Da単o	da5o
Derechonan	dereConan
Diesel	dyesel
Docternan	dokternan
Edward	edward
Elite	elite
End	end
Finansas	finansas
Ford	ford
Gomez	gomez
Grandinan	grandinan
HTC	hatese
House	howse
Illes	illes
Instancia	instansya
Juffrouw	yuffroww
King	king
Luis	luys
Mario	maryo
Mediador	medyador
Milieu	milyew
Mundialmente	mundyalmente
Pandemia	pandemya
Pfizer	pfizer
Rotaract	rotarakt
Siendo	syendo
Sosten	sosteN
TUR	tur
Tata	tata
Telearuba	telearuba
Telefon	telefoN
Tevreden	tevredeN
Town	towN
Unit	unit
WVB	wevebe
Zaken	zakeN
Zuid	zuyd
advies	advyes
ambtenaarnan	ambtenarnan
amistad	amistad
ansiedad	ansyedad
aparte	aparte
asigna	asigna
atraca	atraka
awasero	awasero
balora	balora
biahenan	byahenan
bi単a	bi5a
bofon	bofoN
by	bi
cantica	kantika
cena	sena
certifica	sertifika
confidencial	konfidensyal
contamina	kontamina
criteria	kriterya
debati	debati
delegacion	delegasyoN
dependiendo	dependyendo
diabetico	dyabetiko
diagnostica	dyagnostika
djies	jyes
duidelijk	duydelek
eerste	erste
ekiponan	ekiponan
exclusivo	eksklusivo
externo	eksterno
higiene	hixyene
homenahe	homenahe
igualdad	igwaldad
impresiona	impresyona
insinua	insinwa
institucion	institusyoN
interpreta	interpreta
interpretacion	interpretasyoN
intervencion	intervensyoN
kibrando	kibrando
kustwacht	kustwaCt
medicina	medisina
miseria	miserya
modera	modera
monumentonan	monumentonan
nombramento	nombramento
nomina	nomina
ohala	ohala
operadornan	operadornan
originalmente	orixinalmente
park	park
parkeerplaats	parkerplats
partners	partners
piscamento	piskamento
plaso	plaso
productor	produktor
prometedor	prometedor
reaccionnan	reaksyonnan
restriccionnan	restriksyonnan
sapato	sapato
seconde	sekonde
secuestra	sekwestra
spearfishing	spearfiSing
stul	stul
subiendo	subyendo
sushedad	suSedad
tawatin	tawatiN
temor	temor
tine	tine
track	trakk
unabes	unabes
vandalismo	vandalismo
verbal	verbal
votadonan	votadonan
wordu	wordu
zonido	zonido
Abao	abao
Anual	anwal
Arutram	arutram
Basta	basta
Bosman	bosmaN
Bou	bow
Cabay	kabay
Cantidad	kantidad
Casa	kasa
Day	day
Desk	desk
Development	development
Diabetes	dyabetes
Docentenan	dosentenan
Duna	duna
Ecuador	ekwador
Eleccion	eleksyoN
Gonzalez	gonzalez
Historia	historya
Hitler	hitler
Hulandesnan	hulandesnan
Hyatt	hyatt
Internet	internet
Loonsubsidie	lonsubsidye
Lucia	lusya
Malmok	malmok
Mangel	manxel
Monumentenfonds	monumentenfonds
Natuur	natir
Pavia	pavya
Pickup	pikkup
Prijs	pres
Protocol	protokol
RST	ErEste
Region	rexyoN
Regreso	regreso
RevPAR	rev par
Sasakiweg	sasakiweg
Segundo	segundo
actuando	aktwando
alimenta	alimenta
anti	anti
autorizacion	autorizasyoN
barcode	barkode
bebemento	bebemento
bonus	bonus
cabalmente	kabalmente
cambernan	kambernan
capitulo	kapitulo
cargo	kargo
categorianan	kategoryanan
cel	sel
clarifica	klarifika
concentracion	konsentrasyoN
condecoracion	kondekorasyoN
continuidad	kontinuydad
cosecha	koseCa
cubo	kubo
danjo	danyo
dependiente	dependyente
die	dye
diesel	dyesel
dunabo	dunabo
elmar	elmar
elogia	eloxya
estimulo	estimulo
expectativa	ekspektativa
exponi	eksponi
fotografia	fotografya
gradual	gradwal
herido	herido
himno	himno
hobenan	hobenan
horeca	horeka
hospitalisa	hospitalisa
huurdo	hirdo
inciso	insiso
industrial	industryal
informando	informando
intermediacion	intermedyasyoN
kaminda	kaminda
klapchi	klapCi
libera	libera
liga	liga
literatura	literatura
masterplan	masterplaN
migracion	migrasyoN
morde	morde
operando	operando
organisando	organisando
paro	paro
parokia	parokya
participando	partisipando
personan	personan
placentero	plasentero
pleito	pleto
premionan	premyonan
preparatorio	preparatoryo
preso	preso
prioridadnan	pryoridadnan
prosperidad	prosperidad
rango	rango
razon	razoN
recibo	resibo
rehen	reheN
religion	relixyoN
resistencia	resistensya
rumor	rumor
sacrifica	sakrifika
segunda	segunda
siguransa	siguransa
slip	slip
sobrevivencia	sobrevivensya
socio	sosyo
sostenible	sostenible
spierta	spyerta
spirito	spirito
stabilisa	stabilisa
stapnan	stapnan
studiando	studyando
substancia	substansya
sucesonan	susesonan
systema	sistema
tardi	tardi
transportacion	transportasyoN
tratadonan	tratadonan
webo	webo
wowonan	wowonan
ALV	alv
Atlantico	atlantiko
BES	bes
Bus	bus
Cunucu	kunuku
Dificultad	difikultad
Diripiente	diripyente
Ela	ela
Emmastraat	emmastrat
Falcon	falkoN
Falta	falta
Fe	fe
Gamma	gamma
Gerencia	xerensya
Jaburibari	yaburibari
Karibe	karibe
LNG	ElEnge
Lagoen	laguN
Logicamente	loxikamente
Marino	marino
Masterplan	masterplaN
Mr	EmEr
Normal	normal
OM	om
OMS	oms
Piet	pyet
Prueba	prweba
RCA	rka
Rector	rektor
Recurso	rekurso
Sanders	sanders
Schakel	sCakel
Schiphol	sCiphol
Schwengle	sCwengle
Security	sekuriti
Specialista	spesyalista
Store	store
Suzuki	suzuki
Taxista	taksista
Trabou	trabow
WiFi	wi fi
Zoutman	zowtmaN
abogadonan	abogadonan
aclaria	aklarya
adictonan	adiktonan
afdeling	afdeling
alomenos	alomenos
armanan	armanan
aseguradonan	aseguradonan
asombra	asombra
at	at
atleta	atleta
avionnan	avyonnan
a単as	a5as
best	best
biaheronan	byaheronan
borchinan	borCinan
campus	kampus
cari単o	kari5o
celnan	selnan
componente	komponente
comunista	komunista
convoca	konvoka
criadero	kryadero
cruza	kruza
cuidadano	kuydadano
da単ino	da5ino
dede	dede
diplomatico	diplomatiko
documenta	dokumenta
dudoso	dudoso
dunadonan	dunadonan
especie	espesye
expresionnan	ekspresyonnan
feedback	fedbakk
handsanitizer	handsanitizer
hemchi	hemCi
hoga	hoga
hospitalidad	hospitalidad
ilegalnan	ilegalnan
implica	implika
incinerator	insinerator
informashon	informaSoN
intencionalmente	intensyonalmente
iresponsabel	iresponsabel
justicia	yustisya
kleuter	klewter
lastra	lastra
lema	lema
logicamente	loxikamente
mandatarionan	mandataryonan
manual	manwal
nochi	noCi
ofreciendo	ofresyendo
opone	opone
organizadornan	organizadornan
parse	parse
persecucion	persekusyoN
piek	pyek
plamando	plamando
pobreza	pobreza
progresa	progresa
psychiater	psiCyater
reglamenta	reglamenta
reino	reno
relaha	relaha
restructura	restruktura
sacando	sakando
sancion	sansyoN
selecta	selekta
sensacion	sensasyoN
sercania	serkanya
sker	sker
software	software
suave	swave
superficie	superfisye
take	take
tantisimo	tantisimo
teme	teme
temporario	temporaryo
yamando	yamando
APFA	apfa
ARA	ara
Al	al
Art	art
Arte	arte
Biento	byento
Boegoeroei	buguruy
Bond	bond
CDA	kda
Caso	kaso
Commissie	kommissye
Congreso	kongreso
Cria	krya
Cruise	kruyse
Curason	kurasoN
Examen	eksameN
Famianan	famyanan
Feliz	feliz
Flamingo	flamingo
Frans	frans
Gobiernonan	gobyernonan
Groot	grot
Habitantenan	habitantenan
Hoo	ho
Hose	hose
Imelda	imelda
Importacion	importasyoN
Inmigracion	inmigrasyoN
Interact	interakt
Kong	kong
Laba	laba
Laboral	laboral
Leo	leo
Lito	lito
Live	live
Lottery	lotteri
NOS	nos
Nicolaas	nikolas
Ocean	oseaN
Ohala	ohala
Palo	palo
Pita	pita
Pro	pro
Qredits	kredits
Reunion	rewnyoN
Ritz	ritz
Seguridad	seguridad
Sta	sta
State	state
Super	super
Tumba	tumba
Veterinaire	veterinare
Well	well
Women	womeN
Wuhan	wuhaN
abusonan	abusonan
aceptabel	aseptabel
acogida	akoxida
adhunto	adhunto
alternativanan	alternativanan
aproximadamente	aproksimadamente
aresto	aresto
atacha	ataCa
blokia	blokya
box	boks
bureau	bureau
cancelacion	kanselasyoN
cancionnan	kansyonnan
carbon	karboN
castigable	kastigable
cerebro	serebro
cielo	syelo
ciencia	syensya
cientificonan	syentifikonan
coach	koaC
coba	koba
cognitivo	kognitivo
combatimento	kombatimento
combustibel	kombustibel
competente	kompetente
concientizacion	konsyentizasyoN
conocirnan	konosirnan
considerabel	konsiderabel
considerablemente	konsiderablemente
debolbe	debolbe
decisionan	desisyonan
despacha	despaCa
dirigente	dirixente
division	divisyoN
documentario	dokumentaryo
dramatico	dramatiko
ehecutivonan	ehekutivonan
ei	e
elemento	elemento
empodera	empodera
enfermeronan	enfermeronan
entendi	entendi
escohe	eskohe
estrictamente	estriktamente
fiel	fyel
fit	fit
fragil	fraxil
gali単a	gali5a
gritonan	gritonan
hayanan	hayanan
hora	hora
inaugura	inaugura
individuo	individwo
inkomstenbelasting	inkomstenbelasting
instalacionnan	instalasyonnan
intenso	intenso
interior	interyor
intrankilidad	intrankilidad
investigadornan	investigadornan
jeep	yep
ke	ke
kerstboom	kerstbom
kitando	kitando
laboratorionan	laboratoryonan
locura	lokura
lote	lote
mamanan	mamanan
management	manaxement
met	met
multitud	multitud
negociando	negosyando
netto	netto
niet	nyet
nificacion	nifikasyoN
observacion	observasyoN
ocaciona	okasyona
odio	odyo
opleiding	opleding
oranje	oranye
perseverancia	perseveransya
personalnan	personalnan
piesa	pyesa
pintura	pintura
pionero	pyonero
placanan	plakanan
primi	primi
pronosticonan	pronostikonan
propietario	propyetaryo
recorido	rekorido
refugiado	refuxyado
religioso	relixyoso
resona	resona
rijkswet	rekswet
sabi	sabi
sabiendo	sabyendo
segura	segura
sesionnan	sesyonnan
sex	seks
se単alnan	se5alnan
silencia	silensya
simbolo	simbolo
sonido	sonido
soporta	soporta
stage	staxe
suzuki	suzuki
tennis	tennis
tent	tent
territorial	territoryal
trastorno	trastorno
turtuga	turtuga
unavez	unavez
valve	valve
viaheronan	vyaheronan
weso	weso
AIDS	ads
BOB	bob
Britania	britanya
Burger	burxer
CAO	kao
Casnan	kasnan
Conchi	konCi
Condecoracion	kondekorasyoN
DTP	detepe
Debit	debit
Deportivo	deportivo
Dushi	duSi
ED	ed
Edad	edad
Eddie	eddye
Entiteit	entitet
Ex	eks
Excelencia	eksselensya
Exxon	eksksoN
Formacion	formasyoN
HAVO	havo
Haciendo	hasyendo
Hamas	hamas
Henny	henni
Hobennan	hobennan
Honda	honda
IBiSA	i bi sa
Koopmans	kopmans
Latin	latiN
Liliana	lilyana
Lucky	lukki
Ma	ma
Maestro	maestro
Mitsubishi	mitsubiSi
Negoshinan	negoSinan
Ocupacion	okupasyoN
Officer	offiser
Penal	penal
Procurador	prokurador
Quanten	kwanteN
Redaccion	redaksyoN
Relacionnan	relasyonnan
Rode	rode
Sousa	sowsa
Tours	towrs
Trade	trade
Unico	uniko
Voogdijraad	vogderad
Wout	wowt
Young	yowng
aborda	aborda
accentua	aksentwa
accepta	aksepta
arubiano	arubyano
autobus	autobus
auxilio	auksilyo
balance	balanse
balans	balans
barnan	barnan
bestuur	bestir
cabay	kabay
cambiando	kambyando
cent	sent
chekeo	Cekeo
chiquito	Cikwito
colegio	kolexyo
comisario	komisaryo
concientisacion	konsyentisasyoN
contaminacion	kontaminasyoN
cortina	kortina
criterianan	kriteryanan
cuarto	kwarto
cube	kube
damnan	damnan
desafio	desafyo
direct	direkt
distincion	distinsyoN
dobel	dobel
doctor	doktor
efectividad	efektividad
empresarial	empresaryal
entretene	entretene
eseynan	eseynan
excusa	ekskusa
ford	ford
habilidadnan	habilidadnan
hygiena	hixyena
illegal	illegal
imigracion	imigrasyoN
impedi	impedi
imponi	imponi
innova	innova
insulta	insulta
kap	kap
kleuterschool	klewtersCol
lamper	lamper
laptop	laptop
lokaal	lokal
medianan	medyanan
muhenan	muhenan
numa	numa
obheto	obheto
obranan	obranan
ocupante	okupante
opina	opina
optimismo	optimismo
pacientnan	pasyentnan
paramediconan	paramedikonan
parcial	parsyal
pase	pase
patient	patyent
pensionado	pensyonado
plus	plus
preferi	preferi
preliminar	preliminar
primanan	primanan
proceder	proseder
productornan	produktornan
protegi	protexi
refuerzo	refwerzo
reservacion	reservasyoN
restitucion	restitusyoN
ritmo	ritmo
scooter	skoter
sede	sede
significativo	signifikativo
signo	signo
sobresali	sobresali
stabiel	stabyel
sticker	stikker
sucursalnan	sukursalnan
sunchi	sunCi
technico	teCniko
tram	tram
trapi	trapi
verf	verf
victoria	viktorya
嘆f	of
ASTEC	astek
Alberto	alberto
Amigo	amigo
Asistencia	asistensya
Atardi	atardi
Best	best
Boekenfonds	bukenfonds
Bogota	bogota
Campa単a	kampa5a
Canal	kanal
Cancer	kanser
Caracas	karakas
Carlton	karltoN
Cerca	serka
Challenge	Callenxe
Creek	krek
DCA	dka
DI	di
Delivery	deliveri
Democracia	demokrasya
Funeral	funeral
Genser	xenser
Governance	governanse
Grecia	gresya
Hospice	hospise
Hubert	hubert
II	dos
IPKO	ipko
Imigracion	imigrasyoN
Innovacion	innovasyoN
Islanan	islanan
Italiano	italyano
Klab辿r	klaber
Ladronnan	ladronnan
Lancer	lanser
Latinoamerica	latinoamerika
Leerorkest	lerorkest
Lounge	lownxe
Luydens	luydens
Maestronan	maestronan
Marinierskazerne	marinyerskazerne
Melvin	melviN
Momento	momento
Naturalesa	naturalesa
News	news
Nicole	nikole
Notario	notaryo
Orden	ordeN
Paramediconan	paramedikonan
Parokia	parokya
Pastor	pastor
Pone	pone
Problema	problema
ROPV	ropv
Radio	radyo
Ryan	ryaN
Sahara	sahara
Shiribana	Siribana
Siguiendo	sigyendo
Sky	ski
Step	step
Tecnologia	teknoloxya
Theo	theo
WGK	wegeka
Wind	wind
Yama	yama
Yarzagaray	yarzagaray
abismo	abismo
abusador	abusador
aceptable	aseptable
acusado	akusado
admision	admisyoN
ambiental	ambyental
amistadnan	amistadnan
anima	anima
anualmente	anwalmente
anula	anula
aplicable	aplikable
aplicando	aplikando
aplicante	aplikante
atakenan	atakenan
atrasa	atrasa
ausencia	ausensya
automatico	automatiko
balente	balente
bentaha	bentaha
bij	be
biodiversidad	byodiversidad
biologico	byoloxiko
bishitanan	biSitanan
boluntariamente	boluntaryamente
bonbini	bonbini
brigada	brigada
cabey	kabey
caidanan	kadanan
calculacionnan	kalkulasyonnan
campeonato	kampeonato
capita	kapita
certificacion	sertifikasyoN
cluster	kluster
comentarionan	komentaryonan
comite	komite
conose	konose
conseheronan	konseheronan
consumidornan	konsumidornan
contrae	kontrae
convenio	konvenyo
converti	konverti
coordinacion	kordinasyoN
culminacion	kulminasyoN
custuma	kustuma
decente	desente
decir	desir
demostrando	demostrando
desespera	desespera
diez	dyez
digitalmente	dixitalmente
drief	dryef
entama	entama
fabuloso	fabuloso
fast	fast
fiansanan	fyansanan
filma	filma
finalisando	finalisando
formalisa	formalisa
formando	formando
foto	foto
garoshi	garoSi
generalmente	xeneralmente
gusto	gusto
harpun	harpuN
helpdesk	helpdesk
hermentnan	hermentnan
iPad	i pad
imprimi	imprimi
incansabel	inkansabel
indigna	indigna
infantil	infantil
inflacion	inflasyoN
inkietud	inkyetud
instructornan	instruktornan
intacto	intakto
intensifica	intensifika
invitadonan	invitadonan
kimico	kimiko
kontakto	kontakto
landsbesluit	landsbesluyt
lechi	leCi
lector	lektor
listanan	listanan
localiza	lokaliza
loonbelasting	lonbelasting
luho	luho
maleta	maleta
mandando	mandando
mangel	manxel
maniobra	manyobra
meneer	mener
mobiliza	mobiliza
normalisa	normalisa
om	om
oost	ost
out	owt
paraliza	paraliza
plataformanan	plataformanan
porfabor	porfabor
posecion	posesyoN
preis	pres
presentacionnan	presentasyonnan
psikiatra	psikyatra
rate	rate
recherchenan	reCerCenan
reciente	resyente
rector	rektor
referendum	referendum
reflexion	refleksyoN
respaldo	respaldo
respectivo	respektivo
restart	restart
rooi	roy
santana	santana
scarcedad	skarsedad
severamente	severamente
simple	simple
solicitud	solisitud
specializa	spesyaliza
spiel	spyel
stranheronan	stranheronan
tardansa	tardansa
tempu	tempu
testimonio	testimonyo
time	time
titular	titular
trahe	trahe
transport	transport
turbulento	turbulento
vuurwerk	virwerk
zwaai	zway
Aldrich	aldriC
Anuesca	anweska
BER	ber
BFTO	bfto
Bahamas	bahamas
Bishita	biSita
Cambio	kambyo
Coach	koaC
Considerando	konsiderando
Contraloria	kontralorya
Coronel	koronel
Cuida	kuyda
Democrats	demokrats
Diagnostico	dyagnostiko
Edjean	ejeaN
Eerste	erste
Embahador	embahador
Empresanan	empresanan
Hendrikstraat	hendrikstrat
IPTV	iptv
Influenza	inflwenza
Islands	islands
Ivo	ivo
Jairo	yaro
Juliana	yulyana
Kibaima	kibama
Korea	korea
Laura	laura
Leadership	leaderSip
Market	market
Martijn	marteN
Mericanonan	merikanonan
Meverly	meverli
Oceano	oseano
PNA	pna
PPS	pepeEs
Porfin	porfiN
Productions	produktyons
Punto	punto
Request	rekwest
Rio	ryo
Roland	roland
Santana	santana
TeleAruba	tele aruba
VHF	vehaEf
Vision	visyoN
WOW	wow
Webinar	webinar
Zr	zEtEr
aleha	aleha
alto	alto
angulo	angulo
anonimo	anonimo
apto	apto
autentico	autentiko
awacati	awakati
beneficioso	benefisyoso
bononan	bononan
braza	braza
cabezante	kabezante
campeon	kampeoN
campo	kampo
carece	karese
carnavalesco	karnavalesko
carson	karsoN
celebrando	selebrando
cen	seN
challenge	Callenxe
charter	Carter
coi	koy
comprometi	komprometi
consenso	konsenso
contingencia	kontinxensya
contratistanan	kontratistanan
crew	krew
definicion	definisyoN
definitivo	definitivo
desapunta	desapunta
deseonan	deseonan
dienst	dyenst
dies	dyes
difunto	difunto
diki	diki
djente	jente
dosis	dosis
dunamento	dunamento
eGovernment	e government
efectivamente	efektivamente
eherciendo	ehersyendo
electrico	elektriko
enfermeria	enfermerya
esunan	esunan
extension	ekstensyoN
fabrica	fabrika
familiarnan	familyarnan
flexibel	fleksibel
flexibilidad	fleksibilidad
fotografo	fotografo
frieu	fryew
funeraria	funerarya
grito	grito
handle	handle
handschoen	handsCuN
higienico	hixyeniko
huespednan	hwespednan
huntu	huntu
ilumina	ilumina
immune	immune
inaceptable	inaseptable
incansablemente	inkansablemente
incompleto	inkompleto
indefini	indefini
indole	indole
industrianan	industryanan
inhustamente	inhustamente
inmoral	inmoral
intenta	intenta
lague	lage
leak	leak
legislacion	lexislasyoN
legislativo	lexislativo
localisa	lokalisa
lusnan	lusnan
malcontento	malkontento
malgasta	malgasta
melding	melding
mina	mina
monitoria	monitorya
motibu	motibu
nacion	nasyoN
naturalisacion	naturalisasyoN
paar	par
paginanan	paxinanan
pirata	pirata
presupuestario	presupwestaryo
previo	prevyo
prudente	prudente
rand	rand
re	re
recoge	rekoxe
reparticion	repartisyoN
sabiduria	sabidurya
sabor	sabor
sacudi	sakudi
sangra	sangra
siete	syete
spart	spart
specifica	spesifika
stakeholder	stakeholder
suplente	suplente
susha	suSa
ter	ter
tolerancia	toleransya
ultimamente	ultimamente
una	una
universidad	universidad
upload	upload
usual	uswal
utilidad	utilidad
vacunanan	vakunanan
votonan	votonan
workshops	workSops
AB	ab
Abuse	abuse
Afortunadamente	afortunadamente
Angela	anxela
Angelo	anxelo
Anselmo	anselmo
Antiano	antyano
Area	area
Arubianismo	arubyanismo
Bisti	bisti
C	se
CFT	seEfte
Cachi	kaCi
Carta	karta
Chiquito	Cikwito
Cinco	sinko
Clarisca	klariska
Comandante	komandante
Comun	komuN
Contact	kontakt
Cuentanan	kwentanan
DEA	dea
DJ	deye
DUO	dwo
Debe	debe
Do	do
Expression	ekspressyoN
Exterior	eksteryor
Global	global
Go	go
Gruponan	gruponan
Het	het
Hilton	hiltoN
Imsan	imsaN
Instagram	instagram
Irausquin	irauskwiN
Johnson	yohnsoN
Junior	yunyor
Keto	keto
Kiko	kiko
Land	land
Landsverordening	landsverordening
Managing	manaxing
Marc	mark
Marsman	marsmaN
Mey	mey
Natural	natural
Ocho	oCo
Oranje	oranye
Oro	oro
Pago	pago
Paskel	paskel
Politiconan	politikonan
Prevencion	prevensyoN
RFT	ErEfte
Remarcabel	remarkabel
Richi	riCi
Ruth	ruth
SOGA	soga
Safety	safeti
Sali単a	sali5a
Shailiny	Salini
Tamarijn	tamareN
Tele	tele
UAV	wav
Utilities	utilityes
Vroegop	vrugop
Weganan	weganan
Wel	wel
YouTube	yow tube
Zika	zika
abusado	abusado
aliento	alyento
anticua	antikwa
azota	azota
barku	barku
berdaderamente	berdaderamente
bezoldiging	bezoldixing
biahero	byahero
blo	blo
board	board
buske	buske
cabayero	kabayero
camp	kamp
campamento	kampamento
caretera	karetera
cede	sede
celebracionnan	selebrasyonnan
chines	Cines
clientela	klyentela
colaborador	kolaborador
comedia	komedya
competencianan	kompetensyanan
comunidadnan	komunidadnan
concientiza	konsyentiza
contractnan	kontraktnan
costonan	kostonan
crioyo	kryoyo
cruz	kruz
cr竪che	krECe
cumindanan	kumindanan
deportista	deportista
determinante	determinante
duo	dwo
ehercicionan	ehersisyonan
enfocando	enfokando
enormemente	enormemente
espantoso	espantoso
explosion	eksplosyoN
faborabel	faborabel
fayonan	fayonan
flexibilizacion	fleksibilizasyoN
fracaso	frakaso
funcionando	funsyonando
funcionnan	funsyonnan
gobernador	gobernador
hefenan	hefenan
horor	horor
huurgrond	hirgrond
inovacion	inovasyoN
interoga	interoga
it	it
kas	kas
kiebra	kyebra
lift	lift
linear	linear
mail	mal
mall	mall
manehando	manehando
manteni	manteni
mentalmente	mentalmente
mereci	meresi
modernisa	modernisa
muha	muha
naar	nar
noble	noble
noticianan	notisyanan
ofishi	ofiSi
olanan	olanan
papiamento	papyamento
paradanan	paradanan
pensamentonan	pensamentonan
permanece	permanese
pica	pika
pidie	pidye
popularidad	popularidad
presupuestonan	presupwestonan
prevalece	prevalese
procede	prosede
propiedadnan	propyedadnan
publicacionnan	publikasyonnan
quorum	kworum
refugio	refuxyo
relatonan	relatonan
reparacion	reparasyoN
reputacion	reputasyoN
ri単on	ri5oN
rolluik	rolluyk
rutanan	rutanan
salvo	salvo
scenarionan	ssenaryonan
scuridad	skuridad
separacion	separasyoN
shop	Sop
sicario	sikaryo
simanan	simanan
sociaal	sosyal
solar	solar
spuit	spuyt
strena	strena
stuurgroep	stirgrup
suficientemente	sufisyentemente
suspenso	suspenso
timon	timoN
trend	trend
tripulantenan	tripulantenan
vacatura	vakatura
viahenan	vyahenan
webinars	webinars
welga	welga
welo	welo
x	Eks
yobe	yobe
zijn	zeN
Abou	abow
Americas	amerikas
Artificial	artifisyal
Arubaanse	arubanse
Aseguro	aseguro
Barbados	barbados
Big	big
Blue	blwe
Boca	boka
Boeing	buyng
Breaking	breaking
Car	kar
Christmas	Cristmas
Conrado	konrado
Consulado	konsulado
Cultural	kultural
DPS	depeEs
Dianan	dyanan
Federacion	federasyoN
Finalisando	finalisando
First	first
Fresh	freS
Gonzalo	gonzalo
Goshen	goSeN
Grand	grand
HIV	hiv
Hall	hall
Hendrik	hendrik
Home	home
In	iN
Incinerator	insinerator
Inteligencia	intelixensya
Janine	yanine
Jeon	yeoN
Kabinet	kabinet
Kort	kort
LG	Elge
Leynan	leynan
MAS	mas
MOT	mot
Mainta	manta
Martin	martiN
Mihor	mihor
Museum	musewm
Noka	noka
Nomber	nomber
Old	old
Partidonan	partidonan
RAIZ	raz
RCC	Ersese
Rosel	rosel
SPO	spo
Sagrado	sagrado
Seguro	seguro
Sharina	Sarina
Simar	simar
Simplemente	simplemente
Situacion	sitwasyoN
Smart	smart
Soca	soka
Solange	solanxe
Spaans	spans
Subway	subway
Surinam	surinam
Takelwagen	takelwaxeN
Tipline	tipline
Tisa	tisa
Toets	tuts
Tour	towr
Truck	trukk
Tuitt	tuytt
Turista	turista
UNOCA	unoka
Web	web
Wega	wega
Williams	willyams
Yuda	yuda
abilidad	abilidad
academia	akademya
account	akkownt
acercamento	aserkamento
aclaracion	aklarasyoN
actor	aktor
afortunadamente	afortunadamente
agricultornan	agrikultornan
alcance	alkanse
aliado	alyado
all	all
anochinan	anoCinan
atmosfera	atmosfera
atracador	atrakador
babuca	babuka
batata	batata
blvd	beElvede
bolo	bolo
cabando	kabando
candidata	kandidata
ceramento	seramento
chofer	Cofer
cinema	sinema
colorido	kolorido
compasion	kompasyoN
compensacion	kompensasyoN
comprencion	komprensyoN
comprendibel	komprendibel
concurso	konkurso
contactonan	kontaktonan
contradeci	kontradesi
creciendo	kresyendo
crecimento	kresimento
cueste	kweste
decora	dekora
deporta	deporta
desayuno	desayuno
deteccion	deteksyoN
diesdos	dyesdos
digno	digno
disciplinario	dissiplinaryo
disertacion	disertasyoN
dolornan	dolornan
eigenlijk	exenlek
empresarionan	empresaryonan
encarecidamente	enkaresidamente
encaso	enkaso
entrenamento	entrenamento
erornan	erornan
error	error
especienan	espesyenan
espectaculo	espektakulo
etica	etika
eventualmente	eventwalmente
extendi	ekstendi
fasenan	fasenan
fracasa	frakasa
frecuencia	frekwensya
gasoline	gasoline
gewoon	xewoN
gigante	xigante
grill	grill
hincamento	hinkamento
hole	hole
horibel	horibel
hungando	hungando
identificacion	identifikasyoN
ingles	ingles
intencional	intensyonal
intension	intensyoN
interupcion	interupsyoN
jeans	yeans
juffrouw	yuffroww
kWh	ka weha
licencia	lisensya
logo	logo
mandatorio	mandatoryo
materno	materno
merca	merka
mokete	mokete
moviendo	movyendo
nister	nister
nuebe	nwebe
nunka	nunka
pacient	pasyent
pasco	pasko
periodismo	peryodismo
podernan	podernan
policlinica	poliklinika
pompstation	pompstatyoN
profesionalismo	profesyonalismo
prohimo	prohimo
promesanan	promesanan
propaga	propaga
proposicionnan	proposisyonnan
psycologo	psikologo
puntre	puntre
quadracer	kwadraser
rapidez	rapidez
recomendabel	rekomendabel
recordatorio	rekordatoryo
recreacion	rekreasyoN
refinancia	refinansya
restructuracion	restrukturasyoN
revista	revista
revolver	revolver
riguroso	riguroso
salanan	salanan
saliente	salyente
scarsedad	skarsedad
secretario	sekretaryo
shete	Sete
speech	speC
splike	splike
sufrimento	sufrimento
susto	susto
telefonico	telefoniko
tercera	tersera
toke	toke
traductor	traduktor
trampa	trampa
transaccionnan	transaksyonnan
transmicion	transmisyoN
tripulante	tripulante
tuberia	tuberya
tucson	tuksoN
t竪st	tEst
urgentemente	urxentemente
videoclip	videoklip
visa	visa
AGA	aga
Academia	akademya
Action	aktyoN
Agricultura	agrikultura
Andicuri	andikuri
Antiyas	antiyas
Apenas	apenas
Apple	apple
BZK	bezEtka
Baho	baho
Bienestar	byenestar
Black	blakk
CPR	sepeEr
Cabana	kabana
Cafe	kafe
Cambionan	kambyonan
Choudhry	Cowdhri
Cien	syeN
Compara	kompara
Consul	konsul
Copa	kopa
Corporate	korporate
Cuminsando	kuminsando
Dabian	dabyaN
Department	department
Depresion	depresyoN
Ey	ey
Fatima	fatima
Fitch	fitC
Fuerte	fwerte
Gaalen	galeN
Glenda	glenda
Grant	grant
Growell	growell
HBO	hbo
Hulp	hulp
Imeldahof	imeldahof
Impact	impakt
India	indya
Infantil	infantil
Interest	interest
James	yames
Jet	yet
Kamp	kamp
Kendrick	kendrikk
Kids	kids
LABHOH	labhoh
Laboratorio	laboratoryo
MP	Empe
Mantene	mantene
Mayor	mayor
Miguel	migel
Moderna	moderna
Monta単a	monta5a
Montenegro	montenegro
Motibo	motibo
Nes	nes
Nuhad	nuhad
Oost	ost
Open	opeN
POREDmep	pore dmep
Palace	palase
Papilon	papiloN
Paula	paula
Pedro	pedro
Piscadonan	piskadonan
Prison	prisoN
Progreso	progreso
Public	publik
Richardson	riCardsoN
Rosario	rosaryo
Rumbastraat	rumbastrat
SSA	ssa
Sagicor	saxikor
Sostenible	sostenible
Special	spesyal
Stadhuis	stadhuys
Tera	tera
Terminal	terminal
Texier	teksyer
Trabao	trabao
Traimerdia	tramerdya
Unavez	unavez
VBA	vba
Vondellaan	vondellaN
WCA	wka
Walk	walk
Week	wek
absolutamente	absolutamente
aconseha	akonseha
ader	ader
adresa	adresa
afirma	afirma
agresor	agresor
aparatonan	aparatonan
artikel	artikel
auspicio	auspisyo
bacteria	bakterya
baseball	baseball
binidero	binidero
bisindario	bisindaryo
body	bodi
boost	bost
bosonan	bosonan
burocracia	burokrasya
camaranan	kamaranan
caracterisa	karakterisa
caracteristicanan	karakteristikanan
caravana	karavana
checklist	Cekklist
ciclo	siklo
circumstancia	sirkumstansya
civico	siviko
clapchi	klapCi
clinico	kliniko
cocolishi	kokoliSi
combate	kombate
comodo	komodo
compensa	kompensa
competitivo	kompetitivo
complicacionnan	komplikasyonnan
compornde	kompornde
comunismo	komunismo
condicionan	kondisyonan
conducta	kondukta
congreso	kongreso
consistente	konsistente
cualnan	kwalnan
cuartal	kwartal
cuidador	kuydador
cyclista	siklista
d	de
da単onan	da5onan
debilita	debilita
deleita	deleta
desigualdad	desigwaldad
desmantela	desmantela
deze	deze
discucion	diskusyoN
dive	dive
ecosistema	ekosistema
educacional	edukasyonal
enfaticamente	enfatikamente
engrandece	engrandese
entusiasma	entusyasma
epicentro	episentro
excelencia	eksselensya
explosivo	eksplosivo
festivo	festivo
file	file
free	fre
front	front
frontliners	frontliners
fructifero	fruktifero
greppel	greppel
hasiendo	hasyendo
heridanan	heridanan
hobby	hobbi
imparcial	imparsyal
inauguracion	inaugurasyoN
indicadornan	indikadornan
indirectamente	indirektamente
inspecciona	inspeksyona
interumpi	interumpi
inventario	inventaryo
invisibel	invisibel
joyas	yoyas
kaba	kaba
komo	komo
lastimamente	lastimamente
logistica	loxistika
logistico	loxistiko
maestra	maestra
mancha	manCa
manifestacionnan	manifestasyonnan
manifiesto	manifyesto
minuutnan	minitnan
misterio	misteryo
mondmasker	mondmasker
moringa	moringa
multiple	multiple
natacion	natasyoN
neglisha	negliSa
nervioso	nervyoso
notando	notando
obligatoriamente	obligatoryamente
off	off
opinionnan	opinyonnan
oponentenan	oponentenan
oportuno	oportuno
organisacionan	organisasyonan
pacifico	pasifiko
pagara	pagara
parkeo	parkeo
patientnan	patyentnan
pedofilnan	pedofilnan
perdiendo	perdyendo
pianan	pyanan
pico	piko
pilarnan	pilarnan
plaats	plats
probecho	probeCo
procesverbaal	prosesverbal
proclama	proklama
pura	pura
puro	puro
reactivacion	reaktivasyoN
recobra	rekobra
recompensa	rekompensa
reenforsa	renforsa
reglamentonan	reglamentonan
rekesito	rekesito
remarcabel	remarkabel
responsabilisa	responsabilisa
restante	restante
restonan	restonan
retene	retene
selecciona	seleksyona
short	Sort
sintonisa	sintonisa
slow	slow
speedboat	spedboat
sunu	sunu
supla	supla
taira	tara
tardando	tardando
taskforce	taskforse
tecnica	teknika
thee	the
tilda	tilda
tragedia	traxedya
tribi	tribi
unilateralmente	unilateralmente
util	util
validez	validez
variacion	varyasyoN
venezolano	venezolano
vitamina	vitamina
windshield	windSyeld
yuinan	yuynan
Abraham	abraham
Acaso	akaso
Andre	andre
Andrew	andrew
Animal	animal
AruBIG	aru big
Banconan	bankonan
Benchi	benCi
Bill	bill
Bisi単anan	bisi5anan
Bloomberg	blomberg
Board	board
Calidad	kalidad
Cannabis	kannabis
Caribisch	karibisC
Carolina	karolina
Comerciantenan	komersyantenan
Comite	komite
Compania	kompanya
Computer	komputer
Cuna	kuna
DE	de
Dado	dado
Dengue	denge
Dijkhoff	dekhoff
Douaneronan	dowaneronan
Droga	droga
Duarte	dwarte
Elements	elements
Emanstraat	emanstrat
Encuanto	enkwanto
Escolar	eskolar
Financia	finansya
Fontein	fonteN
Frances	franses
Frere	frere
Futura	futura
Garcia	garsya
Garden	gardeN
Gemeente	xemente
Gradus	gradus
Great	great
Halloween	halloweN
High	high
Iglesia	iglesya
Integriteit	integritet
Jeep	yep
Jucuri	yukuri
Kerstboomlandia	kerstbomlandya
Kisas	kisas
Kralendijk	kralendek
Kwartaal	kwartal
LaSorte	la sorte
Lanta	lanta
Little	little
Mabon	maboN
Mall	mall
Marchena	marCena
Mercado	merkado
Molina	molina
Movimiento	movimyento
Muher	muher
Number	number
Nunes	nunes
Paramedico	paramediko
Pashentnan	paSentnan
Patrick	patrikk
Pelican	pelikaN
Percura	perkura
Peterson	petersoN
Presente	presente
Preto	preto
Problemanan	problemanan
RAiZ	Er a zEt
ROP	rop
Red	red
Relacionista	relasyonista
Ruso	ruso
SDG	Esdege
Samenscholingsverbod	samensColingsverbod
Sostenemi	sostenemi
Speransa	speransa
TOQUE	tokwe
Testnan	testnan
Thomas	thomas
Tico	tiko
Turibana	turibana
Wak	wak
Winklaar	winklar
Zoom	zom
adaptacionnan	adaptasyonnan
annual	annwal
aplauso	aplauso
argumentonan	argumentonan
aruba	aruba
autismo	autismo
auxiliar	auksilyar
beyesa	beyesa
bieuw	byeww
bisabo	bisabo
budget	budxet
buelta	bwelta
cadenanan	kadenanan
camanan	kamanan
careteranan	kareteranan
centenares	sentenares
chat	Cat
ciruhano	siruhano
clasico	klasiko
clip	klip
conrector	konrektor
controle	kontrole
cordialidad	kordyalidad
coremento	koremento
correcto	korrekto
database	database
debit	debit
decoracion	dekorasyoN
decreta	dekreta
derota	derota
discrepancia	diskrepansya
discrimina	diskrimina
dispensacion	dispensasyoN
do	do
domino	domino
donacionnan	donasyonnan
economianan	ekonomyanan
elo	elo
embahada	embahada
emplea	emplea
encabesa	enkabesa
encuestanan	enkwestanan
endemico	endemiko
enfermero	enfermero
envolvimento	envolvimento
equiponan	ekwiponan
estafa	estafa
evidente	evidente
exigiendo	eksixyendo
experencianan	eksperensyanan
fantasma	fantasma
favor	favor
formato	formato
formulanan	formulanan
friu	fryu
ganado	ganado
gigantesco	xigantesko
good	god
gracia	grasya
grato	grato
habitat	habitat
haf	haf
hanja	hanya
huiswerk	huyswerk
ilegalidad	ilegalidad
individualmente	individwalmente
informal	informal
iniciativanan	inisyativanan
input	input
insigur	insigur
insiguridad	insiguridad
institucionnan	institusyonnan
instructor	instruktor
interaccion	interaksyoN
international	internatyonal
ja	ya
karentena	karentena
klasse	klasse
laborando	laborando
lantamento	lantamento
legitimo	lexitimo
lineanan	lineanan
li単anan	li5anan
lobby	lobbi
mala	mala
marcanan	markanan
market	market
masal	masal
medicamento	medikamento
menornan	menornan
mensualmente	menswalmente
mini	mini
mobil	mobil
mortalidad	mortalidad
movimento	movimento
natal	natal
navega	navega
neishi	neSi
network	network
nr	EnEr
observacionnan	observasyonnan
omo	omo
onderwijs	onderwes
parecido	paresido
patruyahe	patruyahe
pena	pena
perhudicando	perhudikando
pleita	pleta
poko	poko
porshento	porSento
precisamente	presisamente
premie	premye
procedimento	prosedimento
profila	profila
prominente	prominente
proteina	protena
protestanan	protestanan
rabo	rabo
raiz	raz
rating	rating
recicla	resikla
recuerdo	rekwerdo
refleho	refleho
regionnan	rexyonnan
regulacionnan	regulasyonnan
rek	rek
renovacion	renovasyoN
responsabilidadnan	responsabilidadnan
rutina	rutina
samenscholingsverbod	samensColingsverbod
sanea	sanea
scogi	skoxi
sende	sende
service	servise
skol	skol
soborno	soborno
sobrepasa	sobrepasa
soledad	soledad
sondea	sondea
statuto	statuto
stem	stem
suv	suv
tabel	tabel
tenso	tenso
tipico	tipiko
toxico	toksiko
viahero	vyahero
vigilando	vixilando
wave	wave
whatsapp	whatsapp
yudabo	yudabo
yui	yuy
ATSA	atsa
Armando	armando
Asia	asya
BaluArte	balu arte
Biemans	byemans
Bingo	bingo
Boliviastraat	bolivyastrat
Boston	bostoN
Britanico	britaniko
Brown	browN
Buena	bwena
CIBC	sibk
CMB	seEmbe
Caf辿	kafe
Cali	kali
Candela	kandela
Casibari	kasibari
Centre	sentre
Chef	Cef
Chief	Cyef
Cierto	syerto
Colony	koloni
Consensus	konsensus
Constantemente	konstantemente
Contabilidad	kontabilidad
Corupcion	korupsyoN
Cumbre	kumbre
DIA	dya
DNA	dna
DWJZ	deweyezEt
Dentista	dentista
Dump	dump
Economische	ekonomisCe
Entrega	entrega
Ernesto	ernesto
Eugene	ewxene
FLPD	EfElpede
FPNM	EfpeEnEm
Faro	faro
Financien	finansyeN
Frido	frido
Futbol	futbol
Gezaghebber	xezaghebber
Goedhoop	gudhop
Gumbs	gumbs
Heights	heghts
Helpdesk	helpdesk
Higiena	hixyena
Inn	inN
Insurance	insuranse
Irani	irani
Jairzinho	yarzinho
Jordan	yordaN
Jorge	yorxe
Koningstraat	koningstrat
Korps	korps
Legislation	lexislatyoN
Lidernan	lidernan
Life	life
Medical	medikal
Meiveld	meveld
Mimi	mimi
Minimarket	minimarket
Naturalisacion	naturalisasyoN
Nel	nel
Night	night
Nort	nort
OC	ok
Odillia	odillya
Olsen	olseN
Patruyanan	patruyanan
Pereira	perera
Pesca	peska
Pesei	pese
Poets	puts
Port	port
Preguntanan	preguntanan
Prinses	prinses
Probablemente	probablemente
Program	program
Psicologo	psikologo
Realidad	realidad
Registracion	rexistrasyoN
Rene	rene
Rep	rep
Reposicionando	reposisyonando
Rodenburg	rodenburg
Rolando	rolando
Ruyter	ruyter
Schloss	sCloss
Scientology	ssyentoloxi
Sustainable	sustanable
Tapaboca	tapaboka
Telecomunicacion	telekomunikasyoN
Teller	teller
Temporada	temporada
Trafico	trafiko
Traveler	traveler
UN	uN
UNICEF	unisef
Uzi	uzi
VNO	vno
VO	vo
Villas	villas
Virgin	virxiN
Vitamina	vitamina
WTO	wto
X	Eks
Zeewijk	zewek
agencianan	axensyanan
agradable	agradable
ambicioso	ambisyoso
anota	anota
argumenta	argumenta
asfalt	asfalt
asientonan	asyentonan
asocia	asosya
awenochi	awenoCi
balanza	balanza
bariga	bariga
ba単a	ba5a
beschikking	besCikking
bloki	bloki
briya	briya
bulando	bulando
bulto	bulto
business	business
c	se
cahanan	kahanan
cantidadnan	kantidadnan
caranan	karanan
caritativo	karitativo
carteranan	karteranan
carton	kartoN
casamento	kasamento
casualidad	kaswalidad
catolico	katoliko
cedula	sedula
charlanan	Carlanan
cierre	syerre
comandante	komandante
combustible	kombustible
comestibles	komestibles
comisionnan	komisyonnan
compilacion	kompilasyoN
componentenan	komponentenan
concientisa	konsyentisa
constant	konstant
constructivo	konstruktivo
contrata	kontrata
coperacion	koperasyoN
crash	kraS
credit	kredit
creencia	krensya
cultiva	kultiva
cup	kup
custumbernan	kustumbernan
deliberadamente	deliberadamente
demonstra	demonstra
descansa	deskansa
desinfectante	desinfektante
dibiaha	dibyaha
dibo	dibo
dictatorial	diktatoryal
dimension	dimensyoN
dividendo	dividendo
double	dowble
edadnan	edadnan
eficaz	efikaz
embahador	embahador
emision	emisyoN
entregamento	entregamento
entregando	entregando
entrena	entrena
envelope	envelope
evacua	evakwa
exclusivamente	eksklusivamente
excluyendo	ekskluyendo
experienciando	eksperyensyando
facultad	fakultad
fake	fake
favorito	favorito
felis	felis
filosofia	filosofya
findishi	findiSi
florece	florese
formalmente	formalmente
foyeto	foyeto
give	xive
grandura	grandura
hancho	hanCo
hera	hera
hobencita	hobensita
hospeda	hospeda
hulp	hulp
h嘆mber	homber
ilegalmente	ilegalmente
iluminacion	iluminasyoN
impeachment	impeaCment
implementando	implementando
imposible	imposible
impresionante	impresyonante
impulso	impulso
indicenan	indisenan
informenan	informenan
ingresonan	ingresonan
innecesariamente	innesesaryamente
inspector	inspektor
integra	integra
intensidad	intensidad
invadi	invadi
jet	yet
lancer	lanser
landsverordening	landsverordening
loteria	loterya
mascotanan	maskotanan
mencion	mensyoN
mentornan	mentornan
mexicano	meksikano
ministerionan	ministeryonan
miyonario	miyonaryo
mondmask	mondmask
motorcycle	motorsikle
municipio	munisipyo
nubia	nubya
onderzoek	onderzuk
opositornan	opositornan
optimalisa	optimalisa
opvang	opvang
pakiko	pakiko
piedad	pyedad
plantamento	plantamento
poesia	pusya
porcierto	porsyerto
positivamente	positivamente
prestigioso	prestixyoso
print	print
propagacion	propagasyoN
radical	radikal
rebelde	rebelde
rectifica	rektifika
recuri	rekuri
referencia	referensya
refinerianan	refineryanan
rehabilita	rehabilita
remedia	remedya
reportahe	reportahe
resolvi	resolvi
sacamento	sakamento
sancionnan	sansyonnan
satelite	satelite
scirbi	ssirbi
sentra	sentra
sexualmente	sekswalmente
share	Sare
sindicalista	sindikalista
sintie	sintye
snacks	snakks
socialista	sosyalista
solidarismo	solidarismo
sondeo	sondeo
sonrisa	sonrisa
speculacion	spekulasyoN
splicando	splikando
stagna	stagna
stakeholdernan	stakeholdernan
suceso	suseso
support	support
suspension	suspensyoN
tanta	tanta
tatanan	tatanan
telefonicamente	telefonikamente
tellernan	tellernan
temporadanan	temporadanan
tokante	tokante
tools	tols
torneo	torneo
tos	tos
tot	tot
touch	towC
transcuri	transkuri
transitorio	transitoryo
transmission	transmissyoN
u	u
use	use
vangrail	vangral
violento	vyolento
visible	visible
west	west
winstbelasting	winstbelasting
Accent	aksent
Administracion	administrasyoN
All	all
Antillas	antillas
Arubadag	arubadag
Arubig	arubig
Autobus	autobus
Awa	awa
Bachelor	baCelor
Ben	beN
Benjamin	benyamiN
Beverage	beveraxe
Birgen	birxeN
British	britiS
Cabesante	kabesante
Chikungunya	Cikungunya
Chile	Cile
Choller	Coller
Cientificonan	syentifikonan
Clinton	klintoN
Coca	koka
Comerciante	komersyante
Complex	kompleks
Concierto	konsyerto
Cond辿	konde
Conhuntamente	konhuntamente
Conservation	konservatyoN
Cruises	kruyses
Decision	desisyoN
Dor	dor
Dorp	dorp
Do単o	do5o
EU	ew
Eduardo	edwardo
Ehecutivo	ehekutivo
Embahada	embahada
Entrevista	entrevista
Envez	envez
Eric	erik
Financial	finansyal
Financiamento	finansyamento
Financieel	finansyel
Flora	flora
Frontera	frontera
Gina	xina
Goeloe	gulu
Grace	grase
Guillermo	gyllermo
Gusto	gusto
Hoek	huk
Hong	hong
Hooyboer	hoybur
Horeca	horeka
Hub	hub
IOWA	yowa
IQ	ik
Idioma	idyoma
Iniciativa	inisyativa
Interior	interyor
It	it
JZP	yezEtpe
Jade	yade
Jetblue	yetblwe
KB	kabe
Kas	kas
Korpschef	korpsCef
LLC	ElElse
Lab	lab
Las	las
Lighthouse	lighthowse
Lisette	lisette
MS	EmEs
Marine	marine
Marquez	markwez
Martinez	martinez
Meteorologico	meteoroloxiko
MiSVb	mi Esvebe
Migracion	migrasyoN
Milio	milyo
Mira	mira
Monarch	monarC
Movies	movyes
Music	musik
Myron	miroN
NVT	Envete
Nast	nast
Nederlandse	nederlandse
Network	network
Nightclub	nightklub
ODEA	odea
Orde	orde
Orlando	orlando
PIN	piN
Pacifico	pasifiko
Paraguana	paragwana
Paris	paris
Participacion	partisipasyoN
Pasa	pasa
Pecho	peCo
Pelea	pelea
Penha	penha
Petronia	petronya
Plus	plus
Posiblemente	posiblemente
Positivo	positivo
Programa	programa
Project	proyekt
Pronk	pronk
Punta	punta
Quality	kwaliti
Quant	kwant
RADEX	radeks
Rampen	rampeN
Rapportnan	rapportnan
Rescue	reskwe
Rodriguez	rodrigez
SI	si
Sacrificio	sakrifisyo
Scan	skaN
Seis	ses
Seyo	seyo
South	sowth
Surnam	surnam
Theater	theater
Thru	thru
Travel	travel
USA	usa
VWO	vwo
Wernet	wernet
Wil	wil
Wilhelminastraat	wilhelminastrat
abilidadnan	abilidadnan
aceptacion	aseptasyoN
acreditacion	akreditasyoN
adecuadamente	adekwadamente
agilisa	axilisa
ahustacion	ahustasyoN
alentador	alentador
analiza	analiza
ancianonan	ansyanonan
anhela	anhela
artesania	artesanya
asbesto	asbesto
asegura	asegura
asesina	asesina
ataka	ataka
auditoria	auditorya
averigua	averigwa
bakinan	bakinan
bandanan	bandanan
barancanan	barankanan
batayon	batayoN
beleid	beled
beyeza	beyeza
bisami	bisami
brabo	brabo
bruin	bruyN
buffer	buffer
campa	kampa
cantantenan	kantantenan
cashi	kaSi
categorisa	kategorisa
censo	senso
censura	sensura
ciclon	sikloN
cobrando	kobrando
comunitario	komunitaryo
conceptonan	konseptonan
concretisa	konkretisa
conocir	konosir
contempla	kontempla
conteniendo	kontenyendo
contractonan	kontraktonan
corantnan	korantnan
coro	koro
cumbini	kumbini
daggeldvergoeding	dagxeldverguding
dental	dental
depresivo	depresivo
desconecta	deskonekta
difamacion	difamasyoN
directivanan	direktivanan
disco	disko
distingui	distingy
districtonan	distriktonan
disturbio	disturbyo
diversidad	diversidad
diverso	diverso
divorcio	divorsyo
donante	donante
dosnan	dosnan
edicionnan	edisyonnan
educador	edukador
elegi	elexi
emocionnan	emosyonnan
enrikece	enrikese
er	er
erfpacht	erfpaCt
eventual	eventwal
evitando	evitando
expectativanan	ekspektativanan
expo	ekspo
eybao	eybao
faha	faha
first	first
flexibiliza	fleksibiliza
foi	foy
forensyco	forensiko
fraccionnan	fraksyonnan
gaba	gaba
gritamento	gritamento
group	growp
guardia	gwardya
hayabo	hayabo
heridonan	heridonan
hermana	hermana
heroenan	herunan
hinka	hinka
hinke	hinke
hospitalnan	hospitalnan
house	howse
hurista	hurista
hustificacion	hustifikasyoN
ilustracion	ilustrasyoN
impuestonan	impwestonan
inclusivo	inklusivo
indicacionnan	indikasyonnan
infeccionnan	infeksyonnan
infraccion	infraksyoN
ingrediente	ingredyente
ingresa	ingresa
inn	inN
insulto	insulto
inteligente	intelixente
intensivamente	intensivamente
intimida	intimida
inunda	inunda
inusual	inuswal
inventarisa	inventarisa
lealtad	lealtad
legado	legado
legalisa	legalisa
legitimidad	lexitimidad
letter	letter
light	light
line	line
listramento	listramento
lokaalnan	lokalnan
lucrativo	lukrativo
maluza	maluza
maneranan	maneranan
meti	meti
migrante	migrante
modelonan	modelonan
momentu	momentu
morocoy	morokoy
motorunit	motorunit
movecionnan	movesyonnan
musca	muska
noordwest	nordwest
nubianan	nubyanan
nulo	nulo
observador	observador
ora単o	ora5o
orientacion	oryentasyoN
overtime	overtime
paciente	pasyente
paliativo	palyativo
palonan	palonan
paranda	paranda
parha	parha
part	part
pasamento	pasamento
patria	patrya
perdidanan	perdidanan
periodistico	peryodistiko
piesanan	pyesanan
plania	planya
plat	plat
politicamente	politikamente
populacion	populasyoN
posibelmente	posibelmente
posicionnan	posisyonnan
positive	positive
postura	postura
poz	poz
problematico	problematiko
procesamento	prosesamento
profundidad	profundidad
prom辿	prome
psicologico	psikoloxiko
que	kwe
raad	rad
recepcion	resepsyoN
regalonan	regalonan
regio	rexyo
repatria	repatrya
respalda	respalda
respetando	respetando
restablece	restablese
revision	revisyoN
sacrificionan	sakrifisyonan
saka	saka
sake	sake
salbaguardia	salbagwardya
schoolnan	sColnan
schouder	sCowder
shopping	Sopping
sifuera	sifwera
sigaria	sigarya
simbolico	simboliko
size	size
si単amento	si5amento
smart	smart
socialisa	sosyalisa
speed	sped
stempel	stempel
sumario	sumaryo
surseance	surseanse
tama単o	tama5o
tarhetanan	tarhetanan
tasa	tasa
terminonan	terminonan
tocando	tokando
tono	tono
trainingnan	traningnan
transformacion	transformasyoN
transplante	transplante
trip	trip
vanguardia	vangwardya
versa	versa
veterinario	veterinaryo
volumen	volumeN
wardanan	wardanan
web	web
werki	werki
ARUBA	aruba
ASF	asf
Accion	aksyoN
Adventista	adventista
Alzheimer	alzhemer
Amalia	amalya
Ambtenaar	ambtenar
Andres	andres
Anteriormente	anteryormente
Anti	anti
Aressa	aressa
Argus	argus
Asegurado	asegurado
Ata	ata
Aurora	aurora
Autismo	autismo
BCMS	beseEmEs
BNA	bna
Barconan	barkonan
Biba	biba
Bloemond	blumond
Britten	britteN
Brokke	brokke
CBA	kba
CENSO	senso
COHO	koho
Cabai	kaba
CableTV	kable teve
Castigo	kastigo
Catalina	katalina
Categoria	kategorya
Celebracion	selebrasyoN
Centronan	sentronan
Chavez	Cavez
Ciudadano	syudadano
Cola	kola
Communicatie	kommunikatye
Compleho	kompleho
Convention	konventyoN
Creando	kreando
Cubano	kubano
Dialogo	dyalogo
Dogcatcher	dogkatCer
Driemasterstraat	dryemasterstrat
Drs	deErEs
Dunadornan	dunadornan
Duque	dukwe
Empleado	empleado
Empresa	empresa
Esunnan	esunnan
Excellence	ekssellense
FHMD	EfhaEmde
FLEXO	flekso
Franklin	frankliN
Golfo	golfo
Gomes	gomes
Haseth	haseth
Havenstraat	havenstrat
Hogarnan	hogarnan
Holding	holding
Hudicial	hudisyal
Huize	huyze
Huridico	huridiko
IBIS	ibis
IMAX	imaks
Ing	ing
Instancianan	instansyanan
Integracion	integrasyoN
Interes	interes
Interno	interno
Iron	iroN
Japon	yapoN
Jessica	yessika
Joaquin	yoakwiN
KYPA	kipa
Kawaiah	kawaah
Kennedy	kennedi
Kiwanistico	kiwanistiko
Koningin	koninxiN
Kranwinkel	kranwinkel
Lama	lama
League	leage
Lid	lid
Lion	lyoN
Locura	lokura
London	londoN
Lorentzstraat	lorentzstrat
MC	Emse
Mahestad	mahestad
Mando	mando
Massive	massive
Mesun	mesuN
Monseigneur	monsegnewr
Monserat	monserat
Moringa	moringa
Mucho	muCo
Nathaly	nathali
Nature	nature
Nest	nest
Nota	nota
Novel	novel
Oficialmente	ofisyalmente
Openbare	openbare
Ordenansa	ordenansa
Pabao	pabao
Padu	padu
Paloma	paloma
Parlamentonan	parlamentonan
Pasaheronan	pasaheronan
Peter	peter
Picanto	pikanto
Play	play
Politica	politika
Porta	porta
Produccion	produksyoN
QUEDA	kweda
RIU	ryu
RWZI	rwzi
Radisson	radissoN
Rampenbestrijding	rampenbestreding
Recupera	rekupera
Regis	rexis
Resiliente	resilyente
Resorts	resorts
Reyes	reyes
Rhuggenaath	rhugxenath
Ritmo	ritmo
Roos	ros
Run	ruN
SLM	EsElEm
SVGA	svga
Saladin	saladiN
Scoop	skop
Sexual	sekswal
Signs	signs
Siguientemente	sigyentemente
Silva	silva
Smartphone	smartphone
Snor	snor
Society	sosyeti
Staatsregeling	statsrexeling
Stella	stella
Superfood	superfod
Titular	titular
Trupialen	trupyaleN
Turkia	turkya
Ultimamente	ultimamente
Unidadnan	unidadnan
Up	up
Vehiculo	vehikulo
Vis	vis
Webb	webb
Wiki	wiki
Wyatt	wyatt
accesibilidad	aksesibilidad
acercando	aserkando
acta	akta
adaptando	adaptando
admiracion	admirasyoN
agradeci	agradesi
ahustacionnan	ahustasyonnan
alcanza	alkanza
alegra	alegra
alergia	alerxya
algu	algu
altezza	altezza
ampliamente	amplyamente
an	aN
asintomatico	asintomatiko
asistente	asistente
astronomico	astronomiko
atrapa	atrapa
atribui	atribuy
autoriza	autoriza
avancenan	avansenan
ayo	ayo
balanan	balanan
baldadi	baldadi
balia	balya
bankroet	bankrut
barrio	barryo
behes	behes
bestel	bestel
bestuurskantoor	bestirskantor
bingo	bingo
blaas	blas
boternan	boternan
bril	bril
buena	bwena
buraconan	burakonan
cabuya	kabuya
canabis	kanabis
cansancio	kansansyo
carchinan	karCinan
care	kare
catastrofe	katastrofe
causante	kausante
cayendo	kayendo
cerando	serando
certamen	sertameN
certidumbre	sertidumbre
cine	sine
claim	klam
clasificacion	klasifikasyoN
comestible	komestible
complementa	komplementa
composicion	komposisyoN
conferencianan	konferensyanan
conforma	konforma
consequencia	konsekwensya
consultanan	konsultanan
consumi	konsumi
contradictorio	kontradiktoryo
coordinadornan	kordinadornan
cordialmente	kordyalmente
corolla	korolla
creditornan	kreditornan
criminalnan	kriminalnan
cuando	kwando
cumpre	kumpre
curiculo	kurikulo
dao	dao
decisivo	desisivo
desaroyadornan	desaroyadornan
desaroyando	desaroyando
diciplina	disiplina
digitalizacion	dixitalizasyoN
dimas	dimas
dinamismo	dinamismo
diputado	diputado
dominio	dominyo
drempel	drempel
economisa	ekonomisa
ekivalente	ekivalente
embarazo	embarazo
emisora	emisora
empe単o	empe5o
empleada	empleada
enfermo	enfermo
entendimento	entendimento
escalacion	eskalasyoN
escohi	eskohi
escritor	eskritor
estadistica	estadistika
estadisticanan	estadistikanan
eta	eta
eventualidad	eventwalidad
examennan	eksamennan
exigente	eksixente
extranhero	ekstranhero
f	Ef
fayecidonan	fayesidonan
figuranan	figuranan
finalisacion	finalisasyoN
fini	fini
flota	flota
fotografianan	fotografyanan
freezer	frezer
fundador	fundador
gedoogbeleid	xedogbeled
genetico	xenetiko
gerente	xerente
graduacion	gradwasyoN
graduadonan	gradwadonan
habla	habla
haza単a	haza5a
hospice	hospise
hungadornan	hungadornan
iglesia	iglesya
impactante	impaktante
incidentenan	insidentenan
indicador	indikador
infeccioso	infeksyoso
inhumano	inhumano
inhusticia	inhustisya
instiga	instiga
integrantenan	integrantenan
intensiva	intensiva
kentel	kentel
kies	kyes
lachi	laCi
landspakket	landspakket
larga	larga
lid	lid
malisimo	malisimo
maltratando	maltratando
margen	marxeN
mashinnan	maSinnan
mediador	medyador
meer	mer
menasanan	menasanan
menase	menase
miembrecia	myembresya
miya	miya
moda	moda
modo	modo
monumental	monumental
motornan	motornan
multanan	multanan
nek	nek
nieto	nyeto
nietonan	nyetonan
night	night
obstaculonan	obstakulonan
occasion	okkasyoN
orador	orador
oral	oral
organizando	organizando
pagado	pagado
parhanan	parhanan
pasivo	pasivo
patronchi	patronCi
pedofilia	pedofilya
penoso	penoso
planes	planes
platonan	platonan
populista	populista
porvenir	porvenir
pre	pre
preferiblemente	preferiblemente
preisnan	presnan
presidi	presidi
primeramente	primeramente
project	proyekt
protehe	protehe
racha	raCa
raportahe	raportahe
raro	raro
refresco	refresko
remarka	remarka
restringi	restrinxi
risiconan	risikonan
saconan	sakonan
salo	salo
sangrando	sangrando
sanitizers	sanitizers
sclama	sklama
seca	seka
separadamente	separadamente
setup	setup
sinceridad	sinseridad
skeiro	skero
specialismo	spesyalismo
sponsornan	sponsornan
sportage	sportaxe
steun	stewN
strobando	strobando
subidanan	subidanan
sugerencianan	suxerensyanan
suppose	suppose
tactica	taktika
talentonan	talentonan
tasnan	tasnan
teamnan	teamnan
terapia	terapya
tercel	tersel
teror	teror
terorismo	terorismo
tesis	tesis
thru	thru
tim	tim
tirando	tirando
toets	tuts
toezicht	tuziCt
tracing	trasing
trafica	trafika
transferencianan	transferensyanan
triunfo	tryunfo
tsunami	tsunami
tubo	tubo
uit	uyt
uitkering	uytkering
unanime	unanime
unilateral	unilateral
universidadnan	universidadnan
variante	varyante
variedad	varyedad
virtualmente	virtwalmente
vitrina	vitrina
voorzitter	vorzitter
zodiacal	zodyakal
zomaar	zomar
zonanan	zonanan
zoom	zom
zwaailicht	zwayliCt
APP	app
Acto	akto
Adriaan	adryaN
Africa	afrika
Agencia	axensya
Airbus	arbus
Alarma	alarma
Anochi	anoCi
Astrid	astrid
Aumento	aumento
Award	award
Aworo	aworo
Ayo	ayo
BBQ	bebeki
Belasting	belasting
Bermudez	bermudez
Biezen	byezeN
Bolivar	bolivar
Boroncana	boronkana
Boto	boto
Branch	branC
CHE	Ce
CUA	kwa
Carlo	karlo
Casinonan	kasinonan
Cayman	kaymaN
Centrum	sentrum
Chito	Cito
Ciudadanonan	syudadanonan
Company	kompani
Conclusion	konklusyoN
Conducta	kondukta
Corporation	korporatyoN
Cuatro	kwatro
Customer	kustomer
D	de
Dance	danse
Davelaar	davelar
Defensie	defensye
Deposit	deposit
Dimas	dimas
DirecTV	direk teve
Dunado	dunado
Elizabeth	elizabeth
Energia	enerxya
Enfermeria	enfermerya
Enid	enid
Entretanto	entretanto
Eseynan	eseynan
FMTB	EfEmtebe
FUTURA	futura
Facultad	fakultad
Family	famili
Farro	farro
Fatum	fatum
Fijo	feo
Financi谷n	finansyeN
Full	full
Fund	fund
Gasoline	gasoline
Generalmente	xeneralmente
Gino	xino
Gloria	glorya
Gold	gold
Gouverneur	gowvernewr
Hand	hand
Harms	harms
Hassell	hassell
Hepple	hepple
Hofi	hofi
Hoge	hoxe
Holiday	holiday
Hot	hot
Hugo	hugo
Incluso	inkluso
Innovation	innovatyoN
Integrity	integriti
Israel	israel
Jean	yeaN
Jimenez	yimenez
Justicia	yustisya
KOR	kor
Kamay	kamay
Katholiek	katholyek
Kaya	kaya
Kayak	kayak
Kooyman	koymaN
LIVE	live
LVV	Elveve
Lantamento	lantamento
Leoncita	leonsita
Loves	loves
Luanne	lwanne
Luenne	lwenne
Malesanan	malesanan
Maris	maris
Maritimo	maritimo
Mavo	mavo
Meneer	mener
Mesa	mesa
Millennials	millennyals
Milo	milo
MiniMega	mini mega
Mobile	mobile
Monica	monika
Monuments	monuments
Nacion	nasyoN
Negoshi	negoSi
Newark	newark
OCTA	okta
ONU	onu
Organisacionnan	organisasyonnan
Oriente	oryente
PHP	pehape
Pan	paN
Papaya	papaya
Party	parti
Pashent	paSent
Passions	passyons
Pier	pyer
Pieters	pyeters
Pietersz	pyetersz
Poder	poder
Principalmente	prinsipalmente
Productonan	produktonan
P炭bliko	publiko
Ranger	ranxer
Reglanan	reglanan
Representante	representante
Rescate	reskate
Restaurantnan	restaurantnan
Retiro	retiro
Rina	rina
Riu	ryu
Roma	roma
Roza	roza
SIN	siN
SV	Esve
Samsung	samsung
Sanchez	sanCez
Sasaki	sasaki
Seco	seko
Shanayah	Sanayah
Shariska	Sariska
Softball	softball
Spearfishing	spearfiSing
Sportsubsidie	sportsubsidye
Star	star
Strategico	stratexiko
Suites	suytes
TOB	tob
Texas	teksas
Thornton	thorntoN
Timeshare	timeSare
Utrecht	utreCt
VIP	vip
Vallejo	valleyo
Virma	virma
Visitor	visitor
Vivienda	vivyenda
Voetbal	vutbal
Welcome	welkome
Wheels	whels
William	willyam
Wilmer	wilmer
Wim	wim
Wingo	wingo
Yen	yeN
Zeeland	zeland
aanwijzing	anwezing
abierto	abyerto
abusadornan	abusadornan
accionan	aksyonan
acomodacionnan	akomodasyonnan
acontecimento	akontesimento
acostumbrado	akostumbrado
actornan	aktornan
adress	adress
advertencianan	advertensyanan
afilia	afilya
afortuna	afortuna
afspraaknan	afspraknan
alinea	alinea
amante	amante
amargo	amargo
amputacion	amputasyoN
ana	ana
anos	anos
aportando	aportando
appel	appel
as	as
aspira	aspira
atraconan	atrakonan
aunque	aunkwe
ausente	ausente
automatisacion	automatisasyoN
aveo	aveo
avioneta	avyoneta
away	away
ba	ba
bachi	baCi
background	bakkgrownd
banana	banana
banki	banki
bankinan	bankinan
bilingual	bilingwal
bocht	boCt
bondad	bondad
bora	bora
boroto	boroto
boton	botoN
brainstorming	branstorming
brake	brake
briyante	briyante
cabesantenan	kabesantenan
cadaver	kadaver
canasta	kanasta
caotico	kaotiko
caracteristica	karakteristika
carnet	karnet
cashier	kaSyer
casinonan	kasinonan
cea	sea
chikitonan	Cikitonan
circo	sirko
clarificacion	klarifikasyoN
clausula	klausula
climatico	klimatiko
codering	kodering
colaboradornan	kolaboradornan
compacto	kompakto
comprendible	komprendible
condenabel	kondenabel
conociendo	konosyendo
conscientemente	konssyentemente
consehabel	konsehabel
consequencianan	konsekwensyanan
contrincante	kontrinkante
convivencia	konvivensya
cordial	kordyal
coreccion	koreksyoN
corrupcion	korrupsyoN
costumbra	kostumbra
crypto	kripto
cubico	kubiko
cuminzamento	kuminzamento
cumprado	kumprado
debilidad	debilidad
decepciona	desepsyona
deliberando	deliberando
desafionan	desafyonan
desagradable	desagradable
desaprobacion	desaprobasyoN
desconocinan	deskonosinan
descubrimento	deskubrimento
descuido	deskuydo
desicionnan	desisyonnan
desk	desk
destructivo	destruktivo
deteriora	deteryora
deterioro	deteryoro
dictadura	diktadura
direcion	diresyoN
distancing	distansing
dobla	dobla
du	du
ecologico	ekoloxiko
emailadres	emaladres
encuestion	enkwestyoN
enfermera	enfermera
entiteit	entitet
essencial	essensyal
excepto	ekssepto
exepcion	eksepsyoN
exihi	eksihi
experiencianan	eksperyensyanan
expertisio	ekspertisyo
explicitamente	eksplisitamente
eyriba	eyriba
factibel	faktibel
fenomenal	fenomenal
flaco	flako
frecuenta	frekwenta
fumiga	fumiga
furioso	furyoso
fuseer	fuser
grandioso	grandyoso
ham	ham
hanchi	hanCi
hardware	hardware
holoshi	holoSi
horcannan	horkannan
hortamento	hortamento
hortando	hortando
humamento	humamento
hungador	hungador
huramento	huramento
husga	husga
hygiene	hixyene
ijs	es
impulsa	impulsa
inaugural	inaugural
incidental	insidental
insecticida	insektisida
insistencia	insistensya
iregularidad	iregularidad
jingle	yingle
judicial	yudisyal
juf	yuf
juffrouwnan	yuffrowwnan
kabel	kabel
kantidat	kantidat
kens	kens
kual	kwal
lantando	lantando
lapso	lapso
lastima	lastima
lease	lease
leiding	leding
lesion	lesyoN
libra	libra
limpia	limpya
links	links
luchador	luCador
lunch	lunC
maligno	maligno
manehador	manehador
manifestante	manifestante
mano	mano
mantenimento	mantenimento
marina	marina
masalmente	masalmente
mastanto	mastanto
materianan	materyanan
mediacion	medyasyoN
mediconan	medikonan
mehorando	mehorando
men	meN
menasando	menasando
mescla	meskla
misanan	misanan
molinanan	molinanan
mondkapjes	mondkapyes
muestranan	mwestranan
murayanan	murayanan
new	new
news	news
niester	nyester
nominado	nominado
nucleo	nukleo
numeroso	numeroso
nutricion	nutrisyoN
ocupantenan	okupantenan
ook	ok
open	opeN
oponente	oponente
oradornan	oradornan
organisadornan	organisadornan
pabo	pabo
paradero	paradero
payaso	payaso
pedagogico	pedagoxiko
peligernan	pelixernan
penetracion	penetrasyoN
pertenencia	pertenensya
pesei	pese
piscador	piskador
piscina	pissina
planeando	planeando
planning	planning
ploeg	plug
plussers	plussers
pomp	pomp
pornada	pornada
postkantoor	postkantor
precis	presis
preocupacionan	preokupasyonan
presonan	presonan
privilegio	privilexyo
probabilidad	probabilidad
profesor	profesor
professional	professyonal
program	program
protega	protega
provincia	provinsya
rasonnan	rasonnan
ratifica	ratifika
rebiba	rebiba
recept	resept
refuerso	refwerso
refugiadonan	refuxyadonan
rehabilitacion	rehabilitasyoN
republica	republika
resistente	resistente
respiracion	respirasyoN
respuesta	respwesta
reunionan	rewnyonan
ridiculo	ridikulo
riesga	ryesga
rifnan	rifnan
rijnan	renan
risib鱈	risibi
roga	roga
romantico	romantiko
ronda	ronda
rondo	rondo
rumornan	rumornan
salarial	salaryal
salon	saloN
satisfactorio	satisfaktoryo
scuchando	skuCando
secrecia	sekresya
secura	sekura
seguramente	seguramente
servisio	servisyo
shift	Sift
siguramente	siguramente
simbolonan	simbolonan
simultaneamente	simultaneamente
sinceramente	sinseramente
site	site
situation	sitwatyoN
sobrepeso	sobrepeso
solicitante	solisitante
sostenedornan	sostenedornan
so単a	so5a
spiritual	spiritwal
sport	sport
spula	spula
stacion	stasyoN
sterilisa	sterilisa
store	store
strategianan	stratexyanan
structuralmente	strukturalmente
substancianan	substansyanan
t	te
talves	talves
tardanza	tardanza
tembla	tembla
timeshare	timeSare
tombola	tombola
traicion	trasyoN
tratamentonan	tratamentonan
triage	tryaxe
tumba	tumba
tume	tume
unidat	unidat
upgrade	upgrade
ventilacion	ventilasyoN
verboden	verbodeN
versus	versus
vet	vet
vice	vise
voucher	vowCer
werksternan	werksternan
w竪psait	wEpsat
ziek	zyek
zundra	zundra
