ha	ha
avei	abei
umi	umi
de	de
peteĩ	petei*
pe	pe
ary	ari
heta	heta
ko	ko
upe	upe
rupi	rupi
Ko	ko
oĩ	oi*
oiko	oiko
térã	tera*
jave	Zabe
ára	ara
katu	katu
táva	taba
chupe	Supe
guive	guibe
ambue	ambue
rehegua	rehexua
rehe	rehe
ikatu	ikatu
hikuái	hikuai
tetã	teta*
guasu	guasu
porã	pora*
ndive	Ndibe
tenda	teNda
oguereko	oxuereko
ramo	ramo
opa	opa
y	i
la	la
yvy	ibi
niko	niko
rire	rire
peve	pebe
tapicha	tapiSa
del	del
ñane	5ane
Umi	umi
hína	hina
ñande	5aNde
gotyo	gotio
ojapo	oZapo
rupive	rupibe
pegua	pexua
apytépe	apitepe
Péicha	peiSa
ava	aba
haguã	haxua*
hérava	heraba
Guarani	guarani
karai	karai
távape	tabape
San	san
oĩva	oi*ba
péicha	peiSa
amo	amo
mokõi	moko*i
hagua	haxua
Upe	upe
tembiapo	tembiapo
aty	ati
opyta	opita
oho	oho
ysyry	isiri
upépe	upepe
kuéra	kuera
Pe	pe
Ary	ari
Oĩ	oi*
oñepyrũ	o5epiru*
mymba	mimba
upéicha	upeiSa
ári	ari
hese	hese
ohasa	ohasa
ichupe	iSupe
orekóva	orekoba
tape	tape
Avei	abei
Paraguái	paraxuai
jey	Zei
ou	ou
oikóva	oikoba
ojejapo	oZeZapo
héra	hera
aja	aZa
ipype	ipipe
yvyra	ibira
kuña	ku5a
oike	oike
péva	peba
osẽ	ose*
Heta	heta
Nacional	na8ional
umíva	umiba
oreko	oreko
upéi	upei
voi	boi
José	Zose
opaichagua	opaiSaxua
chupekuéra	Supekuera
mbohapy	mbohapi
tapichakuéra	tapiSakuera
jepe	Zepe
ohupyty	ohupiti
opaite	opaite
óga	oxa
retãme	reta*me
guare	guare
ohechauka	oheSauka
terã	tera*
Juan	Zuan
Peteĩ	petei*
oipuru	oipuru
kóva	koba
ojehecha	oZeheSa
Ha	ha
La	la
oguerekóva	oxuerekoba
Paraguaýpe	paraxuaipe
pukukue	pukukue
che	Se
mboyve	mboibe
Upéicha	upeiSa
chugui	Suxui
guarã	guara*
hembiapo	hembiapo
peteĩha	petei*ha
retã	reta*
Paraguáipe	paraxuaipe
ambuéva	ambueba
hetaiterei	hetaiterei
tekove	tekobe
upéva	upeba
hetave	hetabe
tavayguakuéra	tabaixuakuera
tee	tee
upévare	upebare
omano	omano
pyahu	piahu
tuichavéva	tuiSabeba
ohai	ohai
tetãme	teta*me
Kóva	koba
jajuhu	ZaZuhu
oúva	ouba
Oguereko	oxuereko
pehẽngue	pehe*Ngue
katuete	katuete
yvate	ibate
árape	arape
Guasu	guasu
ku	ku
meve	mebe
mitã	mita*
km	keme
hague	haxue
oñemoĩ	o5emoi*
reko	reko
arandu	araNdu
ohóvo	ohobo
ojejapóva	oZeZapoba
opavave	opababe
El	el
heñói	he5oi
purahéi	purahei
oguahẽ	oxuahe*
tendápe	teNdape
tetãvore	teta*bore
tuicha	tuiSa
yvyty	ibiti
Kachíke	kaSike
mburuvicha	mburubiSa
vai	bai
yvypóra	ibipora
arýpe	aripe
oikove	oikobe
Carlos	karlos
javeve	Zabebe
ojapóva	oZapoba
oĩha	oi*ha
en	en
gueteri	gueteri
peteï	petei
ñorairõ	5orairo*
Amo	amo
Antonio	aNtonio
Upépe	upepe
akue	akue
opytáva	opitaba
oñemohenda	o5emoheNda
téra	tera
mbytépe	mbitepe
ojekuaa	oZekuaa
Pedro	pedro
tuichakue	tuiSakue
aranduka	araNduka
hekove	hekobe
hendápe	heNdape
hákatu	hakatu
irundy	iruNdi
opáichagua	opaiSaxua
Ára	ara
Tetã	teta*
oiméva	oimeba
López	lope8
morotĩ	moroti*
oime	oime
Táva	taba
ani	ani
ohóva	ohoba
omotenonde	omotenoNde
yma	ima
ypykue	ipikue
María	maria
Oñepyrũ	o5epiru*
ape	ape
ijyvy	iZibi
kuri	kuri
ningo	niNgo
General	general
hete	hete
Villa	billa
oikuaa	oikuaa
Ikatu	ikatu
katupyry	katupiri
ñepyrũ	5epiru*
Dr	dere
Karai	karai
Río	rio
Upéi	upei
asy	asi
el	el
mante	maNte
hembiapokue	hembiapokue
hũ	hu*
kuarahy	kuarahi
oñembohéra	o5embohera
renda	reNda
tekoha	tekoha
yva	iba
Museo	museo
Oiko	oiko
Ruta	ruta
hendive	heNdibe
ikatúva	ikatuba
mbarete	mbarete
omoheñói	omohe5oi
ryepýpe	riepipe
Yvy	ibi
guyra	guira
ojeheróva	oZeheroba
ojejuhu	oZeZuhu
omotenondéva	omotenoNdeba
sua	sua
ñandéve	5aNdebe
Ambue	ambue
Péva	peba
ichugui	iSuxui
jasypoapy	Zasipoapi
máva	maba
ndaikatúi	Ndaikatui
tero	tero
upérõ	upero*
iporãva	ipora*ba
paraguaya	paraxuaia
puku	puku
tavaguasu	tabaxuasu
Upévare	upebare
a	a
cm	8eme
jahecha	ZaheSa
jasypa	Zasipa
mymbakuéra	mimbakuera
ohecha	oheSa
pohã	poha*
tupão	tupa*o
Francisco	fran8isko
nde	Nde
ogueraha	oxueraha
rembiapo	rembiapo
Guaraníme	guaranime
Guerra	guera
aravo	arabo
hetã	heta*
ohasáva	ohasaba
ojeguereko	oZexuereko
tendáre	teNdare
Francia	fran8ia
Itúva	ituba
Luis	luis
Marangatu	maraNgatu
avakuéra	abakuera
iporã	ipora*
peteĩva	petei*ba
pype	pipe
ymaguare	imaxuare
Lengua	leNgua
los	los
oipytyvõ	oipitibo*
ojepuru	oZepuru
ojupi	oZupi
oĩháme	oi*hame
Tupã	tupa*
Universidad	unibersidad
henda	heNda
itúva	ituba
ojehero	oZehero
po	po
teko	teko
Ohai	ohai
jasy	Zasi
michĩ	miSi*
oikovéva	oikobeba
réra	rera
tetãnguéra	teta*Nguera
ypy	ipi
Ñande	5aNde
áva	aba
Ava	aba
Centro	8eNtro
Escuela	eskuela
Itavusu	itabusu
Manuel	manuel
apekue	apekue
atýpe	atipe
haguére	haxuere
haihára	haihara
oheka	oheka
retãygua	reta*ixua
tekotevẽ	tekotebe*
tuicháva	tuiSaba
Chaco	Sako
Tupão	tupa*o
isy	isi
itáva	itaba
kuñakarai	ku5akarai
omoñepyrũ	omo5epiru*
oñangareko	o5aNgareko
oñemoarandu	o5emoaraNdu
pa	pa
poguýpe	poxuipe
tendota	teNdota
jasypo	Zasipo
kavaju	kabaZu
mombyry	mombiri
ndaje	NdaZe
osẽva	ose*ba
reheve	rehebe
Colegio	kolexio
González	gon8ale8
Oreko	oreko
gobierno	gobierno
herakuã	herakua*
jasyporundy	ZasiporuNdi
kuatiahaipyre	kuatiahaipire
mayma	maima
ojeporu	oZeporu
ojogua	oZoxua
porãve	pora*be
tembiporu	tembiporu
ñu	5u
Arte	arte
Guaraní	guarani
Puerto	puerto
ao	ao
hetaite	hetaite
jasypateĩ	Zasipatei*
jasyrundy	ZasiruNdi
nunga	nuNga
oguata	oxuata
oisãmbyhy	oisa*mbihi
ojuka	oZuka
ombohovái	ombohobai
omoĩ	omoi*
rape	rape
tenondegua	tenoNdexua
ypykuéra	ipikuera
Brasil	brasil
Buenos	buenos
Félix	feliks
Rodríguez	rodrixue8
Santa	saNta
arte	arte
guarani	guarani
hasýva	hasiba
hina	hina
mborayhu	mboraihu
oheja	oheZa
oipurúva	oipuruba
ojehu	oZehu
oñondive	o5oNdibe
ruvicha	rubiSa
tavaygua	tabaixua
Che	Se
Dirección	direk8ion
Opa	opa
ijerére	iZerere
jaikuaa	Zaikuaa
kokuépe	kokuepe
mokõiha	moko*iha
omopyenda	omopieNda
paraguayo	paraxuaio
porãva	pora*ba
ykére	ikere
ñemoñare	5emo5are
Cerro	8ero
Jepémo	Zepemo
Kirito	kirito
akóinte	akoiNte
añete	a5ete
distrito	distrito
don	don
guasúpe	guasupe
haguépe	haxuepe
ikatuhápe	ikatuhape
jasyteĩ	Zasitei*
jerére	Zerere
ohechaukáva	oheSaukaba
oikéva	oikeba
sy	si
imemby	imembi
jepémo	Zepemo
marandu	maraNdu
o	o
oguejy	oxueZi
ojeikuaa	oZeikuaa
paha	paha
peteĩháme	petei*hame
pira	pira
pokõi	poko*i
rekove	rekobe
róga	roxa
yvytu	ibitu
yvýpe	ibipe
Ñane	5ane
Cultura	kultura
Tavakuairetã	tabakuaireta*
Tupãsy	tupa*si
agua	axua
añoite	a5oite
añónte	a5oNte
heko	heko
hesekuéra	hesekuera
ikatupyry	ikatupiri
ipukukue	ipukukue
iñembyatýva	i5embiatiba
jasypakõi	Zasipako*i
jasypoteĩ	Zasipotei*
ogueru	oxueru
oikuaauka	oikuaauka
okakuaa	okakuaa
techapyrã	teSapira*
tembipuru	tembipuru
ymave	imabe
Fernando	fernaNdo
Héra	hera
Mymba	mimba
Ysyry	isiri
avati	abati
avave	ababe
hóga	hoxa
kakuaa	kakuaa
ndaipóri	Ndaipori
ojerure	oZerure
okaháre	okahare
rete	rete
upérupi	uperupi
ymaite	imaite
ãva	a*ba
Educación	eduka8ion
Encuestas	enkuestas
Iporã	ipora*
Oime	oime
Paraguaýgui	paraxuaixui
Parana	parana
ae	ae
apytégui	apitexui
haimete	haimete
ipahápe	ipahape
jehai	Zehai
jára	Zara
mbyte	mbite
ojeipuru	oZeipuru
ojuhu	oZuhu
opavavépe	opababepe
pytagua	pitaxua
upevarã	upebara*
vaka	baka
viru	biru
ñana	5ana
Gaspar	gaspar
Gobierno	gobierno
Martínez	martine8
Mburuvicha	mburubiSa
Presidente	presideNte
Triple	triple
Upéva	upeba
arapy	arapi
are	are
e	e
hendáicha	heNdaiSa
ikatuha	ikatuha
imbarete	imbarete
ita	ita
jasykõi	Zasiko*i
jasypokõi	Zasipoko*i
jepi	Zepi
jeroky	Zeroki
mitãrusu	mita*rusu
música	musika
ndéve	Ndebe
ogueraháva	oxuerahaba
opurahéi	opurahei
oñembohérava	o5emboheraba
pyhare	pihare
rei	rei
río	rio
sa	sa
su	su
ã	a*
ñorãirõ	5ora*iro*
Amandaje	amaNdaZe
Caballero	kaballero
Ciudad	8iudad
Congreso	koNgreso
Hembiapo	hembiapo
II	ii
Ndaipóri	Ndaipori
Upérõ	upero*
apoha	apoha
arahaku	arahaku
arapokõindy	arapoko*iNdi
año	a5o
hapicha	hapiSa
hápe	hape
jopói	Zopoi
mandyju	maNdiZu
mbohapyha	mbohapiha
oguahẽva	oxuahe*ba
ohechakuaa	oheSakuaa
oipyhy	oipihi
ombohéra	ombohera
omohenda	omoheNda
ova	oba
político	politiko
pytã	pita*
pópe	pope
remiandu	remiaNdu
ruta	ruta
tendagua	teNdaxua
umía	umia
Censos	8ensos
Kuarahy	kuarahi
Paraguaya	paraxuaia
Paraguayo	paraxuaio
Tenda	teNda
añetehápe	a5etehape
guerra	guera
guýpe	guipe
itavusu	itabusu
iñambue	i5ambue
las	las
marangatu	maraNgatu
mávapa	mabapa
oiporavo	oiporabo
ombojoaju	omboZoaZu
omenda	omeNda
oñembyaty	o5embiati
pirapire	pirapire
pépe	pepe
reheguáva	rehexuaba
renondépe	renoNdepe
temiandu	temiaNdu
tetãygua	teta*ixua
tuja	tuZa
upégui	upexui
vore	bore
Amérika	amerika
Ijyvy	iZibi
Instituto	instituto
Mcal	mkal
Opyta	opita
cultura	kultura
hasy	hasi
hembiapópe	hembiapope
hemiandu	hemiaNdu
hovy	hobi
jajuhukuaa	ZaZuhukuaa
jevy	Zebi
kóicha	koiSa
mbaraka	mbaraka
mitãnguéra	mita*Nguera
ndikatúi	Ndikatui
ohasávo	ohasabo
ohaíkuri	ohaikuri
ohaíva	ohaiba
okaru	okaru
oky	oki
ombopu	ombopu
orekovéva	orekobeba
oñemoambue	o5emoambue
oĩhápe	oi*hape
rógape	roxape
upéichante	upeiSaNte
virus	birus
Ayala	aiala
Facultad	fakultad
Ferreira	fereira
Hesu	hesu
Heñói	he5oi
Kuña	ku5a
León	leon
Mburuvi	mburubi
Oñemoarandu	o5emoaraNdu
Paso	paso
apópe	apope
hekopete	hekopete
isýkatu	isikatu
kuatia	kuatia
kure	kure
léi	lei
obra	obra
oikotevẽva	oikotebe*ba
ojegueraha	oZexueraha
ojehechakuaa	oZeheSakuaa
ojeiko	oZeiko
para	para
reserva	reserba
siglo	sixlo
tavusu	tabusu
tĩgua	ti*xua
ñemuha	5emuha
Alto	alto
Diccionario	dik8ionario
Don	don
Flores	flores
Hekove	hekobe
Nueva	nueba
Omano	omano
Opaite	opaite
Peru	peru
Peteï	petei
Pindoráma	piNdorama
Solano	solano
artista	artista
chéve	Sebe
gueterei	gueterei
hógape	hoxape
jagua	Zaxua
jajapo	ZaZapo
jasyapy	Zasiapi
kamby	kambi
kuaa	kuaa
m	me
nacional	na8ional
ogakuéra	oxakuera
oguerúva	oxueruba
ojekuaáva	oZekuaaba
okápe	okape
omoambue	omoambue
omyakãva	omiaka*ba
oñorairõ	o5orairo*
paraguái	paraxuai
pire	pire
poteĩ	potei*
rembiapokue	rembiapokue
yvóra	ibora
ñemby	5embi
Alianza	alian8a
Asociación	aso8ia8ion
García	gar8ia
Ipukukue	ipukukue
Mariscal	mariskal
Para	para
Péa	pea
Radio	radio
Tetãvore	teta*bore
general	general
gui	gui
hembireko	hembireko
hetavéva	hetabeba
kilómetro	kilometro
meme	meme
metro	metro
mimi	mimi
mitãkuña	mita*ku5a
mm	meme
mokõive	moko*ibe
oikókuri	oikokuri
oipytyvõva	oipitibo*ba
oisãmbyhýva	oisa*mbihiba
ojeho	oZeho
ojepurúva	oZepuruba
ombojoajúva	omboZoaZuba
omoañete	omoa5ete
omoĩva	omoi*ba
oporandu	oporaNdu
oñemotenonde	o5emotenoNde
política	politika
rekuái	rekuai
rembiasa	rembiasa
ryguasu	rixuasu
teroja	teroZa
turismo	turismo
upeigua	upeixua
vove	bobe
Ñorairõ	5orairo*
ñorairõhára	5orairo*hara
Cardozo	kardo8o
Casado	kasado
Coronel	koronel
Departamento	departameNto
Fuerte	fuerte
Guasúpe	guasupe
Ojejapo	oZeZapo
Paraguaigua	paraxuaixua
Rio	rio
Rosario	rosario
Tape	tape
Ymave	imabe
Yvypóra	ibipora
colonia	kolonia
eíra	eira
hatã	hata*
iporãvéva	ipora*beba
jaipuru	Zaipuru
jeko	Zeko
kuatiápe	kuatiape
mbohapypa	mbohapipa
mboka	mboka
memby	membi
michĩvéva	miSi*beba
ministro	ministro
ohechávo	oheSabo
ojeporúva	oZeporuba
omboty	omboti
ombyaty	ombiati
omopyendáva	omopieNdaba
oñembokatupyry	o5embokatupiri
oñemopyenda	o5emopieNda
oñepyrũva	o5epiru*ba
poapy	poapi
rekoha	rekoha
rendápe	reNdape
resẽ	rese*
tata	tata
tavakuéra	tabakuera
upei	upei
upekuévo	upekuebo
yvýre	ibire
ñembosarái	5embosarai
Acosta	akosta
Aires	aires
Aty	ati
Estado	estado
Estados	estados
Estadísticas	estadistikas
Hetave	hetabe
Internacional	iNterna8ional
Los	los
Martín	martin
Miguel	mixuel
Omenda	omeNda
Retã	reta*
Superior	superior
Tavetã	tabeta*
Ymaguare	imaxuare
apañuãi	apa5ua*i
aporeko	aporeko
atã	ata*
aviõ	abio*
departamento	departameNto
estilo	estilo
haguãicha	haxua*iSa
hesa	hesa
hetáva	hetaba
ijapytépe	iZapitepe
ipuku	ipuku
jepokuaa	Zepokuaa
mbeguekatúpe	mbexuekatupe
mbói	mboi
militar	militar
motenondehára	motenoNdehara
ni	ni
ohendu	oheNdu
ojeguerekóva	oZexuerekoba
ojehai	oZehai
ojuehe	oZuehe
ovecha	obeSa
oñemoĩva	o5emoi*ba
peteĩteĩ	petei*tei*
porãite	pora*ite
poyvi	poibi
pueblo	pueblo
rague	raxue
rasy	rasi
reducción	reduk8ion
rembiasakue	rembiasakue
rérape	rerape
tembiapópe	tembiapope
tembiasa	tembiasa
túva	tuba
yvyramáta	ibiramata
Ñandejára	5aNdeZara
Ñu	5u
ápe	ape
área	area
ñemitỹ	5emit3*
Academia	akademia
Barrios	barios
Blas	blas
Decoud	dekoud
Díaz	dia8
Editorial	editorial
Franco	franko
Gral	gral
John	Zohn
Ku	ku
Léi	lei
Ministerio	ministerio
Mitã	mita*
Mora	mora
Ohasa	ohasa
Ojekuaa	oZekuaa
Parque	parke
Partido	partido
Pág	pag
Pérez	pere8
Ru	ru
Sociedad	so8iedad
Tapichakuéra	tapiSakuera
Umíva	umiba
chuguikuéra	Suxuikuera
colonial	kolonial
español	espa5ol
festival	festibal
haku	haku
ijapytepekuéra	iZapitepekuera
ijehegui	iZehexui
indígena	iNdixena
ipehẽngue	ipehe*Ngue
ipoguýpe	ipoxuipe
ipu	ipu
ipyahúva	ipiahuba
jere	Zere
jerovia	Zerobia
kokue	kokue
korapy	korapi
kuatiáre	kuatiare
kuñataĩ	ku5atai*
membykua	membikua
moĩmbaha	moi*mbaha
oikoha	oikoha
oikundaha	oikuNdaha
ojapókuri	oZapokuri
ojere	oZere
omanóva	omanoba
ore	ore
orekóvo	orekobo
oñangarekóva	o5aNgarekoba
oñehenói	o5ehenoi
oñeñangareko	o5e5aNgareko
oĩgui	oi*xui
oĩkuri	oi*kuri
petỹ	pet3*
porundy	poruNdi
potĩ	poti*
presidente	presideNte
resfrío	resfrio
sãmbyhyhára	sa*mbihihara
tasyo	tasio
tembiasakue	tembiasakue
tete	tete
tropa	tropa
tuguy	tuxui
upéa	upea
ypa	ipa
ysyrykuéra	isirikuera
yvyrágui	ibiraxui
ñemoarandu	5emoaraNdu
Ararova	araroba
Avakuéra	abakuera
Bertoni	bertoni
C	8e
Casa	kasa
Club	klub
Cultural	kultural
Estancia	estan8ia
Hákatu	hakatu
I	i
III	iii
Ipahápe	ipahape
Lorenzo	loren8o
Maíz	mai8
Montoya	moNtoia
Municipal	muni8ipal
Ojehecha	oZeheSa
Ojejuhu	oZeZuhu
Rafael	rafael
Rivarola	ribarola
Rosa	rosa
Santo	saNto
Techapyrã	teSapira*
XX	ekisekis
akã	aka*
angirũ	aNgiru*
apañuái	apa5uai
apohára	apohara
centro	8eNtro
civil	8ibil
comandante	komaNdaNte
cultural	kultural
da	da
disco	disko
do	do
educación	eduka8ion
estancia	estan8ia
guasuete	guasuete
hapichakuéra	hapiSakuera
herava	heraba
hetyma	hetima
hũngy	hu*Ngi
ijyvate	iZibate
ipire	ipire
itujavéva	ituZabeba
iñarandu	i5araNdu
iñemoarandu	i5emoaraNdu
ja	Za
jaha	Zaha
jehasa	Zehasa
joaju	ZoaZu
maymáva	maimaba
mbyky	mbiki
musical	musikal
ndoguerekói	Ndoxuerekoi
neporãva	nepora*ba
oguahẽvo	oxuahe*bo
ohenói	ohenoi
oimeraẽ	oimerae*
ojejuhúva	oZeZuhuba
ojoavy	oZoabi
omanda	omaNda
omboguata	omboxuata
omoañetéva	omoa5eteba
omoinge	omoiNge
omoñepyrũva	omo5epiru*ba
omyakã	omiaka*
omyasãi	omiasa*i
orquesta	orkesta
osë	ose
oñandu	o5aNdu
oñemoarandúva	o5emoaraNduba
programa	proxrama
rapicha	rapiSa
rapykuere	rapikuere
tava	taba
tavaguasúpe	tabaxuasupe
tavarandu	tabaraNdu
tendárupi	teNdarupi
tenonde	tenoNde
tetãmegua	teta*mexua
vaiete	baiete
Añetehápe	a5etehape
Bernardino	bernardino
Blás	blas
Bolaños	bola5os
Ciencias	8ien8ias
Este	este
Hete	hete
Jasy	Zasi
Militar	militar
Mokõi	moko*i
Omotenonde	omotenoNde
Opavave	opababe
Orden	orden
Paraná	parana
Patria	patria
Pindorama	piNdorama
Rabia	rabia
Ramón	ramon
Región	rexion
Sosa	sosa
Villarrica	billarika
Virgen	birxen
Vocabulario	bokabulario
Vyretáña	bireta5a
XIX	ksiks
XVIII	ksbiii
Y	i
Yma	ima
Yvate	ibate
arandupy	araNdupi
artesanía	artesania
asýva	asiba
chipa	Sipa
guaraníme	guaranime
guejyha	gueZiha
guitarra	guitara
hekoha	hekoha
ija	iZa
iména	imena
internacional	iNterna8ional
ipo	ipo
iporãitereíva	ipora*itereiba
iñakã	i5aka*
jehechakuaa	ZeheSakuaa
jeporu	Zeporu
juehegua	Zuehexua
juky	Zuki
kg	kexe
koty	koti
kurusu	kurusu
mburuvi	mburubi
muanduhe	muaNduhe
ohupity	ohupiti
ohupytýva	ohupitiba
oikohague	oikohaxue
oiporúva	oiporuba
ojapyhy	oZapihi
ojeguerohory	oZexuerohori
ojehechauka	oZeheSauka
ojejapoha	oZeZapoha
ojekuaavéva	oZekuaabeba
ojeporavo	oZeporabo
ojerereko	oZerereko
ojeréva	oZereba
okambúva	okambuba
ombyai	ombiai
omohechauka	omoheSauka
omoheñóikuri	omohe5oikuri
omoheñóiva	omohe5oiba
omoirũva	omoiru*ba
oveve	obebe
oï	oi
oñembohasa	o5embohasa
peteĩme	petei*me
pohãnohára	poha*nohara
pukukuépe	pukukuepe
puraheihára	puraheihara
purory	purori
puru	puru
público	publiko
reike	reike
ru	ru
social	so8ial
sãso	sa*so
tai	tai
tapére	tapere
tasyópe	tasiope
techaukarã	teSaukara*
tupãópe	tupa*ope
tĩ	ti*
uperire	uperire
ñangareko	5aNgareko
ñemano	5emano
ñembyasy	5embiasi
Ache	aSe
Andrés	aNdres
Artes	artes
Colonia	kolonia
Estadística	estadistika
Európa	europa
Gramática	gramatika
Grande	graNde
Guerrero	guerero
Guyra	guira
Haimete	haimete
Hetaiterei	hetaiterei
Histórico	historiko
Ipoty	ipoti
Ipype	ipipe
Irala	irala
Jesús	Zesus
Joaju	ZoaZu
Joaquín	Zoakin
Jorge	Zorxe
Junta	ZuNta
Loma	loma
Maria	maria
Mbohapy	mbohapi
Música	musika
Oike	oike
Oscar	oskar
Peteĩha	petei*ha
Primera	primera
Rojas	roZas
Roque	roke
Sur	sur
Tapicha	tapiSa
Techapyrãrõ	teSapira*ro*
Tesoro	tesoro
Tomás	tomas
Upehaguére	upehaxuere
VIII	biii
Villeta	billeta
Yegros	iexros
Yvyra	ibira
Yvyty	ibiti
apo	apo
aramirõ	aramiro*
atyguataha	atixuataha
ave	abe
carrera	karera
central	8eNtral
ejército	eZer8ito
estudio	estudio
grado	grado
guara	guara
guaraní	guarani
hembiasa	hembiasa
heseve	hesebe
hetãme	heta*me
ijyvatéva	iZibateba
ikatúma	ikatuma
ipy	ipi
ipópe	ipope
ituichakue	ituiSakue
jarýi	Zarii
karape	karape
karugua	karuxua
katuetei	katuetei
korapýpe	korapipe
mbyja	mbiZa
mi	mi
miembro	miembro
mokõivéva	moko*ibeba
métro	metro
norte	norte
ohupi	ohupi
ohupytývo	ohupitibo
ojeikuaáva	oZeikuaaba
ojejoko	oZeZoko
ojesareko	oZesareko
ojoguáva	oZoxuaba
oke	oke
omaña	oma5a
omboguapy	omboxuapi
ombohasa	ombohasa
omboyke	omboike
ombyatýva	ombiatiba
omoherakuã	omoherakua*
omoirũ	omoiru*
onohẽ	onohe*
oñembojoaju	o5emboZoaZu
oñemotenondéva	o5emotenoNdeba
oñepyrũma	o5epiru*ma
paje	paZe
periodista	periodista
pindo	piNdo
porãnguéra	pora*Nguera
primera	primera
pytu	pitu
revolución	rebolu8ion
santo	saNto
tapiaite	tapiaite
tekohápe	tekohape
tetãyguakuéra	teta*ixuakuera
tres	tres
tuichave	tuiSabe
tyeguasu	tiexuasu
upehaguére	upehaxuere
upéicharõ	upeiSaro*
ygarata	ixarata
yvága	ibaxa
Ñemby	5embi
ñemohenda	5emoheNda
ñemongakuaa	5emoNgakuaa
ñorairõme	5orairo*me
Apa	apa
Arahaku	arahaku
Arapytu	arapitu
Ateneo	ateneo
Benigno	benigno
Benjamín	benZamin
Campo	kampo
Capital	kapital
Castellano	kastellano
Cecilio	8e8ilio
Censo	8enso
Cháko	Sako
Chína	Sina
Domingo	domiNgo
Ejército	eZer8ito
Fernández	fernaNde8
Festival	festibal
Galeano	galeano
Garay	garai
Hyãsia	hia*sia
Imitã	imita*
Isla	isla
Joapykuéra	Zoapikuera
Joaty	Zoati
Juana	Zuana
Larrosa	larosa
Mundial	muNdial
Nde	Nde
Ojapo	oZapo
Oriental	orieNtal
Orquesta	orkesta
Oñemoĩ	o5emoi*
Plata	plata
Pèicha	peiSa
Roberto	roberto
Ruiz	rui8
Salemma	salemma
Salto	salto
Saussure	saussure
Tembiapo	tembiapo
Trinidad	trinidad
Tuicha	tuiSa
Uperire	uperire
Uruguái	uruxuai
Vera	bera
achegety	aSexeti
ama	ama
ambuére	ambuere
arapýpe	arapipe
arquitectura	arkitektura
avaite	abaite
barrio	bario
composición	komposi8ion
compositor	kompositor
concierto	kon8ierto
corriente	korieNte
crup	krup
derecho	dereSo
ferrocarril	ferokaril
guaréva	guareba
guasúre	guasure
hekohápe	hekohape
hembiapokuéra	hembiapokuera
hembiasakue	hembiasakue
henyhẽ	henihe*
heñóiva	he5oiba
hikuéi	hikuei
hokẽ	hoke*
hyepýpe	hiepipe
háicha	haiSa
ijehe	iZehe
ikatupyryvéva	ikatupiribeba
institución	institu8ion
intendente	iNteNdeNte
ipohýi	ipohii
ipukúva	ipukuba
jeguaka	Zexuaka
jehaipyre	Zehaipire
kesu	kesu
kuarahyreike	kuarahireike
kuarahyresẽ	kuarahirese*
kuñáme	ku5ame
kyhyje	kihiZe
mburuvichakuéra	mburubiSakuera
mbytetépe	mbitetepe
michĩva	miSi*ba
millones	millones
misión	mision
mitãme	mita*me
natural	natural
ndojapói	NdoZapoi
ne	ne
ogapýpe	oxapipe
ohayhu	ohaihu
oipota	oipota
ojehaíva	oZehaiba
ojehecháva	oZeheSaba
ojeipapaháicha	oZeipapahaiSa
ojoko	oZoko
okaraháre	okarahare
okára	okara
omboguatáva	omboxuataba
omohendáva	omoheNdaba
omombarete	omombarete
omosẽ	omose*
osyry	osiri
oñemosarambi	o5emosarambi
oñepyrũkuri	o5epiru*kuri
oñeñandu	o5e5aNdu
pakova	pakoba
papapy	papapi
pero	pero
poder	poder
popular	popular
poravopyre	porabopire
porãvéva	pora*beba
proyecto	proiekto
puerto	puerto
pumbyry	pumbiri
pyharépe	piharepe
pyre	pire
pytuhẽ	pituhe*
rogue	roxue
rural	rural
sistema	sistema
taipu	taipu
tapichakuérape	tapiSakuerape
techapyrãrõ	teSapira*ro*
tekovekuéra	tekobekuera
teróre	terore
tetãvorépe	teta*borepe
tiempo	tiempo
tyapu	tiapu
távagui	tabaxui
un	un
vaicha	baiSa
véima	beima
ymaguaréva	imaxuareba
ypýpe	ipipe
yso	iso
yvatevéva	ibatebeba
ºC	o 8e
ága	axa
ña	5a
ñemitỹrã	5emit3*ra*
ñemoambue	5emoambue
ýrõ	iro*
