de	d e
a	a
en	e n
que	k E
o	o
ye	y e
se	s e
os	o s
con	k o n
un	u n
una	u n a
la	l a
por	p o r
as	a s
lo	l o
como	k o m o
suya	s u y a
u	u
En	n
no	n o
son	s o n
ta	t a
ha	s i
suyo	s u y o
d	d
mas	m a s
tamién	t o m e e n
población	p o b l a n k i o n
los	l o s
habitants	h a b i t a n c
las	l a
dos	d o s
Ye	e
entre	e n t r e
pa	p a
fa	f a
La	a
bi	b i
más	m a
pero	p e r o
Se	e
yera	y e r a
estió	e s t i o
nombre	n o mb~ r e
dende	d e n d e
estar	e s t a r
gran	g r a
forma	f o r m a
encara	e n k a r a
i	i
dica	d i k a
parte	p e r t e
suyos	s u y o s
Tamién	a m i e n
puet	p u e ty~
sobre	s o o*
per	p e r
suyas	s u y a s
dimpués	d i m p u e
ciudat	i u d a t
fan	f a n
quan	k
pueden	p u e d e n
on	o n
ya	y a
tien	t i e n
troba	t r o b a
diferents	d i f e r e n c
termin	t E r m i n
atros	a t r o s
mesmo	m e s m o
més	m u
parti	p e r t i
tot	t o t
luenga	l u e n g a
servir	s e r k w 3 L i
han	h a n
fer	f e r
atras	a t a s
fue	f w e
tienen	t i E n e n
aragonés	a r a g o n e
ista	i s t a
anyos	5 o s
Bi	i
mientres	m i e n t r e
e	e
lugar	g a r
Manimenos	a n i m E n o s
baixo	b a i S o
bells	b e l a
luengas	l u e N a
tres	w a m i
latín	m u l e
Por	o r
del	d e l
puesto	p u e s t o
si	s i
mes	t i m 3 s
totz	k a t o nk~
Lo	o
iste	i s t e
enta	e n t a
muitos	m u i t o s
primera	p r i *
municipal	m u n i C i p a l
primer	p r i *
muit	m u i
sieglo	s i e L o
yeran	y e r i
nomás	n o m a
sin	s i n
río	r i o
feito	f e i t o
lugars	g a r
mayor	m a y o r
Sant	a n c
país	p a i
Un	n
Una	n a
francés	f r a n C i e
Dimpués	i m p u e
diz	d i z
heba	h 3 b a
muito	m u i t o
Zaragoza	a r a g o y a 7
numero	n u m e r o
mundo	m u n d o
asinas	a s i n a s
Los	o s
puede	p u e d e
grans	g r a n
metros	m e t r o s
norte	n o r t e
cada	k a d a
grupo	g n i n o
estato	e s t a t o
Aragón	r a g o n
formas	f o r m a s
estau	e s t a u
sobén	s o b e n
caso	k a s o
eixemplo	e i  3 mp~ l o
traza	tr~ a z a
zona	z o n a
cheneral	C e n e r a l
tiempo	t i e N p o
qui	k i
capital	k a p i t a l
traviés	t r a w i e
vida	v i d a
bien	b i e n
important	i m p o r t a nt~
sud	s u d
muitas	m u i t a s
part	p e r t
estando	e s t a n d o
regular	r e g u l a r
contra	r o n t r a
sistema	s i s t e m a
Dende	e n d e
ixo	i S o
Ista	s t a
menos	m E n o s
Con	o n
bellas	b e l l a
seguntes	s e g u n t e
le	l e
verbos	e r b o s
parola	p e r o l a
superficie	s u p e r f i k i e
m	m
rechión	r E c  o n
mayoría	m a y u r i a
tanto	t a n t o
No	o
ilesia	i l e s i a
alto	a l t o
prou	p r o u
Iste	s t e
fació	f a i o
territorio	t e r i t o r i o
millons	m i l l o* s
tener	t 3 n 3 q
casa	k a s a
historia	h i s t o r i a
teneba	t e n e b a
periodo	p e r i o t o
casos	k a s o s 3
castellán	k a s t e l l a a n
mesma	m e s m a
poder	p o d e r
dito	d i t o
Como	o m o
centro	C E n t r o
Encara	n k a r a
meyo	m e y o
países	p a i e
gosa	g o s a
guerra	g e r a
quantos	k a n t o s
veiga	f e i g a
segunda	s e g u n d a
tiene	t i E n E
verbo	e r b o
chunto	w a n t o
obra	o b r a
troban	t r o b a n
tipo	t i p o l a
Ta	a
bell	b e l o
Actualment	k t u a l m E n t
rei	r e i
quasi	k a s i
zonas	z o n a s
Entre	t r e
cinta	T i t a
parolas	p e r o l a
arredol	m a n e d o l
conchunto	r o n ch~ u n t o
personas	p e r s o n a s
punto	p u n t o
color	k o l o r
especies	e s p E kh~ a m e* i e
este	e s t e
ixe	i S 3
puestos	p u e s t o s
dita	d i t a
día	d i a
estioron	e s t i o r o n
vegadas	f e g a d 3 s
común	k o m u n
partir	p e r t i r
Estió	s t i o
Quan	u a n
toponimo	t o p o n i m o
Las	a s
Santa	a n t a
primers	p r i *
val	v a l
conoixito	r o n o i S i t o
grupos	g r u p o s
man	m a n t a
uns	m i a
carrera	k a r e r a
tiempos	t i e m p o s
municipio	m u n i C i p i o i
Son	o n
Tien	i e n
ni	n i
textos	t e S o s
Asinas	s i n a s
proceso	p r o k e s o
quantas	k a nt~ a s
esta	e s t a
garra	g a r a
palabras	p a l a b a s
prencipal	p m i n C i i p a l
familia	f a m i l i a
gosan	g o s a n
segundo	s e g u n d o
significa	s i g  k a
ciudatz	i u d a c
principal	p r i n k i p a l
unas	u n a s
vegada	f e g a d a
considera	k o s i d e r a
hue	h u e
pp	p p
De	e
debant	d e b a nt~ a y
importants	i m p o r t a n c
anyadas	5 a d 3 s
isla	i s l a
siempre	s i 3 mp~
fuoron	f w o k u
popular	p o p u l a r
vegatas	f e g a t a s
qualsiquier	k a l s i k i e r
bella	b e l a
li	l i
presenta	p r e s e nt~ a
trobar	t r o b a r
porque	p o r kw~ i
presencia	p r e s i n C i w a
The	e
actual	a k t u a l
función	f u n C i w o n
habió	h a b i o
prencipals	p m i n C i i p a d
posición	p o s i i o n
muerte	m u e r t e
nuevo	n u u s o
unidatz	u n i d a c
catalán	k a t a l a n
causa	k a u s a
cuerpo	kw~ e r p o
denominación	d e n o m i n a g a o n
especie	e s p E kh~ a m e* i e
fendo	f e n d o
miembros	m i e mb~ r o s
primeras	p r i * a s
total	t a t a l
María	a r i a
chenero	C e n e r o
localidat	l o k a l i d a t
tierra	t i e r a
muller	l l e r
diferent	d i f e r e n t
obras	o b a s
serie	s e r i e
altaria	a l t a r i a
amás	a m a
anyo	a n y o
cal	k a l
gubierno	g u b i E a n o
p	p
propia	p r o p i a
va	v a
cintas	T i t o s
orichen	u r i E N
poco	p o k o
quatre	k a t r e
central	C E n tr~ a l
millor	m i l l o r
movimiento	m o v i m i e n t o
qual	k a l
alemán	a l 3 m a n
istos	i s t o s
materials	m a t e r i a l
natural	n a t u r a l
qualques	k a l s o X
treballo	t r e b a l o
antigo	a n t i g o
chent	C e n t
cultura	k u l t u r a
pueblos	p u e b l o s
Republica	e p u b l i k a
todas	t o d a s
zaguers	z a g e r
Francia	r a n C i w a
conoixita	r o n o i S i t a
cuenta	kw~ e nt~ a
epoca	a p o k a
sufixo	s u f i S o
tradicional	i t r i w C i w r o n a l
aragonesa	a r a g o n 3 s a
campo	k a m p o
medieval	m e d i e b E l
nuclio	n u k l i o
seu	s e u
km	k m
Amás	m a
atra	a t r a
occidental	T i d e n t a l
provincia	p r o v i n C i w a
actualment	a k t u a l m E n t
animals	a n i m a l
relación	r e l a i o n
destacar	d e s t a k a r
fillo	b i l l o
final	f i n a l
manimenos	n i m E n o s
mar	m a r
construcción	k o s t r u C a i o n
linia	l i n i a
presonas	p r e s o n a s
anque	a* k E
casas	k a s a s
politica	p o l i t i k a
Mientres	i e n t r e
an	a n
anglés	a N l e
fin	f i n
oficial	o f i h i a l
elementos	l E l E m E n t o s
hai	h a i
material	m a t e r i a l
palabra	p a l a b r a
teneban	t e n e b a n
atro	a t r o
naixito	n a i S i t o
reino	r e i n o
Teruel	e r
referencia	r e f e r e n C i w a
veyer	e w u r
cantidat	k a n t i d a t
da	d a
luz	% i s
colla	k o ly~ a
les	l e
oriental	u r i n t a l
Tierra	i e r a
cosa	k o s a
ixas	i S o s
libro	b r o
local	l o k a l
posible	p o s i b l e
present	p r o w o
uno	u n o
Seguntes	e g u n t e
alavez	a l a v e z
orichinal	u r i C i n a l
sierra	s i e r a
tenió	o
resta	r e s t a
zaguer	c a G i a
Casa	a s a
castiello	k a s t i 3 l o
dialecto	d i a l e k t o
es	m 3 s
guaire	g u a i r
nombres	n o mb~ r e
territorios	t e r i t o r i o s
Unius	n i u s
Yera	e r a
feba	f e b a
ixa	i S a
sola	s o l a
Pero	e r o
Universidat	n i v e r i d a t
decir	d e l
tierras	t i e r a s
Si	i
días	d i 3 s
evolución	e v o b e l i o n
interior	i n t E r i o r
medievals	m e d i e v a l
muga	m u g a
plantas	p l a y i t o s
president	p r e s i d e n t
antigos	a n t i g o s
cinco	i nC~ o
estructura	e s t r u k t u r a
redolada	r e d o l a d a
situación	s i t u a i o n
solo	s o l o
Estaus	s t a u s
capacidat	k a p a k i d a t
istas	i s t a s
sieglos	s i e g l o s
dialectos	d i a l e k t o s
importancia	i m p o r s i k a n C i w a
lexico	l E n  o
propio	p r o p i o
Editorial	d i t o r i a l
Mapa	a p a
San	a n
base	b a s e
pueblo	p u e b l o
nacional	n a g a o n a l
producción	p r o C u k i o n
rechions	r E c  o* s
siga	s i g a
significau	s i g  k a u
situato	s i t u a t o
superior	s u p e r i o r
planta	p l a y i nt~ a
ser	s e r
costa	k o s t a
dicen	d i k e n
miembro	m i e mb~ r o
sino	s i n o
Europa	u r o p a
camín	k a m l e
chicota	c " i k o t a
clima	k l i m a
existe	" i s t e
griego	g r i e g o
menor	m E n o r
nueva	n u e v a
pasau	p a s a u
dreito	d r e i t o
edición	p i e d w C i w r o n
pocos	p o k o s
charra	C a r a
km²	k m a
Nacional	a c i o n a l
baixa	b a i x a
caracteristicas	k a r a k t E r i s t i k a s
dezaga	d e z a g a
municipios	m u n i C i p i o s
nunca	n u C a
toponimos	t o p o n i m o s
usos	u s o s
variedat	v a r i e d a t
antiga	a n t i g a
desembolique	d e s e m b o l i k E
social	s o k i a l
zaguera	z a g e r a
Este	s t e
Sindembargo	i n d e m b a l i m a g o
Titán	i t E n
actuals	a k t u a d
adintro	a d i t r o
conoixiu	r o n o i n u
islas	i s l a
musica	s i k a
tipos	t e p o s
totas	t a t o s
variant	v a r i a nt~
forman	f o r m a n
meya	m e y a
podría	p o ndr$ i a
villa	v i l l a
Consello	o* s e l o
amán	a m a n
antis	a n t i s
construyíu	k o s t r u y i u
dicir	d i k i r
ell	E l o
equipe	e k i p e
latina	l a t i n a
meses	S e
variants	v a r i a n c
versión	e r b o n
Antiparte	t e p i t e
José	o s e
chicotz	c " i k o c
feban	f e b a n
formación	f o r m a c i o n
igual	i g u a l
premios	p r e m i o s
presentan	p r e s e n t a n
recibe	r E c i b e
romances	r o m a n C i m 3 s
alta	a l t a
canta	k a nt~ a
comarca	k o m a r k a
ells	i L
parla	p a l a
termins	t E r m i n
tota	t o t a
tracta	tr~ a k t a
trobamos	t r o b a m o s
cabo	k a b o
deriva	d e r e
dreita	d r e i t a
espacio	e s p a i o
influencia	i n f n i n C i w a
mayo	m a y o
paso	p a s o
prencipió	p m i n C i w k o
realidat	r e a l i d a t
Ha	a
Imperio	p e r i o
Nueva	k i k " v a
creyar	k r e y a r
mullers	l l e r
Isto	s t o
autor	a u t o r
buena	b u e n a
condato	r o n d a t o
formato	f o r m a t o
idioma	d i o m a
televisión	t e l e i s i o n
van	v a n
Barcelona	a r k e l o n a
Fue	u e
Reino	e i n o
autors	a u t o r
batalla	b a t a ly~ a
conoixida	r o n o i S i d a
francesa	f r a n C i 3 s a
internacional	i n t E r n a g a o n a l
libel	b e l
nº	n
pas	p a s
recibió	r E c i b i o
representa	r e p r e s e nt~ a
temperatura	t e N p e r a t u r a
tornó	t o r n o
Bells	i L
conoix	r o n o i S
desambigación	d e s a m b i g a i o n
ella	m u S
temporada	t e m p o r a d a
facioron	f a i o r o n
fuent	f u e n t
italián	i t a l i n a n
piedra	p i e d r a
prencipalment	p m i n C i i p a l m E n t
quatro	k a t r o
cultural	k u l t u r a l
heban	h 3 b a n
planeta	p l a y i n e t a
plegar	p l e 7 a r
Gubierno	u b i E a n o
Historia	i s t o r i a
auguas	a u g u a s
chicot	c " i k o t
condicions	r o n d i i o* s
fillos	b i l l o s
haber	h a b e r
laco	l a  o
persona	p e r s o n a
poblacions	p o b l a n k i o* s
practica	p r a k t i k a
relativament	r e l a t i w a* m E n t
siguient	s i g i n t
tropas	t r o p a s
Gran	r a
Val	a l
chicotas	c " i k o t o s
clase	k l a s e
consideran	k o s i d e r i
disco	d i s k o
escrito	e s k r i t o
sociedat	s o k i e d a t
sía	s i a
vegata	f e g a t a
Ilesia	l e s i a
Per	e r
aC	a
diferencia	d i f e r e n C i w a
dirección	d i r E C i o n
escuela	e s k u e l a
especial	e s p E kh~ a m e* i a l
estilo	e s t i l o
lista	l i s t a
locals	l o k a d
naturals	n a t u r a d
plural	p l u r a l
sería	s e r i a
tercera	t E r u r a
tradición	i t r i w C i w r o n
Guerra	u e r a
arias	a ry~ a s
colors	k o l o r
comunidat	k o m u n i d a t
envueltas	e n e l t 3 s
fueras	f u e r a s
letra	l E t r a
millors	m i l l o r
nau	n a u
ríos	r i o s
teoría	t e o r i a
toda	t o d o a
vico	v i k o
Alto	l t o
Fa	a
beluns	b e l u n
cantas	k a nt~ a s
caracter	k a r a k t e r
districto	d i s t r i C t o
formar	f o r m a r
publico	p u b l i k o
quals	k a d
sistemas	s i s t e m a s
Chuan	w a n
Espanya	s p a 5 a
Navarra	a b a r a
especialment	e s p E kh~ a m e* i a l m E n t
hombres	h o mb~ r e
mida	m i d a
pasa	p a s a
relacions	r e l a i o* s
sentiu	s e n t i u
solament	s o l a m E n t
the	th~ e
Aragonesa	r a g o n 3 s a
Chuegos	h u i e g o s
Istos	s t o s
alemans	a l 3 m a n
anterior	a n t E r i o r
antes	a n c i
campos	k a m p o s
canto	k a nt~ o
chulio	C o t o
creyó	k a a
datos	d a t o s
dreitos	d r e i t o s
fuents	f u e n c
fácil	f a ky~ o i l
permite	p e r m i t e
plaza	p l a y i c a
presona	p r e s o n a
servicios	s e r i i o s
Fernando	E a n a n d o
Juan	u a n
Muitos	k i t o s
Pa	a
Sobrarbe	o b r a r b e
caracteristica	k a r a k t E r i s t i k a
conoixe	r o n o i S 3
división	d i v i s i o n
existencia	" i s t i n C i w a
fútbol	f a t b o l
lur	l u r
muita	m u i t a
musulmans	s u l m o n
tan	t a n
Istas	s t a s
aragoneses	a r a g o n e e
aria	a r i a
chinero	C i n e r o
disenyo	d i s a n y o
feitos	f e i t o s
mans	n
nuevas	n u e b E s
puntos	p u n t o s
royo	r o y o
seis	s e i s
Esta	s t a
Instituto	s t i t u t o
Roma	o m a
augua	a u g u a
control	r o n t r o l
cristians	k r i s t i a*
departamento	d e p i t a m e n t o
enerchía	i n i l l i a
literatura	t E r a t u r a
luengache	l u g a C e
mai	m a i
montanya	m o* t a 5 a
ninos	n i n o s
organización	u r g a n i r o i o n
papel	p a
politico	p o l i t  o
representación	r e p r e s e n t a q i o n
torre	t o r
chuga	C u g a
club	k l u b "
comuns	k o m m i a
edificio	  i o
existen	" i s t e i n
largo	l a r g o
leis	L e i s
quala	k a l a
romana	r o m a n a
tién	t i e n
tornar	t o r n a r
trazas	tr~ l a s
uso	u s o
apareixe	a p a r a i S 3
dencima	d e n C i i m a
diversas	d i e r s a s
elemento	l E l E m E n t o
huei	h u i e i
melitar	m e l i t a r
razón	r a z o n
romans	r o m a n
situau	s i t u a u
traducción	tr~ a d u k i o n
Hue	u e
blanca	b l a n k o a
comercial	k o * r i a l
cuenca	kw~ e n k a
decada	d e k a d a
estatos	e s t a t o s
estudio	e s t u d i o
fuerza	f u e r c a
humans	h u
maxima	m a x i m a
medio	m e d i o
modelo	m o d e l o
orden	u r d e n
prene	p r e n e
propiedat	p r o p i e d a t
siet	s i e t
simbolo	s i m b o l o
Cal	a l
Estudios	s t u d i o s
Norte	u r t e
anteriors	a n t E r i o r
antigas	a n t i x a s
categoría	k a t e g o r i a
clasificación	k l a s  k a i o n
dentro	d e n t r o
ermita	e r m i t a
espanyola	e s p a 5 o l a
idiomas	d i o m a s
indica	i n d i k a
isto	i s t o
numeros	n u m e r o s
parque	p i kw~ i
provién	p r o v i e n
radiz	r a d i z
sector	s e k t o r
setiembre	s e t i e mb~ r e
siguients	s i g i n c
simple	s i m p l e
situata	s i t u a t a
su	s u
unidat	u n i d a t
vista	v i s t a
zagueras	c a G  a s
Carlos	a r l o s
Rusia	u s i a
conchugación	r o n ch~ u g a i o n
convirtió	r o n v i r t i o
crovates	k r o v a i
dreitament	d r e i t a m E n t
economía	e k o n o m i a
espanyol	e s p a 5 o l
etc	e t
gracias	b o ch~ i 3 s
humana	h u m a n a
ideya	d e y a
lis	l i s
mugas	m u x a s
partiu	p e r t i u
produce	p r o C u k e
provincias	p r o v i n C i w 3 s
queda	k e d a
tradicionals	i t r i w C i w r o n a l
títol	t t o l
Libro	i b r o
Unión	n i o n
actividat	a k t i v i d a t
agora	a g o r a
equipes	e k i n a p e 7 e s
estudios	e s t u d i o s
exito	" i t o
grau	g r a u
imachen	i m a E N
inte	i n t e
libros	b r o s
metat	e
musical	s i k a l
naturaleza	n a t u r a l E z E
obchecto	o b C e k t o
ormino	o r m i n o
pasó	p a s o
prochecto	p r o C e k t o
programa	p r o g r a m a
publica	p u b l i k a
simplament	s i m p l a m E n t
tercer	t E r 5 i r a t
toponimia	t o p o n i m i a
vía	v i a
actividatz	a k t i v i d a c
contina	r o n t i n a
ditos	d i t o s
dominio	b i n i o
fase	f a s e
filla	b i l l a
fonetica	f o n e t i k a
occidentals	T i d e n t a l
populars	p o p u l a r
puerta	p u e r t e
puerto	p u e r t o
velocidat	v e l o v e l o i d a t
viven	v i v e n
Alemanya	l E m a 5 a
Cruz	r u
Internacional	t E r n a g a o n a l
arabe	a r a b e
barranco	b a r a*  o
carreras	k a r  a s
conserva	r o n e r v a
corrient	k o r
creiximiento	k r a i S i m i e n t o
edificios	  i o s
emperador	3 mp~ e r a d o r
fuerte	f u e r t e
largaria	l a r N a r i a
lei	l e i
partito	p e r t i t o
pasar	p a s a r
posteriors	p o s t E r i o r
rechimen	r E c  m e n
remató	r E m a t o
tenemos	t e n i m o s
terreno	t e r
torna	t o r n a
transporte	i t r i s p o r t e
China	h i n a
Institución	s t i t u i o n
Polonia	o l o n i y a
Totz	t o nk~
adverbios	a d e r b i E o s
codigo	k o d i g o
contacto	r o n t a  t o
emplego	3 mp~ l e g o
formau	f o r m a u
kilometros	k i l 3 e t r o s
leva	l e v a
marzo	m a r o
mesmos	m e s m o s
obchectos	o b C e k t o s
partis	p e r t i s
piet	p y E t
problemas	p l o b l 3 m a s
propios	p r o p i o s
suelo	s u e l o
Cada	a d a
Mundial	u n d i a l
Uesca	e s k a
altros	a l t r o s
carretera	k a r e t e r a
considerato	k o s i d e r a t o
creyación	k r e y a i o n
cucha	k u C a
ecetra	e T E t r a
estos	e s t o s
febrero	f e b r e r o
fins	f i n
fuellas	f u e y a
neerlandés	n e r xy~ E kw~ a nd~ e
prebas	p r e b a s
prener	p r 3 n 3 q
principals	p r i n k i p a d
situada	s i t u a d a
socials	s o k i a l
tema	t e m a
Catalunya	a t a l u 5 a
concepto	r o n C i e p t o
diversos	d i e r s o s
estas	e s t o s
feita	f e i t a
griegos	g r i g o s
independencia	i n d e p e n d e n C i w a
localidatz	l o k a l i d a c
mantener	m a n t 3 n 3 q
monesterio	m o* t a 5 3 S t E r i o
prencipio	p m i n C i w p i o i
presión	p r e s i o n
producto	p r o C u k t o
Miguel	i g
Muitas	k i t a s
Premio	r E m i o
al	a l
cheneralment	C e n e r a l m E n t
creye	k r e y e
et	e t
haiga	h a i g a
inferior	i n f e r i o r
información	i n h i o n
manera	m a n e r a
ocupa	o k u p a
peninsula	p e d i s u l a
podeban	p o d e b a n
presents	p r e s E nt~ u
probablement	p l o b a b l E m E n t
productos	p r o C u k t o s
propiedatz	p r o p i e d a c
ruso	r u s o
texto	t e S o
Atros	t r o s
Dica	i k a
composición	k o m p o s i i o n
districtos	d i s t r i C t o s
exterior	e S e r i o r
ganó	g a n o
griega	g r i e g a
incluye	i n k l u y e
mont	m o n t a 5 a
parabra	p a r a b r a
plega	p l e g a
plegó	p l e g o
relichión	r e l i C i o n
servicio	s e r i i o
sí	s i
talment	t a l m E n t
temas	t e m a s
Ana	n a
amplo	a m p l o
culturals	k u l t u r a d
debaixo	d e b a i S o
deciba	d e 7 i b a
ditas	d i t a s
independient	i n d e p e n d i e n t
marguin	m a* r g i n
masa	s m a s a
metal	m e t a l
movimientos	m o v i m i e n t o s
parlants	p a l a n c
plana	p l a n a
poquet	p o k e t
reis	r e i s
variedatz	v a r i e d a c
vecins	s k a* b nsw$ i
Antonio	t o o
Bosnia	o s n i a
Católico	a t o l i k o
Olimpicos	l i m p i k o s
Sierra	i e r a
cine	T i n e
competición	k o m p e t i i o n
comunidatz	k o m u n i d a c
cosas	k o s a s
emplegar	3 mp~ l e 7 a r
equivalent	e k i w a l e n t
estándar	e s t a nd~ a r
fuerzas	f u e r c~ 3 s
futuro	f u t u r o
infinitivo	i n f i n i t i b o
inicial	i n i C y a l
interpresa	i n t E r p r e s a
libre	b r e
nivel	n i v e l
occitán	T k i t E n
oficialment	o f i h i a l m E n t
pareix	p a r e i
participio	p e r t i i p i o i
preba	p r e b a
protección	p r o t e k i o n
pueda	p u e d a
resultau	r e s u l t 3
rete	r e t e
sigue	s i g w e
subchecto	s u b C e k t o
treballos	t r e b a l l o s
unica	u n i k a
verano	e r o
Atras	a s
Madrit	a d r e
altas	a l t 3 s
ampla	a m p l a
articlos	i t i k l o s
banda	b a n d a
carga	k a r g a
chunio	w a n i o
claro	k l a r o
cm	k m
cocina	k o k i n a
contino	r o n t i n o
continó	r o n t i n o
distancia	d i s t a n C i w a
estación	e s t a k i o n
freqüent	f r e k a t o
historica	h i s t o r i k a
honor	h o n o r
mena	m e n a
montanyas	m o* t a 5 a s
mundial	nd~ i a l
par	p a r
partes	p e r t e
podemos	p o d e m o s
representan	r e p r e s e n t a n
reyal	r e y a l
scientificos	S e e n t i f i k o s
selección	s e l e k i o n
sentito	s e n t i t o
serbos	s e r b o s
vechetación	f e 5  i o n
Castiella	a s t i 3 L a
Parque	a r kw~ i
Virchen	i r x e n
accions	a k i o* s
batería	b a t e r i a
cambra	k a mb~ r a
capa	k a p a
categorías	k a t e g o r i 3 s
charran	C a r
chelo	C e l o
corresponde	k o r e s p o nd~ e
dan	d a n
dar	d a r
diez	d i e z
dinastía	d i n a s t i a
divide	d i v i d e
ellas	e y a
grandaria	g r a n e a
indican	i n d i k a n
mos	n o S
politicas	p o l i t i k a s
prenió	p r e n i o
rematar	r E m a t a r
resistencia	r e s i s t i n C i w a
sonito	s o n i t o
tal	t a l
temperaturas	t e N p e r a t u r a s
unatra	u n a t r a
unión	u n i o n
veye	f e y e
vicos	v i k o s
álbum	a l b u m
Baixo	i S o
Edat	d a t
Martín	i t i
Revista	e i s t a
blanco	b l a*  o
calendata	k a l e n d a t a
cambeo	k a m b e o
clases	k l a e
comunicación	k o m u n i C i i o n
consiguió	k o s i g i o
costau	k o s t a u
distribución	d i s t r e i o n
industrial	u z i a l
ixos	i S o s
liga	l i g a
marca	m a* r k a
mica	m i C a
noviembre	n o v i e mb~ r e
oficials	o f i h i a d
pietz	p y E t
ran	r a
respecto	r e s p E kh~ a m e* t o
rusos	r u s o s
sobretot	s o o*  a t
terminación	t E r m i n a g a o n
trobaba	t r o b a b a e
valle	v a l
versions	e r b o* s
vocal	v o k a l
vocals	v o k a d
Ciudat	i u d a t
París	a r i
Santo	a n t o
Sud	u d
anyatas	5 a t a s
cambio	k a m b i o
chodigos	C o d i g o s
chuego	C u e g o
corona	k o r o n a
difuera	d i f u e r a
fuera	f u e r a
funcions	f u n C i w o* s
fusta	f u s t a
interpresas	i n t E r p r e s a s
linias	l i n i a s
només	n o m u
parlas	p a l a
parroquia	p e r o k i a
pico	p i k o
pocas	p o k a s
podeba	p o d e b a
preposición	p r e p o s i i o n
proviene	p r o v i e n e
remata	r E m a t a
salut	s a l u t
voz	v o
Francisco	r a n C i s k i s  o
Real	e a l
adchectivos	a d C e k t i v o s
and	a n d
baverán	b a b e r a n
cabeza	k a b e z a
cargo	k 3 y
consiste	k o ns~ i s t e
debito	d e b i t o
densidat	d e s i d a t
dificil	d i f i k i l
edat	e d a t
estructuras	e s t r u k t u r a s
formata	f o r m a t a
habitual	h a b i t u a l
horas	h o r a s
interna	i n t E r n a
levar	l e v a r
nuclios	n u k l i o s
personaches	p e r s o n a d m 3 s
prencipia	p m i n C i i p i a
primero	p r i *
problema	p l o b l 3 m a
restas	r e s t o s
roca	r o k a
rocas	r o k a s
rural	r u r a l
sección	s e k i o n
será	s e r a
ueito	u e i t o
von	v o n
Reyal	e y a l
University	n i v e r s i t
Valencia	a l e n C i w a
acción	a k i o n
aintro	i t r o
amuestra	a m u e s t r a
aspecto	a 8 p e n e k t o
aus	a u s
ciudadans	i u d a d a
clamau	k l a m a u
comercials	k o * r i a l
conseqüencia	k o s a q 3 i n C i w a
considerau	k o s i d e r a u
cursa	k u r s a
derivau	d e r i v a u
destaca	d e s t a k a
enantes	e n a n t e
escuelas	e s k u e l a
femenín	f a m E n i
franceses	f r a n C E e
numerosos	n u m e r o s o s
otomans	o t e
particular	p e r t i k u l a r
procesos	p r o k e s o s
produció	p r o C u i o
refiere	r e f i e r e
reina	r e i n a
sciencia	S e i n C i w a
series	s e r i
singular	s i n g u l a r
sol	s o l
tecnica	t e k n i k a
unatro	u n a t r o
vasco	v a s k o
victoria	v i k t o r i a
Cortz	u r c
Existen	S i s t e i n
John	o h E 5
New	e w a
Partito	i t i t o
bandera	b a n d e r a
canal	k a n a l
car	k a r
clamata	k l a m a t a
comarcas	k o m a l a s a
compuestos	k o m p u e s t o s
construccions	k o s t r u C a i o* s
diametro	d i m E t r o
director	d i r E C t o r
economica	e k o n o m i k a
europeu	u o p e u
fiestas	f i e s t o s
flors	f l o r
frent	f r e n t
lingüistica	l i N 3 i s t i k a
modelos	m o d e l o s
monedas	m o n e d 3 s
nueu	n u e u
orichinalment	u r i C i n a l m E n t
orientals	u r i n t a l
pais	p a i s
palacio	p a l a i o
posterior	p o s t E r i o r
premio	p r e m i o
presa	p r e s a
pronombre	p r o n o mb~ r e
román	r o m a n
roya	r o y a
to	t o
treballadors	t r e b a ly~ a d o r
vals	v a l
Campo	a m p o
Central	e n t r a l
Cheneral	h e n e r a l
Diccionario	i k i o n a r i o
Qualques	w E l d a s o X
activo	a k t i b o
aragonesas	a r a g o n e s a s
cambios	k a m b i o s
cara	k a r a
celulas	C E l u l a
conoixitos	r o n o i S i t o s
denguna	i s u r u n a
dios	d i o s
efecto	e f e k t o
escape	e s k a p e
estaus	e s t a u s
estausunidense	e s t a u s u n i d e s e
estrela	3 S t r e l a
exercito	" e r i t o
extensión	e S X o n
filmografía	b i l m o g r a f i a
gobierno	g o b i E a n o
instalacions	s t a l a i o* s
libres	b r e
mal	m a l
meridional	m e r i d i o n a l
modo	m o t o
puent	p u e n t
treballar	t r e b a y a r
volumen	v o l u m e n
Deriva	r i v a
Les	m 3 s
Manuel	a n
Press	r e s
alemana	a l 3 m a n a
anyada	5 a d a
arabes	a r a b e sy~ s
branca	b r a C a
chefe	C e f e
civil	i v i l
clara	k l a r a
colonias	k o l o n i a s
denominacions	d e n o m i n a g a o* s
documentos	d o k u m e n t o s
eslavos	e s l a v o s
familias	f a m i l i a s
fundamental	f u nd~ a m e n t a l
melitars	m e l i t a r
memoria	m e m o r i a
mm	m m
negra	n e g r a
nuevos	n u e v o s
pai	p a i
paz	p a z
pende	p e n d e
posibilidat	p o s i b i l i d a t
principio	p r i n k i p i o i
puyar	p u y a r
qualas	k a l a
quedó	k e d o
real	r e a l
recursos	r E C u r s o s
sale	s a l e
seguindo	s e g i d o
selvas	s e l v a s
sudeste	s u d a* 7
territorial	t e r i t o r i a l
tienga	t i E n g a
tradicionalment	i t r i w C i w r o n a l m E n t
unos	u n o s
Antimás	t i m a
Congreso	o N r e s o
Corona	o r o n a
Frusciante	r u s k i a n t e
García	a r T i a
Italia	t a l i a
Mas	a s
Nomás	o m a q a
Oriental	r i e n t a l
Zelanda	e l a n d a
belunas	b e l u n 3 s
calor	k a l o r
choven	C o p e n
chugadors	C o g a d o r
clasico	k l a s i k o
components	k o m p o n e n c
comportamiento	k o m p o r t a m i e n t o
conservación	r o n e r v a i o n
corresponden	k o r e s p o n d e n
cuentas	kw~ e n t a s
dengún	i s u r u n
escudo	e s k u d o
fenomeno	f e n o m E n o
imperio	i m p e r i o
mención	m E n C i w o n
menors	m E n o r
moderna	m o d E a n a
moderno	m o d E a n o
momento	m o p i N t o
peso	m i o
politicos	p o l i t i k o s
poseye	p o s e y e
principalment	p r i n k i p a l m E n t
pronunciación	p r o n u n C i w a i o n
propias	p r o p i a s
remonta	r E m o* t a
resultato	r e s u l t a t o
tardi	t a r d i
templo	t 3 mp~ l o
valor	v a l o r
Anque	n kw~ i
Centro	e n t r o
Dos	o s
Federación	e d e r a i o n
Mundo	u n d o
Museu	u s e u
aconsiguió	a k o s i g i o
avions	a g o y o* s
buen	b u e n
calidat	k a l i d a t
concentración	r o n C i tr~ a i o n
conoixitas	r o n o i S i t a s
considerata	k o s i d i n a
conta	r o n t a
culto	k u l t o
decenio	d e 7 o
dimensions	d i * ns~ i o* s
economico	e k o n o m i  o
emplegato	3 mp~ l e 7 a t o
escribir	e s k b i r
escrita	e s k r i t a
frase	f r a s e
historico	h i s t o i cy~ o
ilesias	i l e s i a s
incluyen	i n k l u y e n
institución	s t i t u i o n
ir	i r
luent	l u e n t
mesura	m e s u r a
negro	n e g r o
nobles	n o b l a m 3 s
nucleyar	n u k l e y a r
periglo	p e r i L o
personache	p e r s o n a C e
pieza	p y E z E
poca	p o k a
producen	p r o C u s e n
quiere	k i e r e
sers	s e r
subchuntivo	s u b w a n t i b o
transmisión	i t r i s m i s i o n
troles	t r o l e
valura	v a l u r a
vin	v i n
visto	v i s t o
vivir	v i k w 3 L i
Copa	o p a
España	s p a 5 a
Le	e
Palacio	a l a i o
Portugal	u r t u g a l
administrativa	a d m i n i s t r a t i v a
anyal	5 a l
aviento	a g o y e n t o
britanico	b r i t a n i k o
campión	k a f u k o n
cautivo	k a u t i b o
chirmán	C i r N n
cofadría	k o f a d r i a
conoixer	r o n o y " e a r
conquiesta	r o n k i e s t a
dició	d i k i o
diferencias	d i f e r e n C i w 3 s
esdevinió	e s b v i n i o
fabrica	f a b r i k a
famosa	f a m o s a
fuella	f u e y a
internacionals	i n t E r n a g a o n a l
investigación	i n v e s t i g a i o n
lacos	l a k o s
levan	l e b E n
lingüistico	l i N 3 i s t  o
lurs	l u r
menistro	m E n i s t r o
metodos	m e t o d o s
muralla	m u r a ly~ a
nueit	n u e i t
para	p a r a
permiten	p e r m i t e n
perén	p e r e n
plegoron	p l e g o r o n
polacos	p o l a  o s
profesionals	p r o f i S i o n a l
quedan	k e d a n
quedoron	k e d o r o n
razons	r a z o* s
scientifica	S e e n t i f i k a
semana	s e m a n a
sexual	s e S u a l
sirven	s i r a b e n
solar	s o l a r
tant	t a n t
terrestre	t e r a* 7
vocabulario	v o k a b u l a r i o
Academia	k a d e m i a
Bellas	e y a
Club	l u b "
Constitución	o s t i t u i o n
Lituania	i t u a n i a
Meya	e y a
Pireneus	i r e n e u s
Tot	o t
Tres	r e
Viena	i e n a
allora	a ly~ o r a
caracters	k a r a k t E r
castellana	k a s t e l a nz~ a
centros	C E n t r o s
clamada	k l a m a d a
colección	k o l e k i o n
comercio	k o * i o
conoixen	r o n o i S e n
conservan	r o n e r w a n
cubierta	k u b i e r t e
culturas	k u l t u r a s
derivaus	d e r e  u s
dioses	d i o e
dotze	d o c e
escribió	e s k m a Ch~ o  o
escritos	e s k r i t o s
etimolochía	e t i m o L o C i a
evitar	p i r i t a r
fiesta	f i e s t a
individuos	i n d i v i d u o s
industria	i d u s t r e
leyenda	l e y e n d a
literalment	t E r a l m E n t
longaria	l o N g a r i a
manca	n k a
maximo	m a x i m o
mezcla	m e z k l a
minchar	m i n C a r
musulmana	s u l m a n a
nacionals	n a g a o n a l
ocasions	k a s a  o* s
orichens	u r i t a C e n
parabras	p a r a b a s
periodos	p e r i o d o s
planas	p l a y i n 3 s
plegau	p l e 7 a u
poemas	p o e m a s
rasgos	r a s g o s
revista	r E i s t a
sexo	s e g o
usuarios	u s u a r i o s
versant	e r s i
Bell	E l o
Cambridge	a m b r i d g e
Chesús	h e s u
David	a b i d
Isabel	s a b e l
Suecia	k i k " i a
Torre	u r
Ya	a
aduya	a d u y a
alas	a l a
altras	a l a s
artistica	i t i s t i k a
campanya	k a m a 5 a
chusto	C u s t o
conflictos	r o n f l i k t o s
creya	k r e y a
curto	k u r t o
descendients	d e s k e n d i E nt~ u
diners	d i n e r
do	d o
documenta	d o k u m e nt~ a
educación	e d u k a i o n
eixemplos	e i  3 mp~ l o s
especials	e s p E kh~ a m e* i a l
etapa	e t a p a
feitas	f e i t a s
formando	f o r m a n d o
fuertes	f u e r t e
identidat	d e n t i d a t
ideyas	d e y a s
liquido	l i k i d o
naixió	n a i n o
necesidat	d e* k a* b e s i d a t
oracions	o r a i o* s
partitos	p e r t i t o s
producir	p r o C u l
programas	p r o g r a m a s
publicó	p u b l i C
quimica	k i m i k a
qué	k e
qüestión	q 3 e s t i o n
radices	r a d i k m 3 s
rechistro	r E c  s t r o
rusa	r u s a
sabe	s a b e
significato	s i g  k a t o
sinyal	s i n y a l
sufixos	s u f i S o s
tabla	t e y a n u s
tecnolochía	t e k n o l o C i a
tendencia	t e n d e n C i w a
tornan	t o r n a n
tuca	t u k a
verbal	e r b a l
árbols	g b o l
Alifonso	l i f o s o
Consellero	o* s  e r o
Esto	s t o
Huesca	u e s k a
Mequinenza	e k i n a m b e n z a
Mont	n t a 5 a
Natural	a t u r a l
Occidental	kh~  i d e n t a l
Saturno	a t u r n o
Toponimia	o p o n i m i a
agosto	a g o s t o
armenios	a r m E n i o s
brancas	b r o m a s a
cadaguna	k a d a g u n a
cheneración	C e n e r a i o n
chira	C i r a
conchunta	r o n ch~ u n t a
contexto	r o n t " t o
els	e l
emplegan	3 mp~ l e g a n
entidat	e n t i d a t
expansión	" k ns~ i o n
favor	f a v o r
fisica	f i s i k a
fonema	f o n i m a
fusión	f u s i o n
gas	x a s
humán	h u m a n
influencias	i n f n i n C i w 3 s
institucions	s t i t u i o* s
interpretación	i n t E r p r e t a i o n
latins	l a t i n
luita	l u i t a
moneda	m o n e d a
numerosas	n u m e r o s a s
octubre	o k t u o*
paper	p a  r
parar	p a r a r
perque	p e r kw~ i
piel	p i e l
posibles	p o s i b l e
prencipios	p m i n C i i p i o s
reciben	r E c i b e n
revolución	r E f o b e l i o n
ribera	b e r a
sala	s a l a
substantivo	s u b s t a n t i b o
superiors	s u p e r i o r
tamas	t o m o s
tarde	t a r d e
temporal	t e m p o r a l
teorías	t e o r i 3 s
tipico	C o* a* o
urbán	u r b a n
veyen	f e y e n
á	a
Atlas	L a s
Beluns	e l u n
Biblioteca	i b l i o t e k a
Cassini	n i i n i
Colección	o l e k i o n
Luna	u n a
Mayor	a y o r
Pirineo	r i i o
Segunda	e g u n d a
amuestran	a m u e s t r i
artistas	i t i s t a s
artistico	i t i s t  o
azul	a z u l
carne	k a r n
cerca	C E r k a
chenerals	C e n e r a d
chovens	C o p e n
clasica	k l a s i k a
complexo	k o m p l " o
considerar	k o s i d e r a r a
consonant	k o Th~ o n a nt~
contrario	r o n t r a r i o
cursas	k u r s a s
definición	d e f i n i C y o n
deixó	d e i  o
electrica	e l e k i cy~ a
escala	e s k a l a
esdevenió	e s i s u s k a i o
espacial	e s p a k i a l
espanyols	e s p a 5 o l
fegura	f e g u r a
figura	f i g u r a
finalidat	f i n a l i d a t
freqüencia	f r e k 3 i n C i w a
fundo	f u n d o
hombre	h o mb~ r e
imachens	i m o t a C e n
independients	i n d e p e n d i E nt~ u
interpretacions	i n t E r p r e t a i o* s
matrimonio	m a t r i m o* i o
mesmas	m e s m a s i
mil	m i l
morió	m o r i o
motivos	m o t i v o s
municipals	m u n i C i p a d
organos	u r g a n o s
parlan	p a l a n
partius	p e r t i u s
piedras	p i e d r o s
plan	p l a n k o
podrían	p o ndr$ i
portugués	p o r t u g e
prenioron	p r e n i o r o n
qualo	k a l o
refirme	r e f i r m e
relativa	r e l a t i v a
representar	r e p r e s e n t a r
respuesta	r e s p u e s t a
sinyals	s i 5 a d
tipica	t e p i k a
ubierto	u b i e r t o
verda	e r d a
viello	v i e l o
viene	v i e n e
viento	v i e n t o
web	w e
zaguerías	z a g e r i 3 s
Comité	a
División	i v i s i o n
Esquema	s k a m a
Estas	s t a s
Existe	S i s t e
Fabla	a b l a
Frank	r a n
General	e n e r a l
Luenga	u e n g a
Madrid	a d r i d
Países	a i e
Presenta	r e s e nt~ a
Salvador	a l v a d o r
amaneixió	a m a n e i n o
animal	a n i m a l
baixas	b a i S o s
buenas	b u e n 3 s
cadagún	k a d a g u n
cantón	k a n t o n
clubs	k l u b
collas	k o l l a
comparanza	k o m a r a n c a
competicions	k o m p e t i i o* s
comuna	k o m u n a
conoixius	r o n o i n u s
continental	r o n t i n e n t a l
corazón	k o r a z o n
cristiana	k r i s t i a n a
cruz	k r u
debe	d e b e
deixa	d e i  a
derivan	d e r i w a n
desapareixer	d e s a p a r e i  e r
emplegau	3 mp~ l e 7 a u
emplegos	3 mp~ l e g o s
encomenzó	e nC~ o m e n z o
esportes	e s p o r t e
estudeos	e s t u d e o s
expresión	" p r e s i o n
fablants	f a b l a n c
femenina	f a m E n i n a
formó	f o r o b e
grafía	g r a f i a
guerras	g e r a s
igualment	i g u a l m E n t
metano	m e t a n o
minerals	m i n e r a d
mitat	m i t a t
modernos	m o d E a n o s
motivo	m o t i b o
nativos	n a t i v o s
necesidatz	d e* k a* b e s i d a c
normal	n o r m a l
obtener	o b t 3 n 3 q
organismos	u r g a n i S m o s
pachina	p a C i n a
paisache	p a i s a C e
partidos	p e r t i d o s
pelo	p e l o
pobreza	p o b r E z E
podió	p o d i o
posteriorment	p o s t E r i o r m E n t
profesional	p r o f i S i o n a l
proposición	p r o p o s i i o n
ra	r a
reinos	r e i n o s
sierras	s i e r a s
suposa	s u p o s a
tecnicas	t e k n i k a s
verbals	e r C i C
verde	e r d e
Antis	t i s
Anvista	n i s t a
Fútbol	o k u t b o l
Mar	a r
Seu	e u
Socialista	T i a l i s t a
William	i ly~ i a m
amplaria	a m p l a r i a
articlo	i t i k l o
astí	a s t i
baloncesto	b a l o n C i e s t o
barrio	b a r o
basa	b a s a
belún	b e l u n
benasqués	b e n a s kw~ e
caballo	k a b a l o
cambeos	k a m b e o s
caza	k a z a
chacimientos	C a kw~ e i m i e n t o s
charrar	C a r r a r a
chents	C e n c
cheografica	C e o g r a f i k a
cognato	k o g i E 5 a t o
component	k o m p o
conchunción	r o n ch~ u n C i w o n
conciertos	r o n C y e r t o s
conoixencia	r o n o i S i n C i w a
conte	r o n t e
cuerpos	kw~ e r p o s
curva	k u r v a
decidió	d e 7 dy~ o
deixar	d e i  a r
describe	d e s k b e
discografica	d i s k o g r a f i k a
discos	d i s k o s
distinción	d i s t i n C i w o n
doncas	d o* a s a
du	d u
espectadors	e s p E kh~ a m e* a d o r
europeus	u o p e u s
familiar	f a m i l i a r
fauna	f a u n a
foneticas	f o n e t i k a s
guitarra	g i t a r a
hipotesi	h i p o t e s i
instrumento	s t r u m e n t o
licencia	l i k i n C i w a
lisos	l i s o s
literaria	t E r a r i a
mamiferos	m a m i f e r o s
masculín	s k u l u N n
medios	m e d i o s
n	n
necesariament	d e* k a* b e s a r i a m E n t
obchectivo	o b C e k t i b o
oral	o r a l
pensar	p e i r a r a
penya	p e n y a
perder	p e r d e r
piezas	p y E c~ 3 s
pista	p i s t a
pistas	p i s t a s
potencia	p o t e n C i w a
presentar	p r e s e n t a r
pronombres	p r o n o mb~ r e
radio	r a d i o
rechional	r e C i o n a l
recibir	r E c i b i r
relichiosas	r e l i C i o s a s
repuis	r e p u i s
restos	r e s t o s
rota	r o t a
tenendo	t e n e n d o
terrestres	t e r  u z i
uellos	 o s
unico	u n i C o
urbana	u r b a n a
Alavez	l a v e z
Aragonés	r a g o n e
Can	a n
Castellón	a s t e l l a o n
Diario	i a r i o
Espanyola	s p a 5 o l a
Europea	u r o p e a
Gara	a r a
Huei	u e i
Liga	i k a
Puet	u e ty~
York	u r
amaneixen	a m a n e i  e n
artificial	a r   i a l
autoridatz	a u t o r i d a c
auxiliar	 i l i a r
camins	k a m i n
cantaire	k a nt~ a i r
centrals	C E n tr~ a d
cercuito	T E r a kw~ i t o
chineses	C i n e e
clama	k l a m a
concello	r o n C i e l o
continar	r o n t i n a r
correspondient	k o r e s p o n d i e n t
curso	k u r s o
definir	d e f i n i r
deixando	d e i  a n d o
destacan	d e s t a k a n
diminutivo	d i m i n u t i b o
documentación	d o k u m e n t a q i o n
duque	d u kw~ i
ellos	 o s
esporte	e s p o r t e
estrelas	3 S t r e l a
europeas	u o p e a s
facilment	f a c i l m E n t
fembras	f a m b a s
fisico	f i s i k o
fizo	f i r o
frontera	f r o n t E r a
helenismos	h e l e n i S m o s
historicos	h i s t o r i k o s
leyer	l e y e r
macizo	m a c i r o
maratón	r a t o n
marcas	m a* r k a s
marcha	m a* r C a
mecanica	m e t a n i k a
mensaches	m e sh~ 3 C m 3 s
metodo	m e t o t o
midas	d 3 s
mira	m i r a
mui	m u i
norueste	n o r u a* 7
orichinals	u r i C i n a l
paretz	p a r e c
participoron	p e r t i k i p o r o n
particlas	p e r t i k l a
patrimonio	p a t r i m o* i o
personal	p e r s o n a l
pintura	p i t u r a
plans	p l a y i a
potencial	p o t e n C i w a l
publicación	p u b l i k a i o n
puertas	p u e r t o s
punta	p u n t a
reacción	r e a k i o n
relacionau	r e l a c i o n a u
relichioso	r e l i C i o s o
respectivament	r e s p E kh~ a m e* t i w a* m E n t
retz	r e c
sectors	s e k t o r
software	 tw~ a r e
standard	s t a n r d
tenioron	t e n i o r o n
tractato	tr~ a k t a t o
trescruzato	w a m i s k r u w Z a t o
ueste	u a* 7
variable	v a r i a b l e
vei	f e i
verdat	e r d a t
veyió	v b a o
visible	v i s i b l e
vive	v i v E
Alpes	l p e 7 e s
Bavera	E b e r a
Estato	s t a t o
Finlandia	i n l a n d i a
Gramática	r a m e t i k a
Grecia	r E c i a
Gredos	r e d o s
Khan	h a n
Londres	o ndr$ e
Nuestra	u e s t r a
Pedro	p i e d r o
Ramón	a m o n
Roya	o y a
Sol	o l
Sovietica	o v i e t i k a
Suiza	k i c a
Tradicionalment	r a d i k i o n a l m E n t
abril	a b " r i l
aconseguir	a k o n e g i r
actos	a k t o s
agricola	y i cy~ o l a
antimás	a n t i m a
autoridat	a u t o r i d a t
bizantins	b i s a n t i n
canals	k a n a l
castellano	k a s t e l a nz~ o
celebra	k e l e b r a
censo	C E s o
chacimiento	C a kw~ e i m i e n t o
cierto	C y e r t o
clamato	k l a m a t o
conflicto	r o n f l i k t o
consumo	k o s u m o
continent	r o n t i n e n t
describir	d e s k b i r
distinguir	d i s t i N g i r
doble	d o b l a e
documentau	d o k u m e n t a u
efectos	e f e k t o s
embotada	e m b o t a d a
escritura	e s k r i t u r a
eslavo	e s l a v o
esleito	e s l e i t o
esto	e s t o
etnografico	e t n o g r a f i k o
fierro	f i e r o
frisón	f r i s o n
fuego	f u e g o
fuese	f u e s e
funcionamiento	f u n C i w o n a m i e n t o
ganar	g a n a r
habría	h a b r i a
hemisferio	h e m i s f e r i o
hese	h e s e
instrumentos	s t r u m e n t o s
larga	l a r g a
lengua	l 3 N u a
masclos	s k l o s
mayors	m a y u r
meter	m e t e r
musicals	s i k a d
nomadas	n o m a d 3 s
normas	n o r m a s
paret	p i
parlar	p a l a r
patrón	p a t r o n
pinturas	p i t u r a s
platos	p l a y i t o s
plazas	p l a y i c~ 3 s
podioron	p o d i o r o n
prenen	p r e n e n
primerías	p r i * i 3 s
pus	p u s
quatreno	k a t r e n o
radiación	r a d i a i o n
realizar	r e a l i s a r
relacionaus	r e l a c i o n a u s
remontan	r E m o* t a y
replega	r e p l e g a
reptils	r e p t i l
rumán	r u m a n
salir	s a l i r
scientifico	S e e n t i f i k o
seguir	s e g i r
sirve	s i r a v e
tozal	t o z a l
trol	t r o l
variacions	v a r i a i o* s
viviban	v i v i b a n
vías	v i 3 s
Autonoma	u t o n o m a
Categoría	a t e g o r i a
Chapón	h a p o n
Chunto	h u n t o
Chusé	h u s e
Estos	s t o s
Felipe	e l i p e
Ixa	S a
Ixo	t "
Luis	k i s
Rumanía	u m a n i a
Valle	a l
Villa	i l l a
World	u r l
abaixo	a b a i S o
altos	a l t o s
amigos	a m i g o s
arco	a r k o
biens	s o N
bulgaros	l a r o s
caracteriza	k a r a k t E r i c a
casco	k a s k o
celtas	C E l t 3 s
chermanismos	C e r m a n i S m o s
complemento	k o m p l E m E n t o
completa	k o m p l e t a
constitución	k o s t i t u i o n
corrients	k o r e n c
costato	k o s t a t o
curtos	k u r t o s
cómo	b r u m o
dau	d a u
diario	d i a r i o
diccionario	d i k i o n a r i o
diftongo	d i f t o n g o
dura	d u r a
equipos	e k i p o s
escritas	e s k r i t a s
esportiva	e s p o r t i v a
estase	e s t a s e
exposición	" p o s i i o n
fabricación	f a b i cy~ a i o n
famoso	f a m o s o
finals	f i n a l
fruito	f r u i t o
historiadors	h i s t o r i a d o r
hora	h o r a
imperial	i m p e r i a l
indicar	i n d i k a r
intrés	i n t r e
locucions	l o k u k i o* s
maquinas	m a k i n 3 s
materia	m a t e r i a
mete	m e t e
mirar	m i r a r a
misión	m i s i o n
monts	m o* t a 5 a
muertos	m u e r t o s
nieu	n i e u
peixes	p a i S 3 m 3 s
pendendo	p e n d e n d o
pintor	p i n t o r
popularidat	p o p u l a r i d a t
preso	p r e s o
procesión	p r o k o n
prochectos	p r o C e k t o s
profesor	p r o f i S o r
protagonista	p r o t a g o n i S th~ a
ret	r e t
rock	r o k
romanico	r o m a n i k o
ropa	r o p a
salita	s a l i t a
sangre	s a n g r e
scenario	s k e n a r i o
seguiu	s e g i u
sigan	s i g a n
siguen	s i g u e n
sinyor	s i n y o r
sovietico	s o v i e t  o
termino	t E r m i n o
termín	t E r m l e
terrenos	t e r  o s
transición	i t r i s i i o n
tribus	t r i b u s
universal	u n i v e r s a l
universidat	u n i v e r i d a t
vez	p e m u
viella	v i e y a
visigodos	v i s i k a t o s
Adintro	d i t r o
Baixos	i S o s
Campionato	a m p i o n a t o
Chusticia	h u s t i i a
Concello	o C E l o
Consultato	o* s u l t a t o
Diputación	i p u t a i o n
Don	o n
Fuent	k i k " a 5 a
Gobierno	o b i E a n o
Grupo	n i n o
Hongría	o N r i a
Kirk	i r
Maria	a r i a
Mexico	e n  o
Oxford	S h d
Parlamento	a r l a m e n t o
Peninsula	s u l a
Primera	r i *
Pueden	u e d e n
Ribagorza	i b a g o L a
Street	a
actriz	a k t r e
anyals	5 a d
aplicacions	a p l i k a i o* s
baixar	b a i S a r
be	b e
belatros	b e l a t r o s
bispe	b i s p e
blancas	b l a n k o 3 s
bomba	b o m b a
caballos	k a b a l l o s
cabalto	k a b a l t o
cadena	k a d e n a
capaz	k a p a z
catolicos	k a t o l i k o s
chermanico	C e r m a n i k o
chirmans	C i r
ciclo	C i w C i l o
coda	k o d a
companyers	k o mp~ a 5 e r
composicions	k o m p o s i i o* s
concreto	r o n C i r e t o
controlar	r o n t r o l a r
costera	k o s t E r a
creixer	k r e i  e r
cubilar	k u b i l a r
decisión	d e 7 i s i o n
dentrada	d e n t r a d a
depresión	d e p r e s i o n
derivato	d e r i v a t o
dió	d i o
dolars	t o r a r
emplega	3 mp~ l e g a
esdevenindo	e s i s u s k n a S i
establió	e s t a b l i o
estadio	e s t a d i o
estudeo	e s t u d e o
exclusivament	" k l u s i w a* m E n t
existiba	" i s t i b a
facilidat	f a c i l i d a t
factors	f a k t o r
feble	f e b l e
federal	f e d e r a l
fenomenos	f e n o m E n o s
fundador	f u n d a d o r
habitadors	h a b i t a d o r
habito	h a b i t o
hectarias	h e k t a r i a s
historicas	h i s t o r i k a s
humanas	h u m a n a s
iba	i b a
indicativo	i n d i k a t i b o
indichenas	i n d i t a C e n a s
interpretar	i n t E r p r e t a r
letras	l E t r 3 s
lexicos	l E n  o s
masiau	s i a u
menester	m E n e s t e r e n
menutos	m E n u t o s
militar	m i l i t a r
mosica	s i k a
motor	m o t o r
muro	u d o
musclos	s k l o s
noble	n o b l a e
ocupación	o k u p a i o n
pareixito	p e r a i S i t o
participios	p e r t i k i p i o s
partz	p e r t
permitió	p e r g i v o
perteneixe	p e r a i S 3
perteneixen	p e r t e n e i  e n
plato	p l a y i t o
popularment	p o p u l a s a y m 3 n t
pos	p o s
prenendo	p r e n e n d o
privar	p r i v a r
pronuncia	p r o n u n C i w a
publicacions	p u b l i k a i o* s
publicato	p u b l i k a t o
publicau	p u b l i k a u
pues	p u e
raso	r a s o
recient	r E C y e n t
recients	r E C y e n c
reconoiximiento	r E c o n o i x i m i e n t o
recuperar	r E C u p e r a r a
referencias	r e f e r e n C i w 3 s
reinato	r e i n a t o
relichions	r e l i C i o* s
relichiosos	r e l i C i o s o s
representant	r e p r e s e n t a nt~
representants	r e p r e s e n t a n c
respective	r e s p E kh~ a m e* t i v E
riqueza	r i k E z E
rurals	r u r a d
seguida	s e g i d a
sudueste	s u d u a* 7
tanyer	t a 5 e r
teniu	t e n i u
tensión	t e s i o n
tornada	t o r n a d a
torres	t o r m 3 s
totalment	t a t a l m E n t
tractau	tr~ a k t a u
ubierta	u b i e r t e
variar	v a r i a r
vien	v i e n
vita	v i t a
zifra	z i f r a
Agustín	g u s t i
Armenia	s a y m 3 n i a
Bretanya	r e t a 5 a
Cinca	i n k a
Española	s p a 5 o l a
George	e o r g e
India	n t i a
Louis	o u i s
Media	e d i a
Pueyo	u e y o
Red	3 d
Serbia	e r b i E a
Sistema	i s t e m a
Todas	o d a s
Turolenses	u r o l e n e
abundants	a b u n d a n c
acabaus	a k a b a u s
actuacions	a k t u a i o* s
anglesa	a N l 3 s a
armas	a r m a s
arredols	m a n e d o l
aspectos	a 8 p e n e k t o s
autonoma	a u t o n o m a
caixa	k a i x a
carta	k i t a
casó	k a s o
chelera	C e l e r a
chinés	C i n e
colonia	k o l o n i y a
considerada	k o s i d e r a d a
diferiencia	d i f e r i n C i w a
dividita	d i v i d i t a
divisions	d i v i s i o* s
ducato	d u k a t o
durando	d u r a n d o
economicos	e k o n o m i k o s
encomienza	e nC~ o m i e n z a
entibo	e n t i b o
esfensa	e s f s a
establita	e s t a b l i t a
formada	f o r m a d a
global	g l o b a l
gols	k o r
guión	g i o n
historicament	h i s t o r i C i C e n t
individual	i n d i v i d u a l
inferiors	i n f e r i o r
latinas	l a t i n 3 s
libertat	b e r t a t
luego	l u e g o
malautía	m a l a u t i a
masas	m a s a s
mediterrania	m e d i t e r a n i a
mercato	m e r k a t o
mercau	m e r k a u
molimento	o l i m e n t o
nacions	n a g a o* s
nombrato	n o mb~ r a t o
normalment	n o r m a l m E n t
ocupaba	o k u p a b a
orientación	u r i n t a i o n
paisaches	p a i s a C m 3 s
particularment	p e r t i k u l a s a y m 3 n t
pasando	p a s a n d o
pasoron	p a s o r o n
plegan	p l e g a n
portalada	p o r t a l a d a
posicions	p o s i i o* s
precipitación	p r E c i p i t a i o n
prefixo	p r e f i S o
presonal	p r e s o n a l
pro	p r o
rechistros	r E c  s t r o s
relaciona	r e l a c i o n a
reproducción	r e p r o C u k i o n
republica	r e p u b l i k a
reserva	r e s E r v a
revuelta	b e b u e l t a
récord	r e k o r d
serán	s e r a n
significaus	s i g  k a u s
sinonimo	s i n o n i m o
situacions	s i t u a i o* s
subespecie	s u b e s p E kh~ a m e* i e
substantivos	s u b s t a n t i v o s
sustantivos	s u s t a n t i v o s
tampoco	t a m p o k o
tradicions	i t r i w C i w r o* s
trafico	tr~ a f i k o
uello	u e l o
urbans	u r b i s
valors	v a l o r
victimas	v i k t i m a s
vivió	v i v i o
Atra	t r a
Barranco	a r a*  o
Chaime	h a i m e
Chapeto	h a p e t o
Chunta	h u n t a
Fernández	E a n a n d e z
Ferrando	e r a n d o
Imachen	m a E N
Ixe	S 3
Jean	e
Literatura	i t E r a t u r a
Loís	o i
Mesmo	e s m o
Más	a s
Orden	r d e n
Pablo	a b l u
Penya	5 e 5 a
Rei	e i
Representa	a p r e s e nt~ a
Robert	o b e r
Sinyora	i n y u r a
Tanto	a n t o
Tomo	o m o
agricolas	y i cy~ o l a
amplament	a m p l a m E n t
apareixen	a p a r e i  e n
aquell	a q u "
britanicos	b r i t a n i k o s
cadiera	k a d i e r a
calcula	k a l k u l a
cambras	k a mb~ a s
campionato	k a m p i o n a t o
cans	k a*
cantos	k a n t o s
capiella	k a p i e y a
caracteristico	k a r a k t E r i s t  o
cargos	k a r g o s
catalana	k a t a l a n a
cayer	k a y e r
chugador	C o g a d o r
cielo	C y e l o
civilización	i v i l i r o i o n
cobalto	k o b a l t o
coincide	k o m a i d e
coincidindo	k o m a a y a S i
combate	k o mb~ a t e
combinación	k o mb~ i n a g a o n
completo	k o m p l e t o
conchuncions	r o n ch~ u n C i w o* s
condatos	r o n d a t o s
condición	r o n d i i o n
constant	k o s t a nt~
constituye	k o s t i t u y e
construyó	k o s t r u a
contar	r o n t a r
contiene	r o n t i E n E
costas	k o s t o s
creyan	k r e y a n
cristianismo	k r i s t i a n i S m o
crosta	k r o s t a
crovate	k r o w a t e
cubierto	k u b i e r t o
curtas	k u r t o s
cutio	k u t i o
decadas	d e k a d 3 s
der	d e r
despoblato	d e s p o b l a t o
destín	d e s t i
dividen	d i v i d e n
dividito	d i v i d i t o
documento	d o k u m e n t o
emplegando	3 mp~ l e 7 a n d o
erosión	e r o s i o n
escriben	e s k r i b e n
escritor	e s k r i t o r
esdevenir	e s i s u s k a i r
esportistas	e s p o r t i s t a s
estreita	e s t r e i t a
expresar	" p r e s a r
fases	f a e
formacions	f o r m a c i o* s
formal	f o r m a l
fundó	f u nd~ o
fuyir	f u y i*
ganato	g a n a t o
gara	g a r a
hierba	hy~ e r b a
individuals	i n d i v i d u a d
irregulars	i r e g u l a r
italiana	i t a l i a n a
literario	t E r a r i o
malautías	m a l a u t i 3 s
marins	m a r i n
menas	m E n 3 s
mesa	m e s a
meyos	m e y o s
microtoponimos	m i C u t u p o n i m o s
morir	m o r i r
muros	r o s
museu	s e u
naixen	n a i S e n
naus	n a u s
nobleza	n o b l E z E
nombrau	n o mb~ r a u
pagar	p a x a r
patas	p a t a s
perfecto	p e r f e k t o
polaco	p o l a  o
practicament	p r a k t i k a m E n t
prencipiar	p m i n C i i p i a r
prencipioron	p m i n C i i p i o k u
principios	p r i n k i p i o s
probable	p l o b a b l e
productor	p r o C u k t o r
publicas	p u b l i k a s
puedan	p u e d a n
pueyo	p u e y o
puya	p u y a
qualos	k a l o s
quedando	k e d a n d o
quiesto	k i e s t o
raza	r a z a
reforma	r E h m a
representacions	r e p r e s e n t a q i o* s
residencia	r e s i d i n C i w a
responsable	r e s p o i r a r u w l e
restaurants	r e s t a u r a n c
risgo	r i s g o
romanas	r o m a n a s
romanica	r o m a n i k a
single	s i N l e
suma	s u m a
superficies	s u p e r f i C y e
tals	t a l
también	t a m b i e n
tiengan	g a n
titol	t i t o l
toneladas	t o n e l a d 3 s
tribu	t r i b u
trobada	t r o b a d a
títols	t t o l
venda	f e n d a
viva	v i v a
vivos	v i v o s
x	7
Astí	s t i
Baixa	i x a
Bielsa	i e l s a
Castiello	a s t i 3 l o
Cort	u r
Cristo	r i s t o
Cuenca	u e n k a
Cultura	u l t u r a
Cultural	u l t u r a l
Dios	i o s
Federal	e d e r a l
Festival	e s t i w a l
Fierro	i e r o
Filología	i l o l o g i a
Fuellas	u e y a
Henrique	e n r i k E
Historicament	i s t o r i C i C e n t
Hitler	i L e r
Joan	o a n
Macedonia	a C E d o n i y a
Manstein	s t o i n u r
Monte	b u* d a k
Pierre	i e r
Plan	l a n
Plana	l a n a
Records	e k o r d
Star	t a r
Sydney	y d n i
Tienen	i e n e n
Uniu	n i u
acceso	a k u s o
administrativas	a d m i n i s t r a t i v a s
alcuerdo	a l kw~ e r d o
alemanas	a l 3 m a n a s
alfabeto	a l f a b e t o
amigo	a m i g o
aproximadament	a p r o n l a p i N
arabismos	a r a b i s m o s
barrancos	b a r a nC~ o s
budismo	b u d i s m o
chuegos	C u e g o s
clau	k l a u
competencia	k o m p e t e n C i w a
conceptos	r o n C i e p t o s
conoiximiento	r o n o i x i m i e n t o
consello	r o n e l o
consideratos	k o s i d e r a t o s
constituyen	k o s t i t u y e n
contienen	r o n t i E n e n
contraste	r o n t r a s t e
correspondients	k o r e s p o n d i E nt~ u
creyoron	k r e y u r u n
criterios	k r i t E r i o s
criticas	k r i t i k a s
cuello	kw~ e l o
cultos	k u l t o s
cursos	k u r s o s
definiu	d e f i n i u
dentrata	d e n t r a t a
desapareixió	d e s a p a r e i n o
desembolicó	d e s e m b o l i C
desepara	d e s e p a r a
destacando	d e s t a k a n d o
difusión	d i f u s i o n
disenyos	d i s e 5 o s
diversidat	d i e r i d a t
edicions	p i e d w C i w r o* s
eleccions	e l e k i o* s
electrons	e l e k tr~ o* s
espectro	e s p E kh~ a m e* t r o
estacions	e s t a k i o* s
excepción	" u p i o n
ezquierda	d k i e r d a
faixas	f a i S o s
fama	f a m a
familiars	f a m i l i a r
ficción	f i k i o n
figurar	f i g u r a r
fixa	f i x a
formula	f o r m u l a
francico	f r a n C i w C i o
freqüents	f r e k 3 e n c
fruitos	f i t o s
funda	f u n d a
goyo	g o y o
gramatical	g r a m a t i k a l
gusto	g u s t o
habitan	h a b i t a n
homosexuals	h o m o s E r m a d
in	i n
industrias	u z i a s
intención	i n t e n C i w o n
intresant	i n t r e s a nt~
introducción	i n t r o C u k i o n
invasión	i n b E s i b o n
irregular	i r e g u l a r
italians	i t a l i a*
laterals	l a t e r a d
leit	L e i t
lingüisticos	l i N 3 i s t i k o s
magnitut	m a h n i t u t
mapa	m a p a
metals	m e t a l
metropolitana	m e t r o p o r i t a n a
meyana	m e y a n a
millón	m i l l o n
mirando	m i r a n d o
moleculas	o l k u l a
moros	m o r o s
nación	n a g a o n
noreste	n o r e s t e
novela	n o p e l a
obchectivos	o b C e k t i v o s
operación	o p e r a i o n
opinión	o p i n i o n
oración	o r a i o n
ordens	u r d e n
organo	u r g a
ortografía	u r t o g r a f i a
pareixe	p e r a i S 3
parroquial	p e r o k i a l
participación	p e r t i k i k i n i o n
pasato	p a s a t o
pastors	p a s t o r
patrimonials	p a t r i m o* i a l
permanent	p e r
pesca	m i C
pilota	p i l o t a
plastico	p l a y i s t  o
plena	p l e n a
posesión	p o s e s i o n
practicas	p r a k t i k a s
radar	r a d a r
rango	r a n g o
recibito	r E c i b i t o
relacionatos	r e l a c i o n a t o s
residents	r e s i d E nt~ u
seguridat	s e g u r i d a t
septentrional	s e p t E nt~ u z i o n a l
signos	s i g n o s
simbolos	s i m b o l o s
suposó	s u p o s o
te	t e
terminacions	t E r m i n a g a o* s
tornoron	t o r n o r o n
treballa	t r e b a ly~ a
treballan	t r e b a r u
treballó	t r e b a ly~ o
turco	t u r k o
túnel	t i r a
uga	u g a
variables	v a r i a b l e
viache	v i a C e
vivo	v i v o
vueito	v u e i t o
zaguero	z a g e r o
é	e
Aquí	k i
Archivo	r C i v o
Benedet	e n e d e t
Bohemia	h e m i a
Bulgaria	u l N a r i a
Crimea	l i m i a
Debito	e b i t o
Javier	a v i e r
Moldavia	o l d a v i a
Noruega	u r u e g a
Patrimonio	a t r i m o* i o
Paul	a u l
País	a i
Plaza	l a z a
President	r e s i d e n t
Revolución	e v o b e l i o n
Román	o m a q a n
Sancho	5 u k u n C o
Tenió	e n i o
Tién	i e n
Turquía	u r q u i a
Vicente	C " e l e n t e
Vlaquia	l a k i a
Zen	e n
adchectivo	a d C e k t i b o
afers	a f e r
alternativa	a l t E r n a t i v a
arquitectura	a r k i t e k t u r a
bronze	b r o n z e
calient	k a l i e n t
cargas	k a g i x a s
celebracions	k e l e b r a i o* s
cheneracions	C e n e r a i o* s
chermanicas	C e r m a n i k a s
chuntos	w a n t o s
cierta	C y e r t e
clamaus	k l a m a u s
clasifican	k l a s  k a n
colonización	k o l o n i r o i o n
columnas	k o l u m n 3 s
conchuntos	r o n ch~ u n t o s
conseguir	r o n e g i r
consonants	k o Th~ o n a n c
construir	k o s t r u i r
contes	r o n t e
cort	k o r
costatos	k o s t a t o s
costaus	k o s t a u s
coste	k o s t e
crei	k r e i
creixe	k r a i S 3
cristals	k r i s t a l
cubre	k u b r e
cucho	k u C o
curta	k u r t e
decenas	d e 7 e n 3 s
dentrar	d e n t r a r a
dentró	d e n t r o
dependendo	d e p e n d e n d o
descrito	d e s k r i t o
devez	d e p e m u
dients	d i E nt~ u
dificultatz	d i f i k u l t 3 c
difícil	d i f i Tw~ i l
diosa	d i o s a
directo	d i r E C t o
dispositivos	d i s p o s i t i v o s
duración	d u r a i o n
encomienzan	e nC~ o m i e n z a n
entidatz	e n t i d a c
equivalents	e k i w a l E nt~ u
esferencia	e s f m i n C i w a
estandar	e s t a n
etnico	e t n i k o
explica	" p l i k a
fembra	f e mb~ r a
ficacio	f i k a i o
fisicos	f i s i k o s
fundación	f u nd~ a i o n
graus	g r a u s
guitarrista	g i t a r s t a
habendo	h a b e n d o
habioron	h a b i o r o n
habiu	h a b i u
hongaros	h o N a r o s
legal	l e 7 a l
leito	L e i t o
localización	l o k a l i r o i o n
locución	l o k u k i o n
mando	m a n d o
mantenimiento	m a n t e n i m i e n t o
masculina	s k u l i n a
mayestro	m a y e s t r o
medallas	m e d a ly~ a
millas	m i l l a
mils	l
minoritaria	m i n o r i t a r i a
minorías	m i n o r i 3 s
muerto	m u e r t o
muestra	m u e s t r a
nacionalidat	n a g a o n a l i d a t
naixe	n a i S 3
ne	n e
nino	n i n o
operacions	o p e r a i o* s
ordinadors	u r d i n a d o r
organicos	u r g a n i k o s
pan	p a n
paralela	p a r a l e l a
pareixita	p e r a i S i t a
participan	p e r t i k i p a n
plataforma	p l a y i t a h m a
pobres	p o o*
poeta	p o e t a
precipitacions	p r E c i p i t a i o* s
prencipe	p m i n C i e p e
promoción	p r o m o i o n
publicos	p u b l i k o s
quatrena	k a t r e n a
quedar	k e d a r
quimicas	k i m i k a s
reflecta	r e f l e k t a
reglas	r e g l a
relatos	r e l a t o s
rematan	r E m a t a n
reservas	r e s E r v a s
resultaus	r e s u l t a u s
ritmo	r e m o
salas	s a l a
salen	s a l e n
scena	s k e n a
seguro	s e g u r o
seqüencia	s a q 3 i n C i w a
serbios	s e r b i E o s
sigla	s i g l a
simients	s i m i e n c
simpla	s i m p l a
simples	s i m p l e
sitúa	s i t u a
soldatos	s o l d a t o s
sonitos	s o n i t o s
sovietica	s o v i e t i k a
sovieticos	s o v i e t i k o s
substancia	s u b s t a n C i w a
tardano	t a r d a
teatro	t e a t r o
tenito	t e n i t o
treballando	t r e b a l l a n d o
trescruza	w a m i s k r u w Z a
urbano	u r b a
vechetals	f e 5  a d
vecinas	s k a* b i n 3 s
verticals	e r t i k a d
vesitants	f e s i t a n c
vientos	v i e n t o s
viviba	v i v i b a
Africa	f r i k a
Alta	l t a
Australia	u s t r a l i a
Canal	a n a l
Catalana	a t a l a n a
Consultau	o* s u l t 3
Ebro	b r o
Estatos	s t a t o s
Estau	s t a u
Fuentes	u e n t e
Galia	a l i a
González	n z a l e z
Guadalachara	u a d a l a C a r a
Guardia	u a r d i a
Guía	u i a
Herzegovina	e r z e g o v i n a
Ibn	b n
Jack	a k
James	a m e
Jesús	e s u
Leyón	e y o n
Madeira	a d e i r a
Mare	a r e
Martin	i t i n
Meyo	e y o
Millor	i l l o r
Nacions	a c i o* s
Naixitos	i S i t o s
Poco	o k o
Prensas	r E sh~ 3 s
Pérez	y e z
Road	o a d
Sin	i n
Tomás	o m a q a
Va	a
Vietnam	i e t n a m
Yugoslavia	u g o s l a v i a
actors	a k t o r
alimentos	a l i m e n t o s
altarias	a l t a r i a s
amés	a m u
apareixió	a p a r e i n o
arte	i t e
asociación	a s o* k a i o n
berbers	b E k
botigas	b o t i x a s
brazos	b r a z o s
cantidatz	k a n t i d a c
capas	k 3 p 3 s
capeza	k a p E z E
capitán	k a p i t E n
celebran	k e l e b r i
celula	C E l u l a
chaponés	C a p o n e
chenerico	C e n e r i k o
chentilicio	C e n t i l i i o
chermanicos	C e r m a n i k o s
cheso	C e s o
chica	c " i k a
chudicial	w a g w C i w r a l
cinematografica	i n e m a t o g r a f i k a
clarament	k l a r a m E n t
com	k o m
companyía	k o mp~ a 5 i a
complexos	k o m p l e S o s
comunas	k o m u n 3 s
conoixidas	r o n o i S i d 3 s
consigue	k o ns~ i a
continación	r o n t i n a g a o n
continoron	r o n t i n o r o n
convierte	r o n v i e r t e
cosacos	k o s a k o s
costumbres	k o s t u mb~ r e
crisi	k r i s i
critica	k r i t i k a
dando	d a n d o
declaró	d e 7  o
descubierto	d e s k u b i e r t o
determinar	d e t e r m i n a r
determinato	d e t e r m i n a t o
dichital	d i C i L a l
dificils	d i f i i l
dimana	d i m a n a
dispositivo	d i s p o s i t i b o
doctrina	d o k t r i n a
durada	d u r a d a
economicas	e k o n o m i k a s
electronica	e l e k t r o n i k a
emplegada	3 mp~ l e 7 a d a
escritors	e s k r i t o r
esdevenito	e s i s u s k a i t o
esleitos	e s l e i t o s
especifica	e s p E kh~ a m e*  k a
espelunga	e s p e l u N a
esportivas	e s p o r t i v a s
estable	e s t a b l e
estatus	e s t a t u s
estrato	e s t r a t o
etnonimo	e t n o n i m o
europea	u o p e a
eventos	e b e n t o s
explicación	" p l i k a i o n
expresa	" p r e s a
falla	f a ly~ a
falta	f a l t a
federación	f e d e r a i o n
fibra	f i b a b r a
flor	f l o r
foro	f o r o
francesas	f r a n C i e s a s
fósils	f o s i l
ganador	g a n a d o r
gosaba	g o s a b a
gubernador	g u b E a n a d o r
habrá	h a b r a
homosexualidat	h o m o s E r m a l i d a t
humanidat	h u m a n i d a t
imperativo	i m p e r a t i b o
infantil	i n f a nt~ i l
intensa	i n t e s a
intervención	i n t E r f e n C i w o n
latitutz	l a t i t u c
libels	b e l
lingüistas	l i N 3 i s t a s
líder	l i d e r
mantiene	m a n t i E n E
melitant	m e l i t a nt~
membrana	m e mb~ r a n a
mesuras	m e s u r a s
modernas	m o d E a n 3 s
mugants	m u g a n c
neolatinas	n e o l a t i n 3 s
nos	n o s
occitanismos	T k i t a n i S m o s
oposición	o p o s i i o n
orbita	u r b i t a
orichinau	u r i C i n a u
parcialment	p i r i a l m E n t
pareixidas	p e r a i S i d 3 s
particla	p e r t i k l a
partida	p e r t i d a
pasachers	p a s a S e r
pasan	p a s a n
pasos	p a s o s 3
pendient	p e n d i e n t
penyas	p e 5 a s
percepción	p e r e p i o n
perdió	p e r dy~ o
personals	p e r s o n a l
piensa	p y E s a
placas	p l a y i a s a
plevia	p l e v i a
polo	p o l o
positiva	p o s i t i v a
presonals	p r e s o n a l
principe	p r i n k e p e
propuesta	p r o p u e s t a
quitó	k i t o
recinto	r E c i t o
recuperación	r E C u p e r a i o n
relativos	r e l a t i v o s
representato	r e p r e s e n t a t o
romanización	r o m a n i r o i o n
saber	s a b e r
satelite	s a t e l i t e
scenas	s k e n 3 s
seguidors	s e g i d o r
segundos	s e g u n d o s
sentir	s e n o x e l
significativa	s i g  k a t i v a
solitario	s o l i t a r i o
solos	s o l o s
solución	s o b e l i o n
sovieticas	s o v i e t i k a s
subordinada	s u b o r d i n a d a
suficient	s u f i C y e n t
tercio	t E r i o
transformación	i t r i s h i o n
trobó	t r o b o
tunica	t u n i C a
une	u n e
utilizau	u t i l i z a u
variación	v a r i a i o n
violencia	v i o l e n C i w a
visión	v i s i o n
vivindo	v i v i n d o
vuelo	v u e l o
vuelta	v u e l t a
árbol	g b o l
Antón	t o n
Austria	u s t r e
Belunas	e l u n 3 s
Brasil	r a s i l
Broto	r o t o
Casas	a s a s
Cinco	m a o
Comarca	t a r k a
Conejero	o j e r o
Destaca	e s t a k a
Edad	d a d
Einstein	s t o i n u r
Escudo	s k u d o
Escuela	s k u e l a
Evolución	v o b e l i o n
Gosa	o s a
Hispania	i s p a n i a
Ligallo	i g a l o
Meseta	e s e t a
Monesterio	n e s t E r i o
Murcia	u r k i a
Nuevo	k i k " v o
Odiseu	d i s e u
Orichinalment	r i C i n a l m E n t
Paleolitico	a l e o l i t  o
Peter	e t e r
Podemos	o d e m o s
Posteriorment	o s t E r i o r m E n t
Prene	r e n e
Quasi	u a s i
Radio	a d i o
Recibió	e T i b i o
Secilia	e T i l i a
Su	u
Superior	u p e r i o r
Tiene	i e n e
Universitarias	n i v e r s i t a r i a s
Vaticano	a t i k a
Ventura	e n t u r a
Venus	e n u s
absoluta	a b " s o l u t a
achent	o t a C e n
acido	a c i d o
actuación	a k t u a i o n
actuar	a k t u a r
adaptación	a d a p t a i o n
administrativament	a d m i n i s t r a t i w a* m E n t
adultos	a d u l t o s
aerio	a e r i o
alazetz	a l a z e c
aldeyas	a l d e y a s
amaneix	a m a n e i
amariello	a m a r i e l o
ambient	a m b i e n t
apareixioron	a p a r e i n o r o n
armenia	a r m E n i a
arribar	a r b a r
artes	i t e
ataque	a t a k E
atletas	a t l e t o s
autoctona	a u t o k t o n a
bellos	b e l l o s
bizantín	b i s a nt~ l e
boca	b o k a
brazo	b r a z o
caballers	k a b a l l e r
cabecera	k a b e T E r a 7
cadenas	k a d e n 3 s
cambiar	k a m b i a r
capable	k a p a b l e
centimetros	C E n t i m E t r o s
chenetica	C e n e t i k a
cheografía	C e o g r a f i a
cheolochico	C e o l o C " i k o
chusticia	C u s t i i a
clasificar	k l a s  k a r
comité	k o m i t e 7
composau	k o m p o s a u
condicional	r o n d i k i o n a l
conoixió	r o n o i n o
considerablement	k o s i d e r a b l E m E n t
construito	k o s t r u i t o
continan	r o n t i n a n
costumbre	k o s t u mb~ r e
dato	d a t o
delta	d e l t a
des	d e
determinadas	d e t e r m i n a d 3 s
di	d i
distintas	d i s t i t o s
distintos	d i s t i n t o s
distribuye	d i s t r i b u y e
dominios	b i n i o s
duró	d u r o
emblema	e m b a l 3 m a
emplegata	3 mp~ l e 7 o
encluye	i n C i l u y e
equipo	e k i p o
era	e r a
esfuerzo	e s pw~ e r o
espacios	e s p a k i o s
esperanto	e s p e r a nt~ o
estreito	e s t r e i t o
etnica	e t n i k a
exclusiva	" k l u s i v a
exemplars	" 3 mp~ l a r
exitos	" i t o s
expedición	" p o w C i w r o n
externa	" t E r n a
ferrocarril	f e r o k a r i l
filosofía	b i l o  i a
firme	f E i r m e
flora	f l o r a
fluvial	f l u b i a l
foranos	f o r a n o s
formaban	f o r m a b a n
fuesen	f u e s e n
haigan	h a i g a n
hipotesis	h i p o t e s i s
humano	h u
impacto	i m p a k t o
individuo	i n d i v i d u o
insectos	s e k t o s
internos	i n t E r n o s
kg	k
lingüisticas	l i N 3 i s t i k a s
luitar	l u i t a r
luna	l u n a
mandato	m a nd~ a t o
mapas	m a p a s
medico	m e d i k o
mensache	m e sh~ 3 C e
minoría	m i n o r i a
miran	m i r i
misions	m i s i o* s
mitolochía	m i t o l o C i a
monarquía	m o n a r k i a
montanyosas	m o* t a 5 o s a s
mozarabe	m o z a r a b e
musclo	s k l o
musicos	s i k o s
musulmán	s u l N n
nomenclatura	n o p i n C i l a t u r a
norma	n o r m a
nuestro	n u a* 7
ocupan	o k u p a n
organismo	u r g a n i S m o
pareixiu	p e r a i S i u
parella	p i m u S
pars	p a r
partidarios	p e r t i d a r i o s
partido	p e r t i d o
perfectament	p e r f e k t a m E n t
piloto	p i l o t o
piso	p i s o
placa	p l a y i k a
planetas	p l a y i n e t o s
plano	p l a y i n o
plegada	p l e 7 a d a
plegando	p l e 7 a n d o
pleno	p l E n o
potencias	p o t e n C i w 3 s
presupuesto	p r e s u p u e s t o
produz	p r o C u
promeyo	p r o m e y o
propietario	p r o p i e t a r i o
proposicions	p r o p o s i i o* s
proposito	p r o p o s i t o
provenients	p r o w e n c
provienen	p r o v i e n e n
quadro	k i
razas	r a z a s
realiza	r e a l i c a
realment	r e a l m E n t
reals	r e a d
recipient	r E c i p i e n t
rector	r E c t o r
reformas	r e f o r m a s
relacionato	r e l a c i o n a t o
relativo	r e l a t i b o
representaba	r e p r e s e n t a b a
restauración	r a a  i o n
ronda	r o n d a
rotación	r o t a i o n
rotas	r o t o s
selva	s e l v a
semellants	s e m e y a n c
siglo	s i g l o
significar	s i g  k a r
sindembargo	s i n d e m b a l i m a g o
sinyors	s i n y u r
sobirán	s o b i r a n
sociedatz	s o k i e d a c
sonda	s o n d a
soniu	s o n i u
suelos	s u e l o s
testimonio	t e s t i m o* i o
tipicas	t e p i k a s
torismo	t o r i s m o
totalidat	t a t a l i d a t
tozuelo	t o z u e l o
traduccions	tr~ a d u k i o* s
transportar	i t r i s p o r t a r
tren	t r e n
trens	w a m i n
trobaban	t r o b a b a n
turcos	t u r k o s
vapor	v a p o r
varía	v a r i a
vertical	e r t i k a l
veyemos	f e y e m o s
viellos	v i e l l o s
vinient	v i
vivienda	v i v i e n d a
vuelos	v u e l o s
Altoaragoneses	l t o a r a g o n e e
Balbastro	a l b a s t r o
Belarrusia	e l a r s i a
Buena	u e n a
Chris	h r i s
City	i t
Comisión	o m i s i o n
Conseller	o* s  e r
Dreito	r e i t o
Fuerza	k i k " L a
Galitzia	a l i c i a
Gaulle	a u l
Jones	o i
Lei	e i
Negra	g r a
North	u r
Pacifico	a k   o
Peña	e ny~ a
Pilar	i l a r
Popular	o p u l a r
Praga	r a g a
Prencipió	r e n C i w k o
Reparo	a p a r o
Río	i o
Totas	o t o s
Ucraína	k r a i n a
Varsovia	a r S o v i a
abraca	a b " r a k a
abundant	a b u n d a nt~
acceder	a k C E d e r
achents	a E nt~ u
actor	a k t o r
administrativo	a d m i n i s t r a t i b o
aire	a i r
aon	a o n
apareixer	a p a r e i  e r
aquells	a q u m u S
aquí	a q u i
atmosfera	a t n o S f e r a
basica	b a s i k a
bispes	b i s p e 7 e s
cabos	k a b o s
caita	k a i t a
cambeó	k a m b e o
campanyas	k a m a 5 a s
campionatos	k a m p i o n a t o s
cantar	k a nt~ a r
cartas	k i t o s
catolica	k a t o l i k a
celta	C E l t a
ch	C
chaponesa	C a p o n 3 s a
cheografico	C e o g r a f i k o
chodiga	C o d i g a
chodigo	C o d i g o
cima	T i m a
coinciden	k o m a i d e n
colaboración	k o l 3 b u a o r a i o n
columna	k o l u m n a
composa	k o m p o s a
composadas	k o m p o s a d 3 s
concreta	r o n C i r e t a
conseqüencias	k o s a q 3 i n C i w 3 s
considerable	k o s i d e r a b l e
consideraus	k o s i d e r a u s
contextos	r o n t e S o s
continents	r o n t i n e n c
contién	r o n t i e n
copias	k o p i a s
correcta	k o r e k t a
correu	k o r e u
cortz	k o r c
costeras	k o s t E r 3 s
creyada	k r e y a d a
creyen	k r e y e n
debiu	d e b i u
decisions	d e 7 i s i o* s
definito	d e f i n i t o
deixan	d e i
denomina	d e n o m i n a
derivación	d e r e  i o n
desapareixe	d e s a p a r a i S 3
descripción	d e s k r i p i o n
deseparación	d e s e p a r a i o n
designa	d e s i g n a
designar	d e s i g n a r
dialectal	d i a l e k t a l
dialectals	d i a l e k t a l
dificultat	d i f i k u l t 3 t
dio	d i o
dirichita	d i r i C i n e n
disenyau	d i s e 5 a u
disponible	d i s p o n i b l e
distancias	d i s t a n C i w 3 s
distingue	d i s t i N g w e
dividiu	d i v i d i u
duques	d u s o X
eixe	a i S 3
electrico	e l e k i cy~ o
entorno	e n t o r n o
entrada	e n t r a d a
esdevinioron	e s b v i n i o r o n
eslavas	e s l a v a s
español	e s p a 5 o l
especificament	e s p E kh~ a m e*  k a m E n t
esportivos	e s p o r t i v o s
estratos	e s t r a t o s
estudiants	e s t u d i a c
etimolochica	e t i m o L o C i k a
etnicos	e t n i k o s
exposicions	" p o s i i o* s
facto	f a k t o
faina	f a i n a
fese	f e s e
feto	f e t o
figuras	f i g u r a s
fluvials	f l u b i a l
fondo	f o n d o
foranas	f o r a n a s
glandulas	g l a nd~ u l a
gol	g o l
golfo	k o r f o
gosaban	g o s a b a n
gramatica	g r a m a t i k a
guaires	g u a i r e
habla	h a b l a
hibiernos	h i b i E a n o s
hierarquía	hy~ e r a r k i a
historias	h i s t o r i a s
iban	i b a n
industrials	u z i a l
iu	i u
largos	l a r g o s
lechislativo	l e C i s l a t i b o
levó	l E f o
literarios	t E r a r i o s
mala	m a l a
maorís	m a o r i
maquina	m a k i n a
marinas	m a r i n 3 s
marrón	m a* r o n
masclo	s k l o
mayoritariament	m a y u r i t a r i a m E n t
me	m i
mencionan	m E n C i w o n a n
mencionato	m E n C i w o n a t o
metro	m e t r o
meyaus	m e y a u s
militars	m i l i t a r
ministro	m i n i s t r o
molimentos	o l i m e n t o s
muere	m u e r e
narancha	n a r a n C a
natal	n a t a l
ninvió	n i n i o
nombran	n o mb~ r i
novelas	n o s k u
obtenió	o b o
organizacions	u r g a n i r o i o* s
ortodoxa	u r t o d o s a
ortodoxos	u r t o d o s S o s
otomán	k o t o m a n
parellanas	p a r e y a n a s
participó	p e r t i k i p o
pasiva	p a s i v a
patrimonial	p a t r i m o* i a l
peix	p a i S 3
pensamiento	p e s a m i e n t o
periodico	p e r i o d i k o
permitir	p e r m i t i r
petrolio	p e t r o l i o
picos	p i k o s
poders	p o d e r
predominan	p r e d o m i n a n
presienta	p r e s i e nt~ a
primaria	p l i m a r i a
primavera	p l i m a b e r a
procesions	p r o k o* s
proteínas	p r o t e i n 3 s
psicolochía	p s i k o l o C i a
qualque	k a l kw~ i
quarta	k i t a
quimico	k i m i  o
relacionadas	r e l a c i o n a d 3 s
representau	r e p r e s e n t a u
resulta	r e s u l t a
revistas	r E i s t o s
romance	r o m a n C i e
romano	r o m a n o
romanz	r o m nz~ i
sabor	s a b e r
sape	s a p e
seccions	s e k i o* s
secreto	s e k r e t o
semellant	s e m e l l a n t i
sendicatos	s e n d i k a t o s
serían	s e r i
simient	s i m i e n t
sobiranía	s o b i r a n i a
solido	s o l i d o
sonora	s o n o r a
sus	s u s
tecnolochías	t e k n o l o C i 3 s
tematica	t e m a t i k a
tendría	t e ndr$ i a
terminolochía	t E r m i n o l o C i a
trachectoria	tr~ a C e k t o r i a
transmeso	i t r i s S o
trenta	w a m i n t a
trobato	t r o b a t o
troboron	t r o b o r o n
turquica	t u r k i k a
videos	v i d e o s
vins	v i n
votos	v o t o s
yo	r o x
être	e t r e
America	m e r i k a
Biescas	e s k a s
Cerro	e r o
Chaca	h a k a
Charles	h a l e
Comunidat	n i d a t
Costa	o s t a
Croacia	r o a c i a
Cup	u p
Democratica	e m o k r a t i k a
Dinamarca	i n a m a r k a
Domingo	o m i Ng~ o
Ella	L a
Els	d
English	N l i S
Enta	t a y
Fueva	k i k " v a
Fundación	u n d a i o n
Galicia	a l i i a
Galligo	a ly~ i g o
Han	a n
Jaime	a i m e
Karabakh	a r a b a k
Libre	i o*
Marilyn	a ry~ ly~ n
Martínez	i t x i a gw~ a
Molimento	o l i m e n t o
Montenegro	o t e n e g r o
Monts	o c
Municipal	u n i C i p a l
Nápols	a p o l
Organización	r g a n i r o i o n
Otomán	t o m a n
Pamplona	a m p l o n a
Quercus	u e r k u s
Respective	e s p E kh~ a m e* t i v E
Sciencias	C y e n C i w 3 s
Semana	e m a n a
Sinyor	i n y o r
Sobre	o o*
Talment	a l m E n t
Teneba	e n e b a
Tercera	e r u r a
Territorio	e r i t o r i o
Veïnat	e 3 n a t
accento	a k C E n t o
acidos	a c i d o s
activos	a k t i v o s
administrativos	a d m i n i s t r a t i v o s
afirma	a f i r m a
altament	a l t 3 m E n t
altra	a l t r a
amostranza	a m o s t r a n c a
amplas	a m p l a
analochía	a n a l o C i a
aniellos	a n i  o s
arriba	m a n i b a
atomos	a t u m o s
baile	b a i l e
basata	b a s a t a
bases	b a e
blancos	b l a*  o s
boiras	b o a s
bosniacos	s n i a k o s
cabal	k a b a l
calandario	k a l a n e o
calendatas	k a l e n d a t a s
calients	k a l i E nt~ u
campiona	k a m p i o n a
capiellas	k a p i e y a
capítol	k a p i t o l
causas	k a u s a s
cayen	k a y e n
celebrar	k e l e b r a r a
cercuitos	T E r a kw~ i t o s
chardín	C a r a n
charrau	C a r a u
cheneros	C e n e r o s
cheograficos	C e o g r a f i k o s
chugaban	C o g a b a n
cientos	C y e n t o s
cinqueno	T i n ky~ E n o
circulación	l r u l a k a i o n
civils	i v i l
claras	k l a r 3 s
colechio	k o l e C i o
comportamientos	k o m p o r t a m i e n t o s
composada	k o m p o s a d a
conoixeba	r o n o i S e b a
construita	r o n u z i n e n
contaminación	r o n t a m i n a g a o n
conteniu	r o n t e n i u
contrimuestra	r o n t r e m 7 o e s t r a
convertiu	r o n e r v u
copa	k o p a
creixen	k r e i  e n
cultismos	k u l t i s m o s
decreto	d e 7 r e t o
define	d e f i n e
definida	d e f i n i d a
demografica	d e m o g r a f i k a
dependencia	d e p e n d e n C i w a
derivar	d e r e  r
desaparición	d e s a p a r i C y o n
describen	d e s k r i b e n
desemboca	d e s a i mb~ o k a
despoblau	d e s p o b l a n k u
destacatos	d e s t a k a t o s
determinau	d e t e r m i n a u
dice	d i k e
dichitals	d i C i t a l
dieta	d i e t a
diya	d i y a
dominación	b i n a g a o n
dorsal	d o r s a l
eficient	e f i C y e n t
eixemplars	e i  3 mp~ l a r
electronicos	e l e k t r o n i k o s
empecipió	e m p E kh~ a m e* i p i o
entrenador	e n t r e n a d o r
eslecions	e s l e m i o* s
espacials	e s p a k i a l
especifico	e s p E kh~ a m e*   o
especificos	e s p E kh~ a m e*  k o s
esportivo	e s p o r t i b o
esquena	e s k e n a
establimiento	e s t a b l i m i e n t o
estatal	e s t a t a l
evident	p i r i d e n t
exacta	" a k t a
exercitos	" e r i t o s
factor	f a k t o r
faiga	f a i g a
fambre	f a mb~ r e
fesen	f e S e n
fisicas	f i s i k a s
fotografía	f o t o g r a f i a
franca	f r a C a
frases	f r a e
fruita	f n i n e n
funcional	f u n C i w o n a l
gana	g a n a
garras	g a r a s
golpe	g o l p e
gotico	g o t  o
grant	g r a nt~
gubiernos	g u b i E a n o s
habita	h a b i t a
horizontal	h o r i z o n t a l
ibons	i b o n
incluyindo	i n k l u y i d o
indoeuropea	i d o e u r o p e a
intelectual	i n t e l e k t u a l
labor	l a b e r
laboratorio	l a b o r a t o r i o
largas	l a r x a s
liberar	b e r a r a
linache	l i n a C e
mamifers	m a m i f e r
manifestacions	n i f e s t a k i o* s
manifiesta	n i f i e s t a
mantenió	m a n t e n i o
mantienen	m a n t i E n e n
marina	m a r i n a
masiva	s i v a
materna	m a t E r n a
mayestros	m a y e s t r o s
medida	m e d i d a
mental	m e n t a l
meridionals	m e r i d i o n a l
mesurar	m e s u r a r
minchan	m i n C a n
monesterios	m o* t a 5 3 S t E r i o s
montanyosa	m o* t a 5 o s a
mover	m o v e r i
mundials	nd~ i a l
murallas	m u r a ly~ a
muscular	s k u l a r
nacionalismo	n a g a o n a l i s m o
navegación	n a b e g a i o n
negativa	n e g a t i v a
nombrar	n o mb~ r a r a
nota	n o t a
notables	n o t t a b l e
noticias	n o t i i 3 s
nuestra	n u e s t r a
ocupando	o k u p a n d o
ocurre	o k u r
ofreixe	o f r a i S 3
ondas	d 3 s
opera	o p e r a
ordinador	u r d i n a d o r
papels	p a  d
parellas	p a r e ly~ a
peninsular	p e d i n r e p e n a r
perdiu	p e r d i u
perduga	p e r d u g a
plantilla	p l a y i n t i l l a
pobladors	p o b l a n k d o r
pobre	p o o*
podendo	p o d e n d o
poesía	p o e s i a
poquetz	p o k e c
poseyen	p o s e y e n
posiblement	p o s i b l E m E n t
pozos	p o i z o s
pre	p r e
prebatinas	p r e b a t i n 3 s
prefixos	p r e f i S o s
prencipiando	p m i n C i i p i a n d o
presas	p r e s a s
presentó	p r e s e n t o
presonache	p r e s o n a C e
previament	p b e b i m E n t
procede	p r o k e d e
procedents	p r o k e d E nt~ u
producito	p r o C u k i t o
protecher	p r o t e C e i r
qualidat	k a l i d a t
quarto	k i t o
quedau	k e d a u
quereba	k e r e b a
rechira	r E c  r a
recientment	r E C y e n t m E n t
reconoixita	r E c o n o i S i t a
reconquiesta	r E c o n k i e s t a
recorriu	r E c o r i u
recurso	r E C u r s o
refirmar	r e f i r m a r
reflexión	r e f l " i o n
regularment	r e g u l a s a y m 3 n t
relacionar	r e l a c i o n a r
requiere	r E k i e r e
rica	r i k a
salida	s a l i d a
santo	s a n t o
sciencias	S e i n C i w 3 s
sendero	s e n d e r o
sepoltura	s e p o l t u r a
setio	s e t i o
substancias	s u b s t a n C i w 3 s
sufrachio	s u f r a C i o
sur	s u r
sustancias	s u s t a n C i w 3 s
sían	s i
tartres	t a r t r e
tendrá	t e n d r a
tetulo	t e t u l o
tienden	t i e n d e n
tocar	t o k a r
toristico	t o r i s t  o
tramo	tr~ a m o
trampo	tr~ a m p o
transchenero	i t r i s t a C e n e r o
trobau	t r o b a u
turismo	t u r i s m o
uellas	u e y a
urbanas	u r b a n a s
usau	u s a u
valencia	v a l e n C i w a
vasca	v a s k a
vasos	v a s o s 3
vechetal	f e 5  a l
viviendas	v i v i e n d 3 s
volar	v o l a r
voluntarios	v o l u n t a r i o s
zarrar	z a r r a r a
án	a n
Adams	d a m
Aeria	e r i a
Albarracín	l bh~ a r a k l e
Alionor	l i o n o r
Apareixe	p e r a i S 3
Arredol	r e d o l
Asimov	s i m o N
Asinasmesmo	s i n a s S m o
Balcans	a l k a*
Banco	5 u k a o
Banks	a n k
Beach	E w e
Belchica	e l C i k a
Carmen	a r m e n
Chorche	h o r C e
Civil	i v i l
Confederación	o f e d e r a i o n
César	e s a r
Daroca	a r o k a
Departamento	a p i t a m e n t o
Die	i e
Finalment	i n a l m E n t
Fuente	u e n t e
Gupta	u p t a
Hu	u
Island	s l a n d
López	o p e z
Mallorca	o l  w E L E
Mediterrania	e d i t e r a n i a
Moncayo	n k a y o
Patrick	a t i cy~
Primer	r i *
Puede	u e d e
Puent	k i k " a 5 a
Puerta	 t a
Puerto	u e r t o
Quatre	u a t r e
Rafael	a f a e l
Ran	a n
Rechión	e T i o n
Recibe	e T i b e
Royal	o y a l
Saint	i nt~
Sellier	e ly~ i e r
Teatro	e a t r o
Teherán	e h e r a n
Tena	e n a
Universal	n i v e r s a l
Viello	i e l o
Villas	i l l a
acaban	a k a b a n
academicos	a c a d 7 e m i k o s
accidents	a k i d E nt~ u
adverbial	a d e r b i E a l
afecta	a f e k t a
africana	a f i cy~ a n a
altro	a l t r o
amanata	a m a n a t a
amaneixe	a m a n a i S 3
ambients	a m b i E nt~ u
americana	a m e r i k a n a
aquella	a q u m u S
asociacions	a s o* k a i o* s
atorga	a t u l g a
auxiliars	 i l i a r
avión	a g o y o n
basada	b a s a d a
basicament	b a s i k a m E n t
bebidas	b e b i d 3 s
biera	b i e r a
buenos	b u e n o s
busca	b u s k a t
cadieras	k a d i a a s
campesins	k a m T i N n E
capitals	k a p i t a l
catalans	k a t a l a n
caye	k a y e
chenerar	C e n e r a r a
chens	C e n
chovenil	C o p e n i l
chudicio	w a g w C i w r o
chugando	C o g a n d o
chunta	w a n t a
chóven	C o k b e n
ciertas	C y e r t o s
ciudadanía	i u d a d a n i a
clamatos	k l a m a t o s
clasicos	k l a s i k o s
clero	k l e r o
comarcal	k o m a r k a l
combina	k o mb~ i n a
combustible	k o m b u s t i b l e
comercios	k o * r i o s
completivas	k o m p l e t i v a s
complexa	k o m p l " a
compromís	k o m p r o m i
comunista	k o m u n i S th~ a
conducta	r o n d u k t a
confluyencia	r o n f l u y i n C i w a
confusión	r o n f u s i o n
consiguioron	k o s i g i o r o n
continentals	r o n t i n e n t a l
coordinador	k o r d i n a d o r
correr	k o r a r
creticas	k r e t i k a s
cruzada	k r u w Z a d a
cráter	k r o e r
cría	k r i a
cubren	k u b r e n
cuento	kw~ e n t o
data	d a t a
deben	d e b e n
decadencia	d E c a d 7 i n C i w a
defensa	d e f e s a
definita	d e f i n i t a
demanda	d e m a n d a
demás	d e m a
dentra	d e n t r a
depende	d e p e n d e
derivatos	d e r i v a t o s
descubrió	d e s k u b ry~ o
deseyo	d e s e y o
desintegración	d e s i n t e b o ch~ i o n
diaspora	d i a s p o r a
directa	d i r E C t a
disponibles	d i s p o n i b l e
dople	d o p l e
dormir	d o r m i*
duro	d u r o
elaboración	e l a b o r a i o n
electricos	e l e k i cy~ o s
emigración	e m i b o ch~ i o n
emigroron	e m i g r o r o n
emplegatos	3 mp~ l e 7 a t o s
empresa	3 mp~ r e s a
encargau	e n k a r g a u
encomenzoron	e nC~ o m e n z o r o n
eno	e n o
entalto	e n t a l t o
entero	e n t e r o
escandinavo	e s k a nd~ i n a b o
esfera	e s f e r a
especialidat	e s p E kh~ a m e* i a l i d a t
establir	e s t a b l i r
etz	e c
evidencia	p i r i d i n C i w a
exactament	" a k t a m E n t
existents	" i S t E nt~ u
extensions	e S X o* s
externos	" t E r n o s
fayena	f a y e n a
feguras	f e g u r a s
ferramientas	f e r a m i e n t a s
finalment	f i n a l m E n t
formatos	f o r m a t o s
fortaleza	f o r t a l E z E
fueros	f u e r o s
fundata	f u nd~ a t a
godos	k a t o s
gramaticals	g r a m a t i k a d
grano	g r o
gravación	g r a v a i o n
gravedat	g r a v e d a t
griegas	g r i e x a s
habituals	h a b i t u a d
hereu	h e r e u
hibierno	h i b i E a n o
ibn	i b n
implica	i m p l i k a
imposible	i m p o s i b l e
incluius	i n k l u i u s
incoativos	i n k o a t i v o s
indicador	i n d i k a d o r
ingredients	i N X i  e n c
ingresos	i N X i e s o s
inscripcions	s k r i p i o* s
internacionalment	i n t E r n a g a o n a l m E n t
invariable	i n v a r i a b l e
invasions	i n b E s i b o* s
investigacions	i n v e s t i g a i o* s
lanzamiento	l a n z a m i e n t o
lateral	l a t e r a l
lechislación	l e C i w a i o n
limfaticos	b u r f a t i k o s
liquida	l i k i d a
luengo	l u i Ng~ o
lunas	l u n 3 s
magnetico	m a j   o
manifestación	n i f e s t a k i o n
mantién	m a n t i e n
maritimo	m a r i t i m o
masculins	s k u l i n
medalla	m e d a ly~ a
mediterranio	m e d i t e r a n i o
microorganismos	m i C o r g a n i S m o s
microtoponimo	m i C u t u p o n i m o
mineral	m i n e r a l
minima	m i n i m a
molins	o l i n t
muebles	m u e b l e
murió	l i o
m²	m a
napas	n a p a s
narracions	n a r a i o* s
negativas	n e g a t i v a s
nivels	n i v e l
nominal	n o m i n a l
nusaltros	n u s a l t r o s
observar	o b e r v a r
oficio	o f i h i o
operativo	o p e r a t i b o
ortograficas	u r t o g r a f i k a s
pachinas	p a C i n 3 s
paralelas	p a r a l e l a
parroquias	p e r o k i a s
particulars	p e r t i k u l a r
pavo	p a b o
permitiba	p e r m i t i b a
permitindo	p e r m i t i n d o
pisos	p i s o s
plachas	p l a y i C a s
platiellos	p l a y i   o s
plegata	p l e 7 o
plegato	p l e 7 a t o
plumas	p l u m a s
poderba	p o d i n b a
policía	p o l i T i a
posan	p o s a n
posesions	p o s e s i o* s
posibilidatz	p o s i b i l i d a c
precisión	p r E c i s i o n
predomina	p r e d o m i n a
predominant	p r e d o m i n a n t
preparación	p r e p a r a i o n
preposicions	p r e p o s i i o* s
propagación	p r o p a g a i o n
proporción	p r L o k i o n
proposau	p r o p o s a u
proposó	p r o p o s o
punk	p u n
quartel	k i t e l
r	r
racial	r a c i a l
radical	r a d i k a l
reaccions	r e a k i o* s
reconoixencia	r E c o n o i S i n C i w a
reconoixer	r E c o n o y " e a r
rectangular	r E c t a n g u l a r
regla	r e g l a
relato	r e l a t o
rematanza	r E m a t a n c a
republicas	r e p u b l i k a s
responsabilidat	r e s p o i r a r u w i l i d a t
resultatos	r e s u l t a t o s
revueltas	b e b u e l t 3 s
robots	r o mb~ u t u a
royos	r o y o s
ruinas	r u i n 3 s
santuario	s a n t u a r i o
satelites	s a t e l i t e
secundario	s e k u n d a r a o
sedimentos	s 3 d i m e n t o s
semanas	s e m a n a s
septentrionals	s e p t E nt~ u z i o n a l
siente	s i e n t e
siglos	s i g l o s
significaba	s i g  k a b a
silaba	s i l a b a
sinonimos	s i n o n i m o s
substrato	s u b s t r a t o
succesión	s u k k o n
suizo	s u i r o
superficial	s u p e r a i a l
tallo	t a l o
tasa	t a s a
tecnico	t e k n i k o
teito	t e i t o
territorials	t e r i t o r i a l
titular	t i t u l a r
tractamiento	tr~ a k t a m i e n t o
trastes	t r a s t i
trescruzar	w a m i s k r u s a r
tripulación	t r e p u l a k a i o n
tu	t u
turquicos	t u r k i k o s
ubrió	u b ry~ o
universidatz	u n i v e r i d a c
usato	u s a t o
venir	f e n i r
viaches	v i a C m 3 s
viellas	v i e y a
visibles	v i s i b l e
vlacos	v l a k o s
Ángel	N
Aires	i r e
Alfonso	l f o s o
Anatolia	n a t o l i a
Andreu	ndr$ e u
Antes	nt~ m 3 s
Atro	t r o
Berenguer	e r e N i a
Blanca	l a n k o a
Blas	l a
Borgonya	u r g o n y a
Buenos	u e n o s
Calatayú	a l a t a y u
Cambra	a m b r a
Canadá	a n a d a
Catolica	a t o l i k a
Chardín	h a r a n
Cheorchia	h e o r C i a
Cine	i n e
Colechio	o l e C i o
Comunista	n i S th~ a
Congo	o n g o
Coreya	o r e y a
Cortes	u r t e
Costantinoble	o s t a n t i n o b l a e
Danubio	a n u b i o
Dentre	e n t r e
Dentro	e n t r o
Diz	i z
Eduardo	d u a r d o
Eixemplos	i S 3 mp~ l o s
Estadio	s t a d i o
Ferrández	e r a n d e z
Golfo	o l f o
Guadalajara	u a d a l a j a r a
Head	E w e d
Heinrich	e i n i cy~
Iberica	b E i cy~ a
Islas	s l a
Joseph	o s e p
Krajina	r a j i n a
League	E w e a
Lengua	g u a
Letras	a t 3 r 3 s
León	e o n
Logo	o g o
Léxico	e n  o
Matarranya	E t E d i t r a 5 a
Michael	i C a
Moscú	o s k u
Muit	u i
Mónegue	i* e a
Navarro	a b a r o
Occident	kh~  i d e n t
Partiu	a r v u
Pireneu	i r e n e u
Platón	l a t o n
Porto	u r t o
Poseye	o s e y e
Pueblos	k i k " bl~ u
Quaid	u a i d
Rechional	e T i o n a l
Reina	e i n a
Ribas	i b a s
Royo	o y o
Santiago	a n c a
Semontano	e m o* t a n o
Sociedad	T i e d a d
Solament	o l a m E n t
Steven	t e b e n
Sánchez	a n C i h e z
Thomas	h o m a s
Toledo	o l e d o
Victoria	i k t o r i a
Zona	o n a
abellas	a b e y a
aconsigue	a k o ns~ i a
actas	a k t o s
activa	a k t i v a
adreza	a d r E z E
aduyó	a d u a
adverbials	a d e r b i E a d
adverbio	a d e r b i E o
alans	a l a n
aletas	a l e t o s
alumnos	a l u m n o s
amanatas	a m a n a t a s
amariella	a m a r i L a
ambitos	a m b i t o s
americán	a m e r i kh~ a m e n
aniello	a n i e l o
anunció	n u i o
aparent	a p a d e
aplicación	a p l i k a i o n
artificials	a r   i a d
asambleya	a s a m b l e y a
asambleyas	a s a m b l e y a s
asegurar	a s e g u r a r
ataques	a t a k e
au	a u
autonomas	a u t o n o m a s
azuls	a z u l
baixan	b a i S a n
baixos	b a i S o s
banco	b a n C i o
bandas	b a n
barcos	b a r k o s
basicos	b a s i k o s
beluna	b e l u n a
breu	b r e u
café	k a f e
caleba	c a l 3 b a
cantons	k a nt~ o* s
caras	k a r 3 s
carbonio	k a g i p o l o
carreteras	k a r   a s
castellanas	k a s t e l a nz~ 3 s
castellanismo	k a s t e l a nz~ i s m o
castiellos	k a s t i 3 o s
cauz	k a u
celebración	k e l e b r a i o n
celebre	C E l E o*
centra	C E n t r a
ceramica	C E r a m i k a
chenitivo	C e n i t i b o
cheolochía	C e o l o C i a
chinesa	C i n 3 s a
choventut	C o p e n t u t
chuez	C o e z
chugar	C o g a r
chunyo	w a n y o
chóvens	C o k s k a
cinquena	T i n ky~ e n a
citar	T i t a r
clasificacions	k l a s  k a i o* s
climatico	k l i m a t  o
coalición	k o a l i i o n
codete	k o d e t e
colaboró	k o l 3 b u a o r o
coloca	k o l o k a
colonial	k o l o n i a l
coloquial	k o l o k i a l
coma	k o m a
comentarios	k o m e n t a r i o s
comparten	k o m p i t e n
composata	k o m p o s a t a
comunistas	k o m u n i s t a s
concentra	r o n C i e n t r a
confundir	r o n f u nd~ i r
conservar	r o n e r v a r
conservau	r o n e r v a u
construyida	k o s t r u y i d a
construyir	k o s t r u y i*
convento	r o n f e n t o
cooperación	k o o p e r a i o n
coordinación	k o r d i n a g a o n
cordelera	k o r d e l e r a
coro	k o r o
corredor	k o r e d o r
creyador	k r e y a d o r
creyato	k r e y a t o
creyau	k r e y a u
cristianas	k r i s t i a n a s
criterio	k r i t E r i o
criticos	k r i t i k o s
cubrir	k u b r a r
cuencas	kw~ e n k a s
cul	k u l
decide	d e 7 i d e
declinación	d e k l i n a g a o n
definicions	d e f i n i C y o* s
dels	d e l
dentradas	d e n t r a d 3 s
derivadas	d e r i v a d 3 s
desapareixioron	d e s a p a r e i n o r o n
desapareixiu	d e s a p a r a i S i u
desaugua	d e s a u g u a
descubrimiento	d e s k u b l i m i e n t o
descubrimientos	d e s k u b l i m i e n t o s
desembocadura	d e s a i mb~ o k a d u r a
deseparato	d e s e p a r a t o
deseparau	d e s e p a r a u
desinencia	d e s i n i n C i w a
despoblados	d e s p o b l a n k d o s
destacable	d e s t a k a b l e
destacato	d e s t a k a t o
detectar	d e t e k t a r
determina	d e t e r m i n a
determinan	d e t e r m i n a n
diferenciar	d i f e r e n C i w a r
diftongación	d i f t o N a C i w o n
dimensión	d i * ns~ i o n
dirichent	d i r i t a C e n
dirichito	d i r i C i t o
disenyato	d i s e 5 a t o
disolución	d i s o b e l i o n
disposición	d i s p o s i i o n
dividió	d i v i d i o
dunas	d u n 3 s
emitir	e m i t i r
enchaquia	e n C a k i a
encluyen	i n C i l u y e n
enemigo	i n i m i g o
entender	e n t e n d e r
entroron	e n t r o r o n
equilibrio	e k i l i b ry~ o
escatas	e s k a t a s
esferencias	e s f m i n C i w 3 s
esfuerzos	e s pw~ e r i z o s
española	e s p a 5 o l a
especificas	e s p E kh~ a m e*  a s a
espelungas	e s p e l u N a
estatals	e s t a t a l
estatua	e s t a t u a
estausunidenses	e s t a u s u n i d e n e
estilos	e s t i l o s
estructural	e s t r u k t u r a l
estudiar	e s t u dy~ a r
etapas	e t 3 p 3 s
etnicas	e t n i k a s
evolucions	e v o b e l i o* s
ex	Z i 7
excepcions	" u p i o* s
existir	" i s t i r
exteriors	e S e r i o r
fabricas	f a b r i k a s
faigan	f a i g a n
famosos	f a m o s o s
feminín	f a m i n i
ferramienta	f e r a m i e nt~ a
fina	f i n a
financiero	f i n a n C y e r o
fluido	f l u i d o
foco	f o k o
fondón	f o n d o n
fonetico	f o n e t  o
formalment	f o r m a l m E n t
formoron	f o r m o r o n
francos	f r a nC~ o s
français	f r a n a i s
fuesa	f u e s a
ganando	g a n a n d o
garchola	g a r C o l a
grafico	g r a f i k o
herencio	h e r e n C i w o
hesen	h e s e n
hi	h i
homonima	h o m o n i m a
identificar	d e n t i f i k a r
ideyal	d e y a l
incendio	m a e n d i o
influyó	i n f % a
inicialment	i n i C y a l m E n t
intentos	i n t e n t o s
irregularidatz	i r e g u l a r i d a c
islam	i s l a m
ixes	i S m 3 s
laboral	l a b o r a l
lexica	l " i k a
librement	b r E m E n t
licherament	l i C e rh~ a m E n t
liders	l i d e r
lingüista	l i N 3 i s t a
lituans	t u a
lochica	l o C i k a
luengaches	l u e ng~ a T h e s
malas	m a l 3 s
malotías	l o t i 3 s
mampostería	m a m p o s t E r i a
maniera	n i e r a
manto	m a n t o
marchar	m a* r C a r
marguins	m a* r g i n
masculinas	s k u l i n 3 s
mencions	m E n C i w o* s
meten	m e t e n
meyatos	m e y a t o s
minutos	m i n u t o s
mirandés	m i r a nd~ e
mixtas	m i S 3 s
molín	o l l e
monarca	m o n a r k a
monches	m o n C i h e s
mongols	o n g o l
motors	m u t u r
multiples	l t e p l e
nacionalista	n a g a o n a l i s t a
nacionalistas	n a g a o n a l i s t a s
naixencia	n a i S i n C i w a
naiximiento	n a i x i m i e n t o
naixita	n a i S i t a
nasal	n a s a l
necesario	d e* k a* b e s a r i o
negros	n e g r o s
noción	n o C i w o n
nombra	n o mb~ r a
normals	n o r m a l
numeración	n u m e r a i o n
occitans	T k i t a n
ocuporon	o k u p o r o n
ofensiva	o f e ns~ i v a
ofreix	o f r e i
olimpico	o l i m p i k o
onda	o n d a
onsos	o s o s
opción	o p i o n
ordenó	u r d e n o
padre	p a d r e
papa	p a p a
pareixen	p a r e i  e n
parellana	p a r e y a n a
parlamento	p a l a m e n t o
parques	p i s o X
pelache	p e l a C e
pelos	p e l o s
pena	p e n a
percusión	p e r k u s i o n
persa	p e r s a
perspectiva	p e r 8 p e n e k t i v a
pierde	p y E r d e
platero	p l a y i t e r o
plurals	p l u r a d
poblata	p o b l a t a
polaca	p o l a k a l
portugueses	p o r t u g u e e
posa	p o s a
posar	p o s a r
prebar	p r e b a r
premite	p r e m i t e
presentación	p r e s e n t a q i o n
prestichio	p r e s t i C i o
profundidat	p r o f u nd~ i d a t
propietarios	p r o p i e t a r i o s
proporciona	p r L o k r i o n a
proposa	p r o p o s a
provenzal	p r o p e n z a l
provincial	p r o v i n C i w a l
puertos	p u e r t o s
qualidatz	k a l i d a c
quitar	k i t a r
qüestions	q 3 e s t i o* s
rapedo	r a p e d o
raro	r a r o
rayo	r a y o
rechionals	r e C i o n a l
reconoixiu	r E c o n o i n u
recupera	r E C u p e r a
redota	r e d o t a
regano	r e g a
relacionada	r e l a c i o n a d a
releu	r E l E u
relichiosa	r e l i C i o s a
rematando	r E m a t a n d o
reparto	r e p i t o
representando	r e p r e s e n t a n d o
resolución	r e s o b e l i o n
responsables	r e s p o n l a g a n u s m 3 s
reyals	r e y a d
ribagorzano	b a g o r o n o
riego	r i e g o
rocoso	r o k o s o
rodiato	r o d i a t o
romanicas	r o m a n i k a s
ruedas	r u e d 3 s
rusio	r u s i o
saxón	s a x o n
sentimiento	s e n t i m i e n t o
signo	s i g n o
simbolica	s i m b o l i k a
sistematica	s i s t e m a t i k a
soldaus	s o l d a u s
sozmesos	S o z S o s
subespecies	s u b e s p E kh~ a m e* i e
subordinadas	s u b o r d i n a d 3 s
superar	s u p e r a r a
tallar	t a l l a r
tamien	t a m i e n
tardana	t a r d a n a
tasament	t a s a m i n t
teatral	t e a t r a l
tendencias	t e n d e n C i w 3 s
tipicament	t e p i k a m E n t
tractar	tr~ a k t a r
transistors	i t r i s i s t o r
tribals	l e d a d
trozos	t r o i z o s
ubicación	u b i k a i o n
ubiertos	u b i e r t o s
usando	u s a n d o
veranos	e r a n o s
via	v i a
vienen	v i e n e n
villas	v i l l a
vital	v i t a l
yoga	y o g a
zucre	z u k
Ánchel	C i n C e l
álbums	a l b u m
