ha	s i
avei	E b e i
umi	r u m i
de	d e
peteĩ	p e t e i*
pe	p e
ary	a r
heta	h e t a
ko	k o
upe	u p e
rupi	n i n
Ko	o
oĩ	o i*
oiko	o i k o
térã	t a r o
jave	y a b e
ára	g a
katu	k a t u
táva	t a v a
chupe	C p e
guive	g i v E
ambue	a m b u e
rehegua	r e h e g u a
rehe	r E e
ikatu	i k a t u
hikuái	h i k u a i
tetã	t e t a*
guasu	g u a s u
porã	p o r a*
ndive	n t i v E
tenda	t e n d a
oguereko	o g e r e k o
ramo	r a m o
opa	o p a
la	l a
yvy	y v y
niko	n i k o
rire	r i r
peve	p e v e
tapicha	t a p i T a
del	d e l
ñane	5 a n e
Umi	m i
hína	h i n a
ñande	5 a nd~ e
gotyo	g o t y o
ojapo	c a p o
rupive	n i n i v E
pegua	p e g u a
apytépe	a p 3 t e p e
Péicha	e i T a
ava	a v a
haguã	h a g u
hérava	h e r a v a
Guarani	u a r a n i
karai	k a r a i
távape	t a v a p e
San	a n
oĩva	o i* v a
péicha	p e i T a
amo	n o i
mokõi	m o k o i k
hagua	h a g u a
Upe	p e
tembiapo	t e by~ u
aty	a t
opyta	o p 3 t a
oho	h o
ysyry	y s 3 r
upépe	u p e p e
kuéra	k u e r a
Pe	e
Ary	cy~
Oĩ	i*
oñepyrũ	w e p 3 r u*
mymba	m 3 i
upéicha	u p e i T a
ári	g a 5
hese	h e s e
ohasa	o h a s a
ichupe	i C p e
orekóva	o r e k o v a
tape	t a p e
Avei	f e i
Paraguái	a r a g u a i
jey	h e
ou	o u
oikóva	o i k o v a
ojejapo	o q j a p o
héra	h e r a
aja	a h a
ipype	i p 3 p e
yvyra	y v y r a
kuña	k u 5 a
oike	o i k e
péva	p e v a
osẽ	o s e*
Heta	e t a
Nacional	a c i o n a l
umíva	u m i v a
oreko	o r e k o
upéi	u p e i
voi	v o i
José	o s e
opaichagua	i n  C a g u a
chupekuéra	C o p e k u e r a
mbohapy	mb~ o h a p y
tapichakuéra	t a p i C a k u e r a
jepe	h e p e
ohupyty	h u p i t i
opaite	o p a i t e
óga	o g a
retãme	r e t a*
guare	g u a r e
ohechauka	h e C a u k a
terã	t E r a*
Juan	u a n
Peteĩ	e t e i*
oipuru	o i p i r
kóva	k o v a
ojehecha	o x e h e C a
Ha	a
La	a
oguerekóva	o g e r e k o v a
Paraguaýpe	a r a g u a p e
pukukue	p u k 3 k 3
che	C e
mboyve	b o y v e
Upéicha	p e i T a
chugui	C u g u i
guarã	g u a r a*
hembiapo	h e by~ u
peteĩha	p e t e i* a
retã	r e t a*
Paraguáipe	a r a g u a t p e
ambuéva	a m b u e v a
hetaiterei	h e t a i t e r e i
tekove	t a k o v e
upéva	u p e v a
hetave	h e t a b e
tavayguakuéra	t a v a y g u a k u e r a
tee	t e n
upévare	u p e v a r e
omano	a m i a s a
pyahu	py~ a u
tuichavéva	t u i C a v e v a
ohai	a i
tetãme	t e t a*
Kóva	o v a
jajuhu	y a h u h u
oúva	m E p v a
Oguereko	g e r e k o
pehẽngue	p e h e* Nw~ a
katuete	k a t u e t e
yvate	y v a t e
árape	g a p e
Guasu	u a s u
ku	k u
meve	m e v e
mitã	m i t a*
km	k m
hague	h a x 3
oñemoĩ	w e m o i*
reko	r e k o
arandu	a r a n d u
ohóvo	h o v o
ojejapóva	o q j a p o v a
opavave	o p a v a b e
heñói	h e ny~ a N
purahéi	p u r a h e i
oguahẽ	o g a h e*
tendápe	t e n d a p e
tetãvore	t e t a* v o r e
tuicha	t u i T a
yvyty	y v y ty ~
Kachíke	a C i k e
mburuvicha	m b u r u w i a
vai	w a i
yvypóra	3 b 3 p o r a
arýpe	a r p e
oikove	o i k o v e
Carlos	a r l o s
javeve	y a b e v e
ojapóva	c a p o v a
oĩha	o i* a
en	e n
gueteri	g e t e r i
peteï	p e t e 3
ñorairõ	5 o r a i r o*
Amo	m o
Antonio	t o o
Upépe	p e p e
akue	a k u e
opytáva	o p 3 t a v a
oñemohenda	w e m o h e n d a
téra	t a r o
mbytépe	b 3 t e p e
ojekuaa	o q u
Pedro	p i e d r o
tuichakue	t u i C a k u e
aranduka	a r a d u k a
hekove	h e k o v e
hendápe	h e nd~ a p e
hákatu	h a k a t u
irundy	i r u nd~
opáichagua	o  i T E g u a
Ára	r a
Tetã	e t a*
oiméva	o i m u v a
López	o p e z
morotĩ	m o r o t i*
oime	o i m e
Táva	a v a
ani	a n i
ohóva	h o v a
omotenonde	w a k i n d e
yma	i m a
ypykue	3 p 3 sw~ e
María	a r i a
Oñepyrũ	d a m a py~ r u*
ape	a p e
ijyvy	g i y i b i 7 a m
kuri	k u r u
ningo	n i Ng~ o
General	e n e r a l
hete	h e t e
Villa	i l l a
oikuaa	o i k u a
Ikatu	k a t u
katupyry	k a t u p 3 r
ñepyrũ	d a m a py~ r u*
Dr	r
Karai	a r a i
Río	i o
Upéi	p e i
asy	a s
mante	m a n t e
hembiapokue	h e by~ a p o k u e
hũ	h u*
kuarahy	k u a r a h
oñembohéra	w e mb~ u h e r a
renda	r e n d a
tekoha	t a k o h a
yva	y v a
Museo	u s a i o
Oiko	i k o
Ruta	u t a
hendive	h e n d i v E
ikatúva	i k a t u v a
mbarete	b a d e t e
omoheñói	h e ny~ a N
ryepýpe	cy~ e p p e
Yvy	v
guyra	g u y r a
ojeheróva	o x e h e r o v a
ojejuhu	o q h u h u
omotenondéva	w a k i n d e v a
sua	s u a
ñandéve	5 a e v e
Ambue	m b u e
Péva	e v a
ichugui	i T u g u i
jasypoapy	y a s 3 p o a p y
máva	m a v a
ndaikatúi	d a i k a t u i
tero	t e r o
upérõ	u p y o*
iporãva	p o r a* v a
paraguaya	p a r a g u a y a
puku	p u k u
tavaguasu	t a v a g u a s u
Upévare	p e v a r e
a	a
cm	k m
jahecha	y a h e C a
jasypa	y a s 3 p a
mymbakuéra	m 3 mb~ a k u e r a
ohecha	h e C a
pohã	p o h
tupão	t u k o
Francisco	r a n C i s k i s  o
nde	nd~ e
ogueraha	o g e r a h a
rembiapo	r E m o  u
Guaraníme	u a r a n S e
Guerra	u e r a
aravo	a r a v o
hetã	h e t a*
ohasáva	o h a c a v a
ojeguereko	o x e g e r e k o
tendáre	t a n g e
Francia	r a n C i w a
Itúva	t u v a
Luis	k i s
Marangatu	a r a N a t u
avakuéra	m a v a k u e r a
iporã	p o r a*
peteĩva	p e t e i* v a
pype	p 3 p e
ymaguare	i m g u a r e
Lengua	g u a
los	l o s
oipytyvõ	o i p 3 t 3 b o*
ojepuru	o x e p u r u
ojupi	b p i
oĩháme	o i* h a m e
Tupã	u p
Universidad	n i v e r i d a d
henda	h e n d a
itúva	i t u v a
ojehero	o x e h e r o
po	p o
teko	t a k o
Ohai	h a i
jasy	y a s 3
michĩ	m i C i*
oikovéva	o i k o v e v a
réra	r e r a
tetãnguéra	t e t a* g a e r a
ypy	3 p 3
Ñande	a n e
áva	a v a
Ava	v a
Centro	e n t r o
Escuela	s k u e l a
Itavusu	t a b u s u
Manuel	a n
apekue	a p u h e
atýpe	a t p e
haguére	h a g e r e
haihára	h a i h a r a
oheka	h e k a
retãygua	r e t a* y g u a
tekotevẽ	t a k o t e b e*
tuicháva	t u i C a v a
Chaco	h a k o
Tupão	u k o
isy	i s
itáva	i t E v a
kuñakarai	k u 5 a k a r a i
omoñepyrũ	w e p 3 r u*
oñangareko	w a N a r e k o
oñemoarandu	w e y a r a n d u
pa	p a
poguýpe	p o g p e
tendota	t e n d o t a
jasypo	y a s 3 p o
kavaju	a v a C u
mombyry	m o m b 3 r
ndaje	d a e
osẽva	o s e* v a
reheve	r e h e v e
Colegio	o l e g i o
González	n z a l e z
Oreko	r e k o
gobierno	g o b i E a n o
herakuã	h e r a
jasyporundy	y a s 3 p o r u nd~
kuatiahaipyre	k u a t i a h a i p y r e
mayma	m a i m a
ojeporu	o x e p o r u
ojogua	o x o g u a
porãve	p o r a* v e
tembiporu	t e m b i p o r u
ñu	5 u
Arte	r t e
Guaraní	u a r a n i
Puerto	u e r t o
ao	a o
hetaite	h e t a i t e
jasypateĩ	y a s 3 p a t e i*
jasyrundy	y a s 3 r u nd~
nunga	n u N a
oguata	o g u a t a
oisãmbyhy	w a z a* b 3 t
ojuka	o h u k a
ombohovái	v o o b a i
omoĩ	i*
rape	r a p e
tenondegua	t e n d e g u a
ypykuéra	3 p 3  e r a
Brasil	r a s i l
Buenos	u e n o s
Félix	3 i S
Rodríguez	o d r i g e z
Santa	a n t a
arte	i t e
guarani	g u a r a n i
hasýva	h a s v a
hina	h i n a
mborayhu	b o r a y u
oheja	h e h a i
oipurúva	o i p i r u v a
ojehu	o q u
oñondive	w o n d i v E
ruvicha	r u w i a
tavaygua	t a v a y g u a
Che	e
Dirección	i r E C i o n
Opa	p a
ijerére	g i y E a y e
jaikuaa	y a i k u a
kokuépe	k o k u e p e
mokõiha	m o k o i k a
omopyenda	py~ e n d a
paraguayo	p a r a g u a y o
porãva	p o r a* v a
ykére	y k e r e
ñemoñare	5 e m w a r e
Cerro	e r o
Jepémo	a p e m o
Kirito	i r i t o
akóinte	a k o i nt~ e
añete	a 5 e t e
distrito	d i u z i t o
don	d o n
guasúpe	g u a s u p e
haguépe	h a g e p e
ikatuhápe	i k a t u h a p e
jasyteĩ	y a s 3 t e i*
jerére	h e r e r e
ohechaukáva	h e C a u k a v a
oikéva	o i k e v a
sy	s
imemby	i m e mb~
jepémo	h e p e m o
marandu	r a n d u
o	o
oguejy	o g j
ojeikuaa	o q i k u a
paha	p a h a
peteĩháme	p e t e i* h a m e
pira	p i r a
pokõi	p o k o i k
rekove	r e k o v e
róga	r o g a
yvytu	i v i t u
yvýpe	y v p e
Ñane	a n e
Cultura	u l t u r a
Tavakuairetã	m a v a k u a i r e t a*
Tupãsy	u k s
agua	g u a
añoite	a 5 o y t 3
añónte	a 5 i* t e
heko	h e k o
hesekuéra	h e s u h e r a
ikatupyry	i k a t u p 3 r
ipukukue	i p u k 3 k 3
iñembyatýva	i 5 e m by~ a t v a
jasypakõi	y a s 3 p a k o i k
jasypoteĩ	y a s 3 p o t e i*
ogueru	o g e r u
oikuaauka	o i k u a u k a
okakuaa	o k i 5 u
techapyrã	t e C a py~ r a*
tembipuru	t e m b i p i r
ymave	i m a b e
Fernando	E a n a n d o
Héra	e r a
Mymba	y i
Ysyry	s 3 r
avati	a b a t i
avave	a b a b e
hóga	h o g a
kakuaa	k a k u a
ndaipóri	d a i p o r i
ojerure	o x e r u r e
okaháre	o k a h a
rete	r e t e
upérupi	u p e k i n
ymaite	i m i t e
ãva	a v a
Educación	d u k a i o n
Encuestas	n kw~ e s t o s
Iporã	p o r a*
Oime	i m e
Paraguaýgui	a r a g u a g u i
Parana	a r a n a
ae	a e
apytégui	a p 3 t e g u i
haimete	h a i m e t e
ipahápe	i p a h a p e
jehai	h e a i
jára	h g a
mbyte	b 3 t e
ojeipuru	o q i p i r
ojuhu	o h u h u
opavavépe	o p a v a v e p e
pytagua	p 3 t a g u a
upevarã	u p e b E r a*
vaka	v a k a
viru	v i r u
ñana	5 a
Gaspar	a s p a r
Gobierno	o b i E a n o
Martínez	i t x i a gw~ a
Mburuvicha	b u r u w i a
Presidente	r e s i d e n t e
Triple	r i p l e
Upéva	p e v a
arapy	a r a p y
are	a r e
e	e
hendáicha	h e nd~ a i T a
ikatuha	i k a t u h a
imbarete	i m b a d e t e
ita	i t a
jasykõi	y a s 3 k o i k
jasypokõi	y a s 3 p o k o i k
jepi	h e p i
jeroky	h e r o k
mitãrusu	m i t i u s u
música	m a s i k a
ndéve	nd~ e v e
ogueraháva	o g e r a h a v a
opurahéi	o p u r a h e i
oñembohérava	w e mb~ u h e r a v a
pyhare	p 3 h a r e
rei	r e i
río	r i o
sa	s a
su	s u
ñorãirõ	y o* k r a * i r o*
Amandaje	m a n dy~ e
Caballero	u C i C l e r o
Ciudad	i u d a d
Congreso	o N r e s o
Hembiapo	e m b a u
Ndaipóri	d a i p o r i
Upérõ	p y o*
apoha	a p o h a
arahaku	a r a h a k u
arapokõindy	a r a p o k o i k a t a
año	a 5 u
hapicha	h a p i T a
hápe	h a p e
jopói	j o p a N
mandyju	m a n dy~ C u
mbohapyha	mb~ o h a p 3 h a
oguahẽva	o g a h e* v a
ohechakuaa	h i n i 5 u
oipyhy	o i p i t
ombohéra	o mb~ o h e r a
omohenda	h e n d a
ova	o v a
político	p o r i t  o
pytã	p 3 t a*
pópe	p o p e
remiandu	r E m i a n d u
ruta	r u t a
tendagua	t e n d a g u a
umía	u m i a
Censos	e Th~ o s
Kuarahy	u a r a h
Paraguaya	a r a g u a y a
Paraguayo	a r a g u a y o
Tenda	e n d a
añetehápe	a 5 e t e h a p e
guerra	g e r a
guýpe	g u p e
itavusu	i t a b u s u
iñambue	i 5 a m b u e
las	l a
marangatu	r a N a t u
mávapa	m a v a p a
oiporavo	o i p o r a v o
ombojoaju	e c u s u
omenda	e n d a
oñembyaty	w e m by~ a t
pirapire	p i r a p i r
pépe	p e p e
reheguáva	r e h e g u a v a
renondépe	r e n d e p e
temiandu	t e m i a n d u
tetãygua	t e t a* y g u a
tuja	t u h a
upégui	u p e g u i
vore	v o r e
Amérika	m u r i k a
Ijyvy	x i v i
Instituto	s t i t u t o
Mcal	k a l
Opyta	p 3 t a
cultura	k u l t u r a
hasy	h a s
hembiapópe	h e by~ a p o p e
hemiandu	h e m i a n d u
hovy	h o v
jajuhukuaa	y a h u w u
jevy	p i r
kóicha	k o i T a
mbaraka	b a r a k a
mitãnguéra	m i t a* g a e r a
ndikatúi	n t i k a t u i
ohasávo	o h a c a v o
ohaíkuri	o h a d i k u r i
ohaíva	o h a i v a
okaru	o k a t u
oky	o k
ombopu	c o p u
orekovéva	o r e k o v e v a
oñemoambue	w e y a m b u e
oĩhápe	o i* h a p e
rógape	r o x a p e
upéichante	u p e i C a n t e
virus	v i r u s
Ayala	a l a
Facultad	a k u l t a d
Ferreira	E r  r a
Hesu	e s u
Heñói	e ny~ a N
Kuña	u 5 a
León	e o n
Mburuvi	b u r u b i
Oñemoarandu	d a m a y a r a n d u
Paso	a s o
apópe	a p o p e
hekopete	h e k o p e t e
isýkatu	i s k a t u
kuatia	k u a t i a
kure	k u r e
léi	l e i
obra	o b r a
oikotevẽva	o i k o t e b e* v a
ojegueraha	o x e g e r a h a
ojehechakuaa	o x e h e C i 5 u
ojeiko	o q i k o
para	p a r a
reserva	r e s E r v a
siglo	s i g l o
tavusu	t a b u s u
tĩgua	t i* g u a
ñemuha	5  a
Alto	l t o
Diccionario	i k i o n a r i o
Don	o n
Flores	l o r e
Hekove	e k o v e
Nueva	k i k " v a
Omano	n o
Opaite	p a i t e
Peru	e r u
Peteï	e t e 3
Pindoráma	i d o r a m a
Solano	o r a n o
artista	i t i s t a
chéve	C e v e
gueterei	g e t e r e i
hógape	h o x a p e
jagua	h 3 g g u a
jajapo	y a j a p o
jasyapy	y a s 3 a p y
kamby	k a m b
kuaa	k u a
m	m
nacional	n a g a o n a l
ogakuéra	o g a k u e r a
oguerúva	o g e r u v a
ojekuaáva	o q a kw~ a r a v a
okápe	o k a p e
omoambue	o y a m b u e
omyakãva	a m i y a b 3* v a
oñorairõ	w o r a i r o*
paraguái	p a r a g u a i
pire	p i r
poteĩ	p o t e i*
rembiapokue	r E m o  a p o k u e
yvóra	y v o r a
ñemby	d a m a mb~
Alianza	l i a n c a
Asociación	s o k a i o n
García	a r T i a
Ipukukue	p u k 3 k 3
Mariscal	a r i s k a l
Para	a r a
Péa	e a
Radio	a d i o
Tetãvore	e t a* v o r e
general	g e n e r a l
gui	g i
hembireko	h e m b i r e k o
hetavéva	h e t a v e v a
kilómetro	k i l o u m E t r o
meme	m e m
metro	m e t r o
mimi	m i m i
mitãkuña	m i a* sw~ 5 a
mm	m m
mokõive	m o k o i i v E
oikókuri	o i k o k u r i
oipytyvõva	o i p 3 t 3 b o v a
oisãmbyhýva	w a z a* b 3 t v a
ojeho	o x e h o
ojepurúva	o x e p i r u v a
ombojoajúva	c o h a r k u v a
omoañete	o y a 5 e t e
omoĩva	i* v a
oporandu	L o k a n d u
oñemotenonde	w e m o t e n d e
política	p o r i t i k a
rekuái	r e k u a i
rembiasa	r E m o  a s a
ryguasu	cy~ g u a s u
teroja	t E r o h a
turismo	t u r i s m o
upeigua	u p e i g u a
vove	v o v e
Ñorairõ	o r a i r o*
ñorairõhára	5 o r a i r 3 h a r a
Cardozo	a r bw~ r o
Casado	a s a d o
Coronel	o r o n e l
Departamento	a p i t a m e n t o
Fuerte	u e r t e
Guasúpe	u a s u p e
Ojejapo	h e y a p o
Paraguaigua	a r a g u a i g u a
Rio	i o
Rosario	o s a r i o
Tape	a p e
Ymave	m a b e
Yvypóra	b 3 p o r a
colonia	k o l o n i y a
eíra	e i r a
hatã	h a t a*
iporãvéva	p o r a* v e v a
jaipuru	y a i p i r
jeko	h e k o
kuatiápe	k u a t i a p e
mbohapypa	mb~ o h a p 3 p a
mboka	b o k a
memby	m e m b a
michĩvéva	m i C u s e v e v a
ministro	m i n i s t r o
ohechávo	h e C a v o
ojeporúva	o x e p o r u v a
omboty	c o t
ombyaty	d o mb~ y a t
omopyendáva	py~ e nd~ a v a
oñembokatupyry	w e mb~ r a t u p 3 r
oñemopyenda	w e m o p y e n d a
oñepyrũva	w e p 3 r u v a
poapy	p o a p y
rekoha	r e k o h a
rendápe	r e n d a p e
resẽ	r e s e*
tata	t a t a
tavakuéra	t a v a k u e r a
upei	u p e i
upekuévo	u p e k u e v o
yvýre	y v
ñembosarái	d a m a e s e r a i
Acosta	k o s t a
Aires	i r e
Aty	t
Estado	s t a d o
Estados	s t a d o s
Estadísticas	s t a a s t i k a s
Hetave	e t a b e
Internacional	t E r n a g a o n a l
Los	o s
Martín	i t i
Miguel	i g
Omenda	m e n d a
Retã	e t a*
Superior	u p e r i o r
Tavetã	E b e t a*
Ymaguare	m a g u a r e
apañuãi	a p a 5 u a* i
aporeko	a p o r e k o
atã	a t a*
aviõ	a g o y o*
departamento	d e p i t a m e n t o
estilo	e s t i l o
haguãicha	h a g u a* i T a
hesa	h e s a
hetáva	h e t a v a
ijapytépe	u j a p 3 t e p e
ipuku	i p u k u
jepokuaa	h e p o k u a
mbeguekatúpe	mb~ e g e k h a u p e
mbói	mb~ a N
militar	m i l i t a r
motenondehára	o r e n d e h a r a
ni	n i
ohendu	h e n d u
ojeguerekóva	o x e g e r e k o v a
ojehai	o q a i
ojuehe	b e e
ovecha	o p e m u C a
oñemoĩva	w e m o i* v a
peteĩteĩ	p e t e i S e e i*
porãite	p o r a* i t e
poyvi	p o y v i
pueblo	p u e b l o
rague	r a a
rasy	r a s
reducción	r e d u k i o n
rembiasakue	r E m o  a s a k u e
rérape	r e r a p e
tembiapópe	t e by~ a p o p e
tembiasa	t e by~ a s a
túva	t u v a
yvyramáta	3 b 3 r a m e t a
Ñandejára	a n d e h a g a
Ñu	u
ápe	a p e
área	g e a
ñemitỹ	5 r e p e  q
Academia	k a d e m i a
Barrios	m a n i o s
Blas	l a
Decoud	e T a u d
Díaz	i a z
Editorial	d i t o r i a l
Franco	r a n C i o
Gral	r a l
John	o h E 5
Ku	u
Léi	e i
Ministerio	i n i S t E r i o
Mitã	i t a*
Mora	o r a
Ohasa	h a s a
Ojekuaa	h e u
Parque	a r kw~ i
Partido	i t i d o
Pág	a g
Pérez	y e z
Ru	u
Sociedad	T i e d a d
Tapichakuéra	a p i C a k u e r a
Umíva	m i v a
chuguikuéra	C u g u i  e r a
colonial	k o l o n i a l
español	e s p a 5 o l
festival	f e S t i w a l
haku	h a k u
ijapytepekuéra	u j a p 3 t e p e k u e r a
ijehegui	g i y e d h e g u i
indígena	i n d i g e n a
ipehẽngue	i p e h e* Nw~ a
ipoguýpe	p o g p e
ipu	i p u
ipyahúva	i p y a h u v a
jere	h e r e
jerovia	h e r o v i a
kokue	k o k u e
korapy	k o r a p y
kuatiáre	k u a t i g e
kuñataĩ	k u 5 a t a i*
membykua	m e m by~ u
moĩmbaha	m o e m b a h a
oikoha	o i k o h a
oikundaha	o i k u n d a h a
ojapókuri	c a p o k u r i
ojere	o x e r e
omanóva	a m i a s a o v a
ore	u r e
orekóvo	o r e k o v o
oñangarekóva	w a N a r e k o v a
oñehenói	w e h e r a N
oñeñangareko	w y u* k a* a N a r e k o
oĩgui	o i* g u i
oĩkuri	o i* k u r i
petỹ	p e t q
porundy	p o r u nd~
potĩ	p o t i*
presidente	p r e s i d e n t e
resfrío	r e s f r i o
sãmbyhyhára	s a* b 3 h 3 h a r a
tasyo	t a s y o
tembiasakue	t e by~ a s a k u e
tete	t e t e
tropa	t r o p a
tuguy	t u g u i
upéa	u p e a
ypa	3 p a
ysyrykuéra	y a ry~ k u e r a
yvyrágui	3 b 3 r a g u i
ñemoarandu	d a m a y a r a n d u
Ararova	r a r o v a
Avakuéra	v a k u e r a
Bertoni	e r t o n i
Casa	a s a
Club	l u b "
Cultural	u l t u r a l
Estancia	s t a n C i w a
Hákatu	a k a t u
Ipahápe	p a h a p e
Lorenzo	o r e n z o
Maíz	a i
Montoya	o n t o y a
Municipal	u n i C i p a l
Ojehecha	h e h e C a
Ojejuhu	h e h u h u
Rafael	a f a e l
Rivarola	i v a r o l a
Rosa	o s a
Santo	a n t o
Techapyrã	e T a py~ r a*
akã	a b 3*
angirũ	a N i r u*
apañuái	a p a 5 u a i
apohára	a p o h a r a
centro	C E n t r o
civil	i v i l
comandante	k o m a n d a n t e
cultural	k u l t u r a l
da	d a
disco	d i s k o
do	d o
educación	e d u k a i o n
estancia	e s t a n C i w a
guasuete	g u a s u e t e
hapichakuéra	h a p i C a k u e r a
herava	h e r a v a
hetyma	h e t i m a
hũngy	h u* N
ijyvate	g i y y v a t e
ipire	p i r
itujavéva	i t u h a v e v a
iñarandu	i 5 a r a n d u
iñemoarandu	i 5 e y a r a n d u
ja	y a
jaha	y a h a
jehasa	h e h a s a
joaju	j o s u
maymáva	m a y N v a
mbyky	mb~ a q
musical	s i k a l
ndoguerekói	d o g e r e k o i
neporãva	n e p o r a* v a
oguahẽvo	o g a h e* v o
ohenói	h e r a N
oimeraẽ	o i * a e*
ojejuhúva	o q xy~ h u v a
ojoavy	o x o a b
omanda	o m a n d a
omboguata	c o g u a t a
omoañetéva	o y a 5 E n v a
omoinge	o m o i N a
omoñepyrũva	w e p 3 r u v a
omyakã	a m i y a b 3*
omyasãi	a m i y a s a* i
orquesta	u r q u e s t a
osë	o s 3
oñandu	w a n d u
oñemoarandúva	w e y a r a nd~ u v a
programa	p r o g r a m a
rapicha	r a  C a
rapykuere	r a py~ k u e r e
tava	t a v a
tavaguasúpe	t a v a g u a s u p e
tavarandu	t a b a r a n d u
tendárupi	t a n s a m i
tenonde	t e n d e
tetãmegua	t e t a* e g u a
vaiete	v a i e t e
Añetehápe	5 e t e h a p e
Bernardino	E a n a r Z u
Blás	u
Bolaños	o l a 5 o s
Ciencias	i n C i w 3 s
Este	s t e
Hete	e t e
Jasy	a s
Militar	i l i t a r
Mokõi	o k o i k
Omotenonde	o r e n d e
Opavave	p a v a b e
Orden	r d e n
Paraná	a r a n a
Patria	a t r i a
Pindorama	i d o r a m a
Rabia	a b i a
Ramón	a m o n
Región	g i o n
Sosa	o s a
Villarrica	i l l a r i cy~ a
Virgen	i r g 3 n
Vocabulario	o k a b u l a r i o
Vyretáña	y r e t a 5 a
Yma	m a
Yvate	v a t e
arandupy	a r a nd~ u p y
artesanía	i t e s a n i y a a
asýva	a s v a
chipa	C i p a
guaraníme	g u a r a n S e
guejyha	g e hy~ a
guitarra	g i t a r a
hekoha	h e k o h a
ija	i y a N u
iména	i m u n a
internacional	i n t E r n a g a o n a l
ipo	i p o l a
iporãitereíva	p o r a* i t e r a i v a
iñakã	i N a d e b 3*
jehechakuaa	h e h e C i 5 u
jeporu	h e p o r u
juehegua	x u e h e g u a
juky	y u k E
kg	k
koty	k o t
kurusu	k u r u s u
mburuvi	m b u r u b i
muanduhe	m u a e
ohupity	h u p i t
ohupytýva	h u p 3 t v a
oikohague	o i k o h a x 3
oiporúva	o i p o r u v a
ojapyhy	c a p i t
ojeguerohory	o q a  h o r
ojehechauka	o x e h e C a u k a
ojejapoha	o q j a p o h a
ojekuaavéva	o q a kw~ a r a v e v a
ojeporavo	o x e p o r a v o
ojerereko	o x e r e r e k o
ojeréva	o x e r e v a
okambúva	o k a m b u v a
ombyai	d o mb~ y a i
omohechauka	h e C a u k a
omoheñóikuri	h e ny~ o i k u r i
omoheñóiva	h e ny~ o i v a
omoirũva	o m o i r u v a
oveve	o p e m u v e
oï	o 3
oñembohasa	w e mb~ o h a s a
peteĩme	p e t e e m e
pohãnohára	p o h a* n o h a r a
pukukuépe	p u k u k e p e
puraheihára	p u r a h e i h a r a
purory	p u r o r
puru	p u r u
público	p u bl~ i k o
reike	r e i k e
ru	r u
social	s o k i a l
sãso	s a* s o
tai	t a i
tapére	t a p y e
tasyópe	t a s 3 o p e
techaukarã	t e C a u k a r a*
tupãópe	t u k o p e
tĩ	t i*
uperire	u p e r
ñangareko	y a* N a r e k o
ñemano	d a m a
ñembyasy	d a m a mb~ y a s
Ache	C e
Andrés	ndr$ e
Artes	r t e
Colonia	o l o n i y a
Estadística	s t a a s t i k a
Európa	u r o p a
Gramática	r a m e t i k a
Grande	r a nd~ e
Guerrero	u e r e r o
Guyra	u y r a
Haimete	a i m e t e
Hetaiterei	e t a i t e r e i
Histórico	i s t o i cy~ o
Ipoty	p o t
Ipype	p 3 p e
Irala	r a l a
Jesús	e s u
Joaju	a r k u
Joaquín	o a k l e
Jorge	u r g e
Junta	u n t a
Loma	o m a
Maria	a r i a
Mbohapy	b o h a p y
Música	a s i k a
Oike	i k e
Oscar	s k a r
Peteĩha	e t e i* a
Primera	r i *
Rojas	c a s
Roque	o k E
Sur	u r
Tapicha	a p i T a
Techapyrãrõ	e T a py~ r i o*
Tesoro	e s o r o
Tomás	o m a q a
Upehaguére	p e h a g e r e
Villeta	i l l e t a
Yegros	g r o s
Yvyra	v y r a
Yvyty	v y ty ~
apo	a p o
aramirõ	a r a m i X o*
atyguataha	t u s g u a t a h a
ave	a b e
carrera	k a r e r a
central	C E n tr~ a l
ejército	j y k i t o
estudio	e s t u d i o
grado	g r a d o
guara	g u a r a
guaraní	g u a r a n i
hembiasa	h e by~ a s a
heseve	h e s a i v e
hetãme	h e t a*
ijyvatéva	g i y y v a t E v a
ikatúma	i k a t u m a
ipy	i py~
ipópe	i p o p e
ituichakue	b i t u i C a k u e
jarýi	h a r i
karape	k a r a p e
karugua	k a r u g u a
katuetei	k a t u e t e i
korapýpe	k o r a p p e
mbyja	mb~ i L a
mi	m i
miembro	m i e mb~ r o
mokõivéva	m o k o i k v e v a
métro	m u t r o
norte	n o r t e
ohupi	h u p i
ohupytývo	h u p 3 t v o
ojeikuaáva	o q i k u a a v a
ojejoko	o q j o k o
ojesareko	o x e s a r e k o
ojoguáva	o x o g a v a
oke	o k e
omaña	t a 5 a
omboguapy	c o g u a p y
ombohasa	o mb~ o h a s a
omboyke	c o y k e
ombyatýva	d o mb~ y a t v a
omoherakuã	h e r a
omoirũ	o m o i r u*
onohẽ	n o h e*
oñembojoaju	w e e c u s u
oñemotenondéva	w e m o t e n d e v a
oñepyrũma	w e p 3 r u m a
paje	p a h e
periodista	p e r i o d i s t a
pindo	p i d o
porãnguéra	p o r a* g a e r a
primera	p r i *
pytu	p 3 t u
revolución	r E f o b e l i o n
santo	s a n t o
tapiaite	t a p i a i t e
tekohápe	t a k o h a p e
tetãyguakuéra	t e t a* y g u a k u e r a
tres	w a m i
tuichave	t u i C a b e
tyeguasu	t e g u a s u
upehaguére	u p e h a g e r e
upéicharõ	u p e i C a r o*
ygarata	y N a r a t a
yvága	y v a g a
Ñemby	e m b a
ñemohenda	d a m a o* h e n d a
ñemongakuaa	5 e m o N i 5 u
ñorairõme	5 o r a i r o m e
Apa	p a
Arahaku	r a h a k u
Arapytu	r a p 3 t u
Ateneo	t e n e o
Benigno	e n i g n o
Benjamín	e n c a m o l e
Campo	a m p o
Capital	a p i t a l
Castellano	a s t e l a nz~ o
Cecilio	e T i l i o
Censo	e n s o
Cháko	h a k o
Chína	h i n a
Domingo	o m i Ng~ o
Ejército	h y k i t o
Fernández	E a n a n d e z
Festival	e s t i w a l
Galeano	a l e a
Garay	a r a y
Hyãsia	y a s i a
Imitã	m i t a*
Isla	s l a
Joapykuéra	o a p i  e r a
Joaty	o a t
Juana	u a n a
Larrosa	a r s a
Mundial	u n d i a l
Nde	d e
Ojapo	y a p o
Oriental	r i e n t a l
Orquesta	r k e s t a
Oñemoĩ	5 e m o i*
Plata	l a t a
Pèicha	e i T a
Roberto	o b e r t o
Ruiz	k i z
Salemma	a l e m a
Salto	a l t o
Saussure	a u s s u r e
Tembiapo	e m b a u
Trinidad	r i n i d a d
Tuicha	k i T a
Uperire	p e r
Uruguái	r u g u a i
Vera	e r a
achegety	a k h e g e t
ama	a m a
ambuére	a m b u y e
arapýpe	a r a p p e
arquitectura	a r k i t e k t u r a
avaite	a b a i t e
barrio	b a r o
composición	k o m p o s i i o n
compositor	k o m p o s i t o r
concierto	r o n C y e r t o
corriente	k o r e n t e
crup	k r u p
derecho	d e r e T h o
ferrocarril	f e r o k a r i l
guaréva	g u a r e v a
guasúre	g u a s u r e
hekohápe	h e k o h a p e
hembiapokuéra	h e by~ a p o k u e r a
hembiasakue	h e by~ a s a k u e
henyhẽ	h e 5 e*
heñóiva	h e ny~ o i v a
hikuéi	h i k u e i
hokẽ	h o k e*
hyepýpe	h e p p e
háicha	h a i T a
ijehe	g i y e d e
ikatupyryvéva	i k a t u p 3 r 3 v e v a
institución	s t i t u i o n
intendente	i n t e n d e n t e
ipohýi	p o h i
ipukúva	i p u k u v a
jeguaka	h e g o a k a
jehaipyre	h e h a i p y r e
kesu	k e s u
kuarahyreike	k u a r a h 3 r e i k e
kuarahyresẽ	k u a r a h 3 r e s e*
kuñáme	k u 5 a m e
kyhyje	ky~ i L
mburuvichakuéra	m b u r u w i k u e r a
mbytetépe	b 3 t E n p e
michĩva	m i C u s e v a
millones	m i l l o n i
misión	m i s i o n
mitãme	m i a*
natural	n a t u r a l
ndojapói	nd~ o h a p a N
ne	n e
ogapýpe	o x a p p e
ohayhu	o h a y u
oipota	o i p o t a
ojehaíva	o x e h a i v a
ojehecháva	o x e h e C a v a
ojeipapaháicha	o q i p a p a h a i T a
ojoko	o x o k o
okaraháre	k a d a h a
okára	o k a r a
omboguatáva	c o g w a k a t v a
omohendáva	h e nd~ a v a
omombarete	o m o m b a d e t e
omosẽ	s e*
osyry	o s 3 r
oñemosarambi	w e m o s a r a m b i
oñepyrũkuri	w e p 3 r u k u r i
oñeñandu	w y u* k a* a n d u
pakova	p a k o v a
papapy	p a p a p y
pero	p e r o
poder	p o d e r
popular	p o p u l a r
poravopyre	p o r a v o p 3 r e
porãvéva	p o r a* v e v a
proyecto	p r o y o j t o
puerto	p u e r t o
pumbyry	p u m b 3 r
pyharépe	p 3 h a r e p e
pyre	p 3 r e
pytuhẽ	p 3 t u h e*
rogue	r o a
rural	r u r a l
sistema	s i s t e m a
taipu	t a i p u
tapichakuérape	t a p i C a k u y a p e
techapyrãrõ	t e C a py~ r i o*
tekovekuéra	t a k o p e m u  e r a
teróre	t E r o
tetãvorépe	t e t a* v o r e p e
tiempo	t i e N p o
tyapu	t y a p u
távagui	t a v a g u i
un	u n
vaicha	v a i T a
véima	v e i m a
ymaguaréva	i m g u a r e v a
ypýpe	3 p p e
yso	y s o
yvatevéva	y v a t e v e v a
ága	a g a
ña	5 a
ñemitỹrã	5 r e p e  q r a*
ñemoambue	d a m a y a m b u e
ýrõ	3
