llaqtam	y a q t a m
Uma	m a
llaqtanqa	y a q t a n N g a
nisqaqa	n i S q a N g a
de	d e
icha	i T a
kay	k a y a
distritu	d i s t r e t u
huk	h u k
runakunam	r u n a k u n a m
San	a n
sutiyuq	s u t i y u
kawsachkanku	k a w s a C k a n k u
Yachay	a k " a y
watapi	w a t a p i
kastilla	k a s t i l l a
wan	w a n
llaqtapiqa	y a q t a p i k a
rimanku	l i m a kw~ a
runaqa	r u n a N g a
qhichwa	q i C w a
mana	m a n a
astawan	a s t a w a n
Kay	a y
lliwmanta	l l i p t a
kan	k a n
mama	m a m a
llaqtapi	y a q t a p i
kitilli	k i t i l l i
suyu	s u y u
simikunatam	s i m i k u n a t a m
aswan	a s w a n
karqan	k a r q a n
pruwinsya	p r u w nsw$ i y a
Alma	l m a
runa	r u n a
aymara	a i m a r a
kantun	k a n t u n
llaqta	y a q t a
chunka	w a n
munisipyupiqa	m u n i s i p y u p i k a
paqarisqa	p a q a r i s k a
ñiqin	5 t a m u a n
Sunturnin	u n t u r n i n
del	d e l
runakuna	r u n a k u n a
chay	C a y
Chay	h a y
Huk	u k
mater	m a t e r
chaymanta	C a y t a
kaq	k a q
nisqa	n i S N g a
iskay	i s k a y
kachkan	k a C k a n
munisipyu	m u n i s i p i r u
llaqtayuq	y a q t a y u
La	a
ima	i m a
Suntur	u n t u r
Lima	i m a
la	l a
Santa	a n t a
simipi	s i m i p i
pacha	p a C a
Hatun	a t u n
yachay	y a C a y
pulitiku	p u l i t i k u
hina	h i n a
kitillipi	k i t i l l i p i
allin	a ly~ i n
Churinkuna	h u r i 7 o m u n a
hatun	h a t u n
pruwinsyapiqa	p r u w nsw$ i y a p i k a
chanta	C a nt~ a
José	o s e
kiti	k i t i
manam	m a n a m
mayu	m a y u
Mama	a m a
achka	a k h i k a
Nacional	a c i o n a l
kanku	k a n k u
ancha	5 u k u n C a
Universidad	n i v e r i d a d
aswanta	a s w a nt~ a
Colegio	o l e g i o
simi	s i m i
Perú	e r u
kimsa	k i m s a
llaqtaqa	y a q t a N g a
wata	w a t a
Kamasqa	a m a k N g a
Editorial	d i t o r i a l
kawsanku	k a w s a n k u
qucha	q u C a
warmiqa	w a r m i k a
raymi	r a l m i
wasi	w a s i
Huwan	u w a n
kaqmanta	k a q t a
Juan	u a n
Yachaywasi	a k " o q u y w a s i
wañusqa	w a 5 u s k a
qarqan	q o m i 7 x u q
nispa	n i s p a
unquy	u n ky~
warmi	w a r m i
Iskay	s k a y
tiyachkan	i y a 7 C k a n
killa	k i l l a
uma	u m a
ñawpa	y a* w p a
kaqpi	k a q p i
kaqwan	k a q w a n
simitam	s i m i t a m
tiyanku	i y a n k u
tukuy	n k u y
wakin	w a k i n
Piruw	i r u w o
Chunka	h u n k a y a
Kastilla	a s t i l l a
tawa	t a w a
watamanta	w a t a m a n t a
María	a r i a
utaq	u t a q
Mana	a n a
hunuchá	h u n u C a
ichaqa	i C a N g a
llaqtap	y a q t E p
Antonio	t o o
Pedro	p i e d r o
Qhichwa	h i C w a
sinchi	s i n C i h
tiyan	i y a n
riqsisqa	r i k s i s k a
ayllu	a y L u
suntur	s u n t u r
Qhapaq	h a p a q
rimaqninmi	l i m a q l m i
Kunan	u n a n
Paykunaqa	a y k u n a N g a
kantunmi	k a n t u n m i
risirwa	r i s i r w a
ñawpaq	y a* w p a q
en	e n
pisi	p i s i
waraniyi	w a r a n i y i
Carlos	a r l o s
Musuq	u s u
México	e n  o
Puerto	u e r t o
University	n i v e r s i t
Urin	r i n
kanman	k a n m a n
kaqqa	k a k " o a
Aires	i r e
Aswan	s w a n
Buenos	u e n o s
Santiago	a n c a
musuq	s u
runam	r u n a m
sapa	s a p a
Pachantin	a C a n t i n
Ediciones	d i k i o n i
Francisco	r a n C i s k i s  o
Munisipyupiqa	u n i s i p y u p i k a
pusaq	p u s a q
suyupiqa	s u y u p i k a
Kimsa	i m s a
kaqta	k a q t a
karqa	k a r X a
parki	p e r k i
qhipaq	q i p a q
sumaq	s u m a q
Kupa	u p a
Luis	k i s
Madrid	a d r i d
Piluta	i l u t a
kamayuq	k a m a y u
runakunaqa	r u n a k u n a N g a
Cultura	u l t u r a
Tayta	a i t a
indihina	i n d i h i n a
lliw	l l i p
Ankash	Nk~ a S
kawsay	k a w s e i
nisqapi	n i S q a p i
watakama	w a t a k a m a
Binidiktu	i n i d i u
anafilaxia	a n a f i l a x i a
nin	n i n
sichus	s i T u s
and	a n d
distritunmi	d i u z i t u n m i
killapi	k i l l a p i
kuti	k u t i
syn	s
Ñawpaq	a w p a q
Chayrayku	h a y r a y k u
Griguryu	r i g u r y u
Quito	k i t o
Qusqu	u s kw~
Umalliq	m a l l i q
kaptin	k a p t i n
kaspa	k a s p a
manchay	m a n C a y
suqta	s u k t a
wamani	w a m a n i
Chaymanta	h a y t a
Markus	a r k u s
achkha	a C a
hawa	h a w a
mamallaqta	m u m u l l a q t a
pachak	p a C a k
pichqa	p i c N g a
suyup	s u y u p
Liyun	i y u n
Pampa	a m p a
Pawlu	a w l u
amachaq	a m a C a q
crup	k r u p
in	i n
kamasqa	k a m a k N g a
kapun	k a p u n
pachapi	p a C a p i
qhapaq	q a p a q
sutichasqa	s u t i C a s k a
yaqa	y a q a
California	a l i f o r n i a
Llaqtap	l a q t E p
Manuel	a n
Miguel	i g
Piruwpa	i r u w p a
hampi	h a m p i
hinam	h i n a m
kikin	k i k i n
suyupi	s u y u p i
Achka	C i k a
Chinchay	h i n C a y
Limaq	i m a q
kanchu	k a n C u
kitillipipas	k i t i l l i p i p a s
runakunata	r u n a k u n a t a
simita	s i m i t a
Fondo	o n d o
Peruana	e r u a n a
Pruwinsyapiqa	r u w nsw$ i y a p i k a
Villa	i l l a
ama	a m a
llimphisqan	ly~ i m p i s x u q
los	l o s
rimay	l i m a y
wak	w a k
Chawpi	h a u w p i
Las	a s
Wasi	a s i
karu	k a t u
kasqa	k a s k a
kayta	k a i t a
nisqakunaqa	n i S q a k u n a N g a
qanchis	q a n u q a n C i s
qillqa	q i l l N g a
taripay	t a r i p a y
unquyta	u n ky~ nd~ a
yawar	y a w a r
Biblioteca	i b l i o t e k a
Centro	e n t r o
Nihun	i h u n
Quechua	k i k " w a h
Santo	a n t o
Sociedad	T i e d a d
allpa	a ly~ p a
isqun	m i s k e n
kawsachkan	k a w s a C k a n
kunan	k u n a n
manañam	m a n a y a* b i*
pp	p p
pukllaykuna	p u k l l a y k u n a
qallarirqan	q a l l a r i r q a n
Guadalupe	u a d a l u p e
Krus	r u s
Rosa	o s a
Taytan	a i t a n
huklla	h u k L a
llaqtakuna	y a q t a k u n a
m	m
munan	m u n a n
nisqap	n i S q a p
p	p
pampa	p a m p a
runakunap	r u n a k u n a p
waranqa	w a r a n N g a
Ñawpa	a w p a
ñiqi	5 i k i
Ana	n a
Andrés	ndr$ e
Diccionario	i k i o n a r i o
Editores	d i t o r e
Estudios	s t u d i o s
Maman	e m e n
Sebastián	e b a s t i a n
Wakin	a k i n
hunu	h u n u
imaraykuchus	i m a r a y k u C u s
llaqtanmi	y a q t a n m i
rurasqa	r u r a s k a
tukurqan	n k u r q a n
unqusqa	u n ky~ s k a
unquyqa	u n C " a N g a
urqu	u r q u
virus	v i r u s
yaku	y a k u
Domingo	o m i Ng~ o
Hanan	a n a n
Los	o s
Tawa	a w a
iskayniyuq	i s k a  g
quechua	k e T u
raphi	r a p
runayuq	r u n a y u
sutin	s u t i n
tiyaq	i y a q
Ancha	5 u k u n C a
Barcelona	a r k e l o n a
Cambridge	a m b r i d g e
Tukuy	u k u y
Warmi	a r m i
atin	a t i n
awqaq	a w q a q
hanaq	h a n a q
hinallataq	h i n a l l a t a q
kamarisqa	k a m a r i s k a
kaqkunaqa	k a q k u n a N g a
nisqam	n i S o m a r s
pi	p i
wayra	w a y r a
Apuwasinyuq	p u w a s i n y u
Awya	w y a
College	o l l e g e
Económica	r o n o m i k a
Edición	d i k i o n
Jesús	e s u
Kathuliku	u  l i k u
Linguistics	i n g i s t i k s
Pichqa	i C N g a
Piruwpi	i r u w p i
Puka	u k a
Qanchis	5 u k a n C i s
Rimana	i m a n a
Santu	a n t u
The	e
Tupaq	u p a q
chaypi	C a 3 p i
ichataq	i C a t a q
kanmi	k a n m i
kusa	w o j
marka	m a* r
ninchik	n i n u q a n C i k
runakunamanta	r u n a k u n a m a n t a
runakunapaq	r u n a k u n a p a q
simimanta	s i m i m a r a
the	th~ e
umalliqnin	u m a ly~ i k n i n
waq	w a q
yupayninqa	y u p a  N g a
Díaz	i a z
Eccles	kh~  l e
Fernando	E a n a n d o
Instituto	s t i t u t o
Inti	t i
Javier	a v i e r
Kayqa	a y N g a
Kunanqa	u n a N g a
Maria	a r i a
Piyu	i y u
Premio	r E m i o
Pusaq	u s a q
Runa	u n a
Río	i o
anchata	5 u k u n C a t a
chakra	a q r a
kanqaku	k a n q a k u
kaqkuna	k a q k u n a
kaqman	k a q m a n
manas	m a n a s
pruwinsyanmi	p r u w nsw$ i y a n m i
qillqasqa	q i l q a s k a
rikusqa	r i k u s k a
rimaqniyuq	l i m a q l g
runakunapi	r u n a k u n a p i
ruru	r u r u
sunturnin	s u n t u r n i n
wiñan	w i 5 a n
American	m e r i k a n
Artes	r t e
Aymara	i m a r a
Bedoya	e d o y a
Católica	a t o l i k a
Escuela	s k u e l a
General	e n e r a l
Historia	i s t o r i a
Ima	m a
Maypim	a y k u
Pablo	a b l u
Press	r e s
Urbanu	r b a n u
Uru	r u
Wari	a r i
al	a l
alli	o l
hamun	h E m u n
hinaspa	h i n a s p a
kaqhina	k a q h i n a
kaqlla	k a q L a
kaqrayku	k a q r a y k u
kikinpa	k i k i n p a
las	l a
laya	l a y a
llaqtakunapi	y a q t a k u n a p i
machu	m a C u
nanay	n a n a y
ninku	n i n k u
nirqan	n i r q a n
piluta	p i l u t a
qallarin	q a l l a r i n
qallupi	q a l u p i
qhaway	q a b a y
rikhurin	r i k u r i n
rimaqnin	l i m a q l n
rumi	r u m i
sisa	s i s a
wasikuna	w a s i k u n a
watayuq	w a t a y u
wañurqan	w a 5 u r q a n
yachaq	y a C a q
yapasqa	y a p a s k a
Ñiqi	i k i
ñawpagradupi	y a* w p a g r a d u p i
Agustín	g u s t i
Arte	r t e
Bellas	e y a
Buliwya	l i p y a
Concepción	o u p i o n
Cristóbal	r i s t o b a l
Cusco	u s k o
Gutiérrez	h o 7 o t i y ty ~ e z
Imprenta	p r e nt~ a
John	o h E 5
Revista	e i s t a
Suqta	b t a
Yuraq	u r a q
a	a
allinta	a ly~ i t a
chawpi	C a p i
chayqa	C a y N g a
hukniyuq	h u k n i y u
kachi	k a C i
kamachiy	k a m a C i
kawsaq	k a w s a q
kaykuna	k a y k u n a
kaypi	k a y p i
llapan	l l a p a n
ninchikmi	n i n u q a n C i k m i
nisqapas	n i S q a p a s
niyta	n i nd~ a
qillqasqan	q i l q a s x u q
runap	r u a p
ruruchinapaqmi	r u r u C a  u t " u k m i
simiman	s i m i m a n
suti	s u t i
wiñay	w i 5 a y
yachachin	y a C a C i n
Andina	n t i n a
Dictionary	i k t i o n a r
Hukllachasqa	u k y a C a s k a
Isabel	s a b e l
Ispaña	s p a 5 a
Kawsay	a w s e i
Librería	i b r e r i a
Lliw	l i p
Qullu	u L u
School	C o l
Sichus	i T u s
Tampu	a m p u
Tomo	o m o
Urqu	r X u
Wak	a k
Yala	a l a
hampikamayuq	h a m p i k a m a y u
hunumanta	h u n u t a
kanqa	k a n N g a
llaqtamanta	y a q t a
mitrum	a n u d
munisipyunmi	m u n i s i p y u n m i
musiku	s i k u
nisqamanta	n i S g o t a
nisqawan	n i S q a w a n
qhipa	q i p a
qhipagradupi	q i p a g r a d u p i
qillqaq	q i l q a q
qillqayta	q i l q o nd~ a
quchamanta	k C a m a n t a
rimaykunata	l i m a y k u n a t a
wasipi	w a s i p i h
yachachiq	y a C a X a n d Z i X
ñan	y a*
Andinos	n t i n o s
Anti	t i
Awqaq	w q a q
Caracas	a r a k a s
Chaypi	h a 3 p i
Chile	h i l e N
Chili	h i l i
Cruz	r u
Cáceres	a u r e
García	a r T i a
Hawa	a w a
Ichaqa	a q a
Jorge	u r g e
Kuraq	u r a q
Ministru	i n i s t r u
Moreno	o r e n o
New	e w a
Nueva	k i k " v a
Nuevo	k i k " v o
Pacha	a C a
Paykuna	a y k u n a
Seminario	e m i n a r i o
Siglo	i L o
São	a o
Tawantinsuyu	a w a n t i n s u y u
Truhillu	r u h i l l u
Universitaria	n i v e r s i t a r i a
Valencia	a l e n C i w a
Walla	a ly~ a
Yale	a l e
akllasqa	a k y a s k a
amachasqa	a m a C a s k a
chantapas	C a n t 3 p 3 s
epinefrina	a p i n e f r i n a
faringitis	f a r i N i t i s
imatapas	i m a t 3 p 3 s
kaqkama	k a q k a m a
kasqan	k a s x u q
kayqa	k a y N g a
kutiqa	k u t i k a
llapa	l l a p a
llaqtan	y a q t a n
may	m a y
ministru	m i n i s t r u
munisipyupi	m u n i s i p y u p i
nisqata	n i S q a t a
paqarin	p a q a r i n
pichqayuq	p i c g o y u
puka	p u k a
pukllaq	p u k y a q
rimaq	l i m a q
runakunapas	r u n a k u n 3 p 3 s
tukukun	n k u k u n a
ukhu	u k u
umalliqninmi	u m a ly~ i k n i n m i
willan	w i l l a n
yura	y u r a
Allin	ly~ i n
Ama	m a
Amaru	m a* r u
Amirika	m i r i k a
Bíblica	i b a l i k a
Carmen	a r m e n
Casa	a s a
Dyus	y u s
Educación	d u k a i o n
Fe	e
Grammar	r a m m a r
Husiy	s u
Inca	C a
Inka	k a
Jatun	a t u n
Joseph	o s e p
Juana	u a n a
Kashamarka	a s a m a r
Kichwa	i C w a
Kunti	u n t i
Lipis	i p i s
Llaqta	l a q t a
Machu	a C u
Marcos	a r k o s
Mariscal	a r i s k a l
Matías	a t i 3 s
Merced	e r 3 d
Mishiku	i S i k u
Museo	u s a i o
Obras	b a s
Pampas	a m a s
Pichqantin	i C g o n t i n
Pidru	d r u
Pikchunqa	i k w a n N g a
Punta	u n t a
Qosqo	o s k a
Qullana	u y a n a
Ramón	a m o n
Roberto	o b e r t o
Unión	n i o n
Wawakuna	a w a k u n a
Wayna	a y n a
Wila	i l a
ahinataq	a h i n a t a q
antanka	a n t a n
atinchu	a t i n C u
chayta	C a i t a
edición	p i e d w C i w r o n
hampikuna	h a m p i k u n a
hukkunataq	h u k k u n a t a q
huñusqam	h u 5 u s o m a r s
inti	i n t i
kachkanku	k a C k a n k u
kaqkunata	k a q k u n a t a
kawsan	k a w s a n
kuyuy	k u y u y
llaqtachapiqa	y a q t a C a p i k a
llaqtaman	y a q t a m a n
manaraq	m a n a r a q
manaña	n e 5 e w a
maypi	m a y p i
nir	n i r
niyan	n i a n
pachan	p a C a n
para	p a r a
pinchikilla	p i n C i k i l l a
purin	p u r i n
qallu	q a L u
quchap	k C a p
qukun	q u k u n a
respiratorias	r e s p i r a t o r i a s
rimachkanku	l i m a C k a n k u
ruran	r u r a
ruwakun	r u w a k u n
tarikun	t a r i k u n
tuktu	n a t u
unqunayaq	u n ky~ n a y a q
urin	u r i n
waranqachá	w a r a n q o t a
yachaqkuna	y a a q k u n a
yachaywasikunapi	y a C a y w a s i k u n a p i
yupay	y u p a y
