di	d i
e	e
cu	k u
ta	t a
a	a
pa	p a
un	u n
na	n a
den	d e n
nan	n a n
tin	t i n
no	n o
Aruba	r u b a
por	p o r
lo	l o
aki	a k i
nos	n o s
riba	b a
su	s u
mas	m a s
tabata	t a b a t a
tur	t u r
mester	m e s t e r e n
bay	b a y
wordo	e* d o
tambe	t a mb~ e
haci	h a k i
esaki	e s a k i
haya	h a y a
hopi	h o p i
pero	p e r o
otro	o t r o
keda	k e d a
hende	h e n d e
bo	b o
asina	a s i n a
aña	a 5 a
persona	p e r s o n a
mes	t i m 3 s
duna	d u n a
si	s i
tuma	t u m a
sigui	s i g u i
como	k o m o
bisa	b i s a
ora	o r a
pasa	p a s a
Minister	i n i s t e r e n
bin	b i n
for	f o r
dia	d i a
nobo	n o b o
Na	a
yega	y e g a
caso	k a s o
manera	m a n e r a
Hulanda	u l a n d a
kier	k i e r
Gobierno	o b i E a n o
prome	p r o m e
loke	l o k e
unda	u n d a
cas	k a s
Pa	a
pais	p a i s
grandi	g r a n d i
situacion	s i t u a i o n
drenta	d r e nt~ a
caminda	k a m i n d a
momento	m o p i N t o
Esaki	s a k i
Den	e n
bon	b o n
cual	k u a l
forma	f o r m a
traha	tr~ a h a
bira	b 3 r a
te	t e
parti	p e r t i
Ta	a
gobierno	g o b i E a n o
dos	d o s
mira	m i r a
Nos	o s
Un	n
durante	d u r a n t e
despues	d e s p u e
pone	p o n e
con	k o n
diferente	d i f e r e n t e
pasobra	p a s o b r a
siman	s i m a n
pueblo	p u e b l o
sin	s i n
caba	k a b a
entre	e n t r e
polis	p o l i s
awor	u o r
anochi	a n o C i
yuda	y u d a
biaha	b i a h a
cuminsa	k u m nsw$ i a
sa	s a
importante	i m p o r t a n t e
Polis	o l i s
tempo	t e N p o
informacion	i n h i o n
trata	tr~ a t a
presenta	p r e s e nt~ a
habri	h a b r i
Parlamento	a r l a m e n t o
mundo	m u n d o
comunidad	k o m u n i d a d
auto	a u t o
sitio	s i t i o
pidi	p i d i
luna	l u n a
esnan	e s n a n
algun	a l g u n
placa	p l a y i k a
segun	s e g u n
ainda	a i n d a
esey	e s a i
mustra	s t r a
dilanti	d i l a n t i
mi	m i
problema	p l o b l 3 m a
ricibi	r i C i b i
tene	t e n e
crisis	k r i s i s
Croes	r o m 3 s
splica	s p l i k a
paga	p a g a
indica	i n d i k a
ya	y a
Pero	e r o
logra	l o g r a
mainta	m a i t a
hunto	h u n t o
mucha	m u C a
door	o r
sali	s a l i
kico	k i k o
ley	l E
atende	a t e n d e
contra	r o n t r a
trece	t r e k e
total	t a t a l
papia	p a p i a
cada	k a d a
Prome	r o m e
ultimo	u l t i m o
lugar	g a r
cantidad	k a n t i d a d
motibo	m o t i b o
Si	i
mesora	m e s o r a
financiero	f i n a n C y e r o
yama	y a m a
grupo	g n i n o
informa	i n h m a
conoce	r o n o k e
ningun	n i 3 l n
ey	u y
entrega	e n t r e g a
banda	b a n d a
publico	p u b l i k o
algo	a l g o
patruya	p a t r u y a
bek	b e k
sigur	s i g u r
famia	f a m i a
para	p a r a
homber	h o b e r e
scol	s k o l
laga	l a g a
awe	a w e
casonan	k a s o n a n
varios	v a r i o s
dirigi	d i r i g i
trabao	tr~ a b a o
via	v i a
trabou	tr~ a b o u
busca	b u s k a t
tanto	t a n t o
cumpli	k u m p l i
solamente	s o l a m e n t e
test	t e s
personanan	p e r s o n a n a n
de	d e
cuenta	kw~ e nt~ a
economia	e k o n o m i a
cera	T E r a 7
Nan	a n
baha	b a h a
cos	k o s
Segun	e g u n
Departamento	a p i t a m e n t o
base	b a s e
Tambe	a m b e
compania	k o mp~ a n i a
virus	v i r u s
muchanan	m u C a n a n
dicidi	d i k i d i
No	o
ser	s e r
informe	i n h m e
bida	b i d a
positivo	p o s i t i b o
Tur	u r
wak	w a k
man	m a n t a
Hues	u e
entrada	e n t r a d a
miyon	m i y o n
social	s o k i a l
Ministro	i n i s t r o
nota	n o t a
Hulandes	u l a n d e
posibel	p o s i b e l
manda	m a n d a
salud	s a l u d
Tin	i n
proyecto	p r o y o j t o
Maduro	a d u r o
hasta	h a s t a
maneho	m a n e h o
menos	m E n o s
ni	n i
Merca	e r k a
necesario	d e* k a* b e s a r i o
cuido	k u i d o
mesun	m e s u n
en	e n
Reino	e i n o
acuerdo	a 7 kw~ e r d o
bishita	b i S i t a
crea	k r e a
servicio	s e r i i o
personal	p e r s o n a l
dje	j e
prensa	p r e s a
conoci	r o n o k i
mantene	m a n t e n e
reunion	r e u n i o n
minister	m i n i s t e r e n
futuro	f u t u r o
menciona	m E n C i i o n a
local	l o k a l
luga	g a
rond	r o n d i
basta	b a s t a
Mike	i k e
proceso	p r o k e s o
hendenan	h e n d e n a n
Cu	u
caya	k a y a
registra	r e g i s t r a
evita	p i r i t a
spera	s p e r a
coronavirus	k o r o n a b i r u s
cay	k a y
bou	b o u
accidente	a k i d e n t e
Evelyn	v e l o v e
economico	e k o n o m i  o
florin	f l o r i n
dal	d a l
mandatario	m a n d E t E d i t o o
yegada	y e g a d a
isla	i s l a
debi	d e b i
henter	h e n t e r
cambia	k a m b i a
prepara	p r e p a r a
medidanan	m e d i d a n a n
nada	n a d a
Durante	u r a n t e
investigacion	i n v e s t i g a i o n
pandemia	p a n d e m i a
medico	m e d i k o
semper	s e m p e r
tabatin	t a b a t i n
Despues	e s p u e
politico	p o l i t  o
chauffeur	C a u f e u r
uza	u z a
Oduber	d u b e r e
dificil	d i f i k i l
sistema	s i s t e m a
cuminza	k u z a
Diabierna	i a b i E a n a
cla	k l a
brinda	b r i n d a
subi	s u b i
tereno	t e r e n o
Nicolas	i k o l a
poco	p o k o
mientras	m i e n a s
tres	w a m i
Pues	u e
compronde	k o m p r o nd~ e
halto	h a l t o
awa	a w a
Dialuna	i a l u n a
conta	r o n t a
cambio	k a m b i o
cerca	C E r k a
causa	k a u s a
Publico	u b l i k o
fin	f i n
dama	d a m a
hospital	h o s p i t a l
locual	l o kw~ a l
contacto	r o n t a  t o
sector	s e k t o r
uno	u n o
Esey	s e
Ora	r a
decision	d e 7 i s i o n
biba	b i b a
atardi	E t E d i t d i
Por	o r
turismo	t u r i s m o
perde	p e r d e
relaciona	r e l a c i o n a
herida	h e r i d a
core	k o r e
expresa	" p r e s a
negoshi	n e g o S
warda	w a r d a
Hospital	o s p i t a l
Parlamentario	a r l a m e n t a r i o
control	r o n t r o l
medio	m e d i o
Di	i
detene	d e t e n e
Eman	m a n t a
topa	t o p a
area	a r e a
Fiscal	i s k a l
anuncia	n u i a
resultado	r e s u l t a d o
saca	s a k a
afecta	a f e k t a
mundial	nd~ i a l
San	a n
candela	k a n d e l a
percura	p e r k u r a
desaroyo	d e s e r o y o
Venezuela	e n d u e l a
hiba	h i b a
serio	s e r i o
sosten	s o s t e i n
ehempel	e h e m p e l
ayudo	a y u d o
cliente	k l i e n t e
Diahuebs	i a w r
paisnan	p a i s n a n
exigi	" i g i
momentonan	m o p i n t o n a n
edad	e d a d
pregunta	p r e g u n t a
final	f i n a l
peticion	p e t i i o n
van	v a n
Diasabra	i a s a b r a
sosode	s o s o t e
nifica	n i f i k a
reglanan	r e g l a n a n
pago	p a g o
atencion	a t e n C i w o n
actual	a k t u a l
ariba	a r i b a
partido	p e r t i d o
Mi	i
bini	b i n i
chikito	c " i k i t o
internacional	i n t E r n a g a o n a l
desde	d e s d e
oportunidad	L o k t u n i d a d
pues	p u e
conferencia	r o n f m i n C i w a
punto	p u n t o
bolbe	b o l b e
introduci	i n t r o C u k i
bao	b a o
plan	p l a n k o
permiti	p e r m i t i
aworaki	a w o r a k i
esta	e s t a
remarca	r E m a r k a
cierto	C y e r t o
programa	p r o g r a m a
controla	r o n t r o l a
Awe	w i
Ministerio	i n i S t E r i o
purba	p u r b a
pashent	p a S o
salario	s a l a r i o
fuerte	f u e r t e
meta	m e t a
sumamente	s u m a m e n t e
berdad	b E r d a d
kende	k e n d e
medida	m e d i d a
Diamars	i a m a r
companianan	k o mp~ a n i a n a n
nomber	n o mb~ e r
gastonan	g a s t o n a n
dianan	d i a n a n
Coronavirus	o r o n a b i r u s
so	s o
trahando	t r a h a n d o
cune	k u n e
pensa	p e s a
Presidente	r e s i d e n t e
hecho	h e T h o
hoben	h o b e n
Riba	i b a
Diadomingo	i a d o m i Ng~ o
Salud	a l u d
firma	f E i r m a
sinti	s i n t i
nunca	n u C a
turista	t u r i s t a
nivel	n i v e l
cualkier	k u a l i e r
sr	s r
number	n u mb~ v e r
tocante	t o k a n t e
Awor	w o r
yiu	y i u
Caribe	a r i b e
esun	e s u n
periodo	p e r i o t o
kere	k e r e
sinta	s i t a
miembronan	m i e mb~ r o n a n
tipo	t i p o l a
atrobe	a t r o b e
realidad	r e a l i d a d
resulta	r e s u l t a
cumpra	k u m p r a
prueba	p r u e b a
general	g e n e r a l
activo	a k t i b o
cuminda	k u m i n d a
interes	i n t e r e
mirando	m i r a n d o
Manera	a n e r a
departamento	d e p i t a m e n t o
temporada	t e m p o r a d a
Citgo	i t g o
impacto	i m p a k t o
tawata	t a w a t a
team	t e a m
ofrece	o f r e k e
participa	p e r t i k i p a
regla	r e g l a
Asina	s i n a
largo	l a r g o
porta	p o t a
kibra	k i b r a
pasando	p a s a n d o
palabra	p a l a b r a
duro	d u r o
presente	p r e s e n t e
Mester	3 S t a r
yena	y e n a
desea	d e s a i a
Pesey	e s a i
tras	a s
contesta	r o n t e s t a
bienestar	s o N u s t a r
propio	p r o p i o
malesa	m a l 3 s a
miembro	m i e mb~ r o
carta	k i t a
online	o n l i n e
Florin	l o r i n
ciudadano	i u d a d a
gradici	g r a d i k i
guia	g i a
hobennan	h o b e n
victima	v i k t i m a
asistencia	a s i s t i n C i w a
special	s p e k i a l
siguiente	s i g i n t e
clientenan	k l i e n t e n a n
mihor	m i h o r
derecho	d e r e T h o
suma	s u m a
ku	k u
malo	m a l o
worde	e* d e
cana	k a n a
Bo	o
arma	a r m a
boto	b o t o
Fundacion	u n d a i o n
lama	l a m a
necesidad	d e* k a* b e s i d a d
kita	k i t a
gobernacion	g o b E a n a g a o n
usa	u s a
bista	b i s t a
eleccion	e l e k i o n
Dia	i a
falta	f a l t a
anterior	a n t E r i o r
recupera	r E C u p e r a
Cuerpo	 p o
trafico	tr~ a f i k o
uzo	u z o
atras	a t a s
proyectonan	p r o y o j t o n a n
puntra	p u n t r a
lanta	l a n t a
mucho	m u C o
mayoria	m a y u r i a
normal	n o r m a l
añanan	a 5 a
miho	m i h o
frontera	f r o n t E r a
oficial	o f i h i a l
contento	r o n t e n t o
tampoco	t a m p o k o
debe	d e b e
Pais	i s
lista	l i s t a
pronto	p r o n t o
sostene	s o s t e n
compara	k o m a r a
demostra	d e m o s t r a
esakinan	e s u ly~ o
vacuna	v a k u n a
Toque	o k E
rapport	r a p p o r
Aki	k i
dialuna	d i a l u n a
cubri	k u b r i
mil	m i l
droga	d r o g a
pashentnan	p a S e n t n a n
seguridad	s e g u r i d a d
agrega	y r e g a
condicionnan	r o n d i i o* n a n
Betico	e t i k o
Como	o m o
mescos	m e s k o s
tema	t e m a
abuso	a b u s o
For	o r
morto	m o r t o
awo	a w o
hasi	h a s i
trahadornan	t r a h a d o r n a n
cuadro	k u a d r o
scolnan	s k o l n a n
problemanan	p l o b l 3 m a n a
solucion	s o b e l i o n
declara	d e k l a r a
Marisol	a r i S o l
opinion	o p i n i o n
vehiculo	e i k u l o
lucha	l u C a
proximo	p r o x i m o
cifranan	i f r a n a n
distancia	d i s t a n C i w a
Sinembargo	i n e m b a l i m a g o
bunita	b u n i t a
ki	k i
Ademas	d e m a s
eynan	b n a n
Policial	o l i i a l
actua	a k t u a
masha	m a Ch~ a
maximo	m a x i m o
acepta	a k e p t a
mayornan	m a y u r n a n
aden	a d e n
gana	g a n a
basa	b a s a
fecha	f e C a
Diaranson	i a r a Th~ o n
Corte	u r t e
responsabilidad	r e s p o i r a r u w i l i d a d
riesgo	e s g o
stop	s t o p
gran	g r a
oficina	o f i k i n a
Arubiano	r u b i a
unico	u n i C o
cuarentena	k u a r e n t e n a
merdia	m e r d i a
casi	k a s i
completo	k o m p l e t o
facil	f a c i l
poni	p o n i
Kico	i S
aplica	a p l i k a
peliger	p e l i g e r
Arubano	r u b a
Covid	o v i d
autoridad	a u t o r i d a d
diabierna	d i a b i E a n a
scucha	s k u C a
confirma	r o n f i r m a
constata	k o s t a t a
encarga	e n k a r g a
haciendo	h a C y e n d o
presupuesto	p r e s u p u e s t o
principal	p r i n k i p a l
aumenta	a u m e nt~ a
Hopi	o p i
Colegio	o l e g i o
bandona	b a n d o n a
hunga	h u N a
rato	r a t o
Bikker	i k k a r
cuida	k u i d a
mayor	m a y o r
permiso	p e r m i s o
proteha	p r o t e h a
mercado	m e r a y
edificio	  i o
completamente	k o m p l e t a m e n t e
corda	k o r d a
empleadonan	3 mp~ l e a d o n a n
fase	f a s e
mama	m a m a
Maart	a r
pm	p m
Knops	o p
curpa	k u r p a
Husticia	u s t i i a
bai	b a i
posibilidad	p o s i b i l i d a d
cambionan	k a m b i o n a n
extra	e S
protocol	p r o t o k o l
realisa	r e a l i s a
asunto	a s u n t o
cosnan	k o s n a n
sea	s e a
depende	d e p e n d e
acaso	a k a s o
Dangui	a N gw~ i s
Santa	a n t a
cooperacion	k o o p e r a i o n
oranan	o r a n a n
refineria	r e f i n e r i a
ambulans	a m b u l a
hinca	h i n k a
mata	m a t a
pesey	p e S 7y~
actividad	a k t i v i d a d
accion	a k i o n
publica	p u b l i k a
sra	s r a
direccion	d i r E C i o n
sera	s e r a
señala	s e ny~ a l a
trahador	t r a h a d o r
uso	u s o
Club	l u b "
Crisis	r i s i s
Premier	r E m i e r
over	o v e r i
studiantenan	s t u d i a t e n a n
suficiente	s u f i C y e n t e
estado	e s t a d o
campaña	k a m a 5 a
djis	d h i s
dor	d o r
maart	m a r
nacional	n a g a o n a l
website	w o r s i t e
Team	e a m
polisnan	p o l i s n a n
tira	t i r a
Pueblo	u e b l o
historia	h i s t o r i a
tratamento	tr~ a t a m e n t o
danki	d a n k i
lunanan	l u n a n a n
sospechoso	s o s p e C o s o
Lo	o
benta	b e n t a
conseho	r o n c e h o
preocupacion	p r e o k u p a k i o n
director	d i r E C t o r
islanan	i s l a n a n
Gabinete	a b i n e t e
calidad	k a l i d a d
leynan	l e y n a n
pafo	p a f o
Bank	n
Cruz	r u
disponibel	d i s p o n i b e l
full	f u l o
or	o r
señora	s e 5 o r a
Sr	r
bati	b a t i
considera	k o s i d e r a
digital	d i g i L a l
mesa	m e s a
net	n e t
toch	t o X
comparti	k o m p i t i
fondo	f o n d o
gasto	g a s t o
paso	p a s o
estudio	e s t u d i o
vuelo	v u e l o
December	e T E m b e r e
cura	k u r a
doño	d w o
sino	s i n o
desaroya	d e s e r o y a
acudi	a k u d i
contribui	r o n b u i
lubida	l u b i d a
priva	p r e
bayendo	b a y e n d o
carga	k a r g a
comercio	k o * i o
Juli	u l i
November	o p e m u mb~ e r
Social	T i a l
destrui	d e s t r u i
humano	h u
juli	x u l i
importancia	i m p o r s i k a n C i w a
Tromp	r o m p
actualmente	a k t u a l m e n t e
fundacion	f u nd~ a i o n
Nacional	a c i o n a l
Wever	e v e r i
articulo	i t i k u l o
aproba	a p r o b a
condicion	r o n d i k i o n
instancia	s t a n C i w a
liber	b e r e
muher	m u h e r
responsabel	r e s p o i r a r u w
rotonde	r o t o nd~ e
Beach	E w e
September	a p t e mb~ e r
continua	r o n t i n u a
testnan	t e s t n a n
pisa	p i s a
uni	u n i
hala	h a l
termina	t E r m i n a
stipula	s t i p u l a
boso	b o s o
celebra	k e l e b r a
comision	k o m i s i o n
bende	b e n d e
i	i
leu	l E u
madruga	d r u g a
maneha	m a n e h a
reuni	r e u n i
studiante	s t u dy~ a n t e
trahado	t r a h a d o
turistanan	t u r i s t a n a n
plama	p l a y i m a
produci	p r o C u k i
puntonan	p u n t o n a n
Te	e
keto	k e t o
experiencia	" p e r i n C i w a
paden	p a d e n
subraya	s u b r a y a
inclui	i n k l u i
October	k t o b e r e
cita	C i w a
Queda	u e d a
Juni	u n i
Partido	i t i d o
ambiente	a m b i e n t e
Ley	u y
Tabata	a b a t a
capacidad	k a p a k i d a d
cuanto	k u a nt~ o
espacio	e s p a i o
bario	b a r i o
empleado	3 mp~ l e a d o
garantisa	g a r a n t i s a
Central	e n t r a l
abogado	a b o g a d o
ambulance	a m b u l a n k o e
organisacion	u r g a n i s a k i o n
reduci	r e d u k i
castigo	k a s t i g o
chens	C e n
fiesta	f i e s t a
parlamentario	p a l a m e n t a r i o
pega	p e g a
seguro	s e g u r o
deteni	d e t e n i
sintoma	s i n t o m a
Pasobra	a s o b r a
organisa	u r g a n i s a
pasado	p a s a d o
sigura	s i g u r a
tiki	t i k i
Banco	5 u k a o
Mientras	i e n a s
afo	a f u
autonomia	a u t o n o m i a
confronta	r o n f r o n t a
recuperacion	r E C u p e r a i o n
Mas	a s
bisti	b i s t i
donacion	d o n a g a o n
Mei	e i
abou	a b " a u
dolor	d o l o r
Aparte	p e r t e
enfatisa	e n f a t i s a
pia	p i a
Polisnan	o l i s n a n
Serlimar	e r l i m a r
adapta	a d a p t a
prijs	p r i j
China	h i n a
check	C e k
ne	n e
Desde	e s d e
aumento	a u m e n t o
entrante	e n t r a n t e
pakico	k i k o
subsidio	s u b i d i o
luz	% i s
video	v i d e o
Loke	o k e
Status	t a t u s
comercial	k o * r i a l
ciudadanonan	i u d a d a n o n a n
mal	m a l
aspecto	a 8 p e n e k t o
transporta	i t r i s p o r t e
fondonan	f o n d o n a n
mei	m e i
proteccion	p r o t e k i o n
boet	b o e t
evalua	p i r a l u a
Gobernador	o b E a n a d o r
corta	k o r t e
marduga	m a* r d u g a
negativo	n e g a t i b o
presencia	p r e s i n C i w a
banco	b a n C i o
material	m a t e r i a l
diasabra	d i a s a b r a
enfrenta	e n f r e nt~ a
menasa	m E n a s a
enseñansa	e n s 5 a s a
noticia	n o t i i a
Curacao	u r a k a w
declaracion	d e k l a r a i o n
etc	e t
hotel	h o d
siña	s i 5 a
caida	k a i d a
famianan	f a m i a n a n
Sra	r a
invita	i n v i t a
potret	p o t r e t
Endy	n t a
impuesto	i m p u e s t o
lider	l i d e r
pakete	p a k e t e
sala	s a l a
Centro	e n t r o
Impuesto	p u e s t o
region	r e g i o n
relacion	r e l a i o n
tata	t a t a
cacho	k a C o
contagio	r o n t a h i r i o
documento	d o k u m e n t o
ilegal	i l e 7 a l
poder	p o d e r
yiunan	y i u n a n
Banda	a n d a
horta	h o r t e
pasahero	p a s a h e r o
ripara	r i p a r a
barco	b a r k o
directiva	d i r E C t i v a
combati	k o mb~ a t i
Colombia	o l o m b i a
politica	p o l i t i k a
presidente	p r e s i d e n t e
produccion	p r o C u k i o n
solo	s o l o
exterior	e S e r i o r
ken	k e n
buki	b u k i d
centro	C E n t r o
conclui	r o n k l u i
dokter	d o k t e r e n
lihe	l i e
resultadonan	r e s u l t a d o n a n
yudansa	y u d a s a
Facebook	a k r o k
ayera	a y e r a
consecuencia	r o n e kw~ e n C i w a
ehecuta	e h e k u t a
juni	C i x u n i
otronan	o t r o n a n
legal	l e 7 a l
balor	b a l o r
detencion	d e t e n C i w o n
mara	m a r a
tumando	t u m a n d o
fisico	f i s i k o
Censo	e n s o
Con	o n
efecto	e f e k t o
higiena	h i x i e n a
in	i n
pareha	p a r e h a
producto	p r o C u k t o
productonan	p r o C u k t o n a n
bes	b e sy~ s
desaroyonan	d e s e r o y o n a n
limita	l i m i t a
basico	b a s i k o
diahuebs	d i a w r
negoshinan	n e g o s i n a n
reto	r e t o
unidad	u n i d a d
yamada	y a m a d a
pendiente	p e n d i e n t e
Augustus	t u g u s t u s
acerca	a C E r k a
directamente	d i r E C t a m e n t e
Dr	r
altura	a l t u r a
ambos	a m b o s
diamars	d i m a r
laboral	l a b o r a l
tey	t e
fraccion	f r a k i o n
kiermen	k i e s a y m 3 n
Lampe	a m p e
coriente	k o r i n t e
diaranson	d i a r a Th~ o n
prison	p r i S o n
sufri	s u f r i
Carnaval	a X n a q a v a l
Januari	a n u a r i
Noord	o r d
contagia	r o n t a h i r i a
costa	k o s t a
Cada	a d a
Conseho	o* s e h o
bishitante	b i S i t a n t e
directo	d i r E C t o
documentonan	d o k u m e n t o n a n
envolvi	e n v o l w i
forsa	f o r s a
and	a n d
bishitantenan	b i S i t a n t e n a n
evento	e b e n t o
mental	m e n t a l
topico	t o p i k o
trahadonan	t r a h a d o n a n
november	n o p e m u mb~ e r
augustus	a u g u s t u s
december	d e u mb~ e r
vota	v o t a
Turismo	u r i s m o
instancianan	s t a n C i w a n a n
interna	i n t E r n a
parce	p i r e
tarea	t a r e a
pisca	p i s k i s  a
raporta	r a p o r t e
telefon	t e l e f o n
Costa	o s t a
diadomingo	d i a d o m i Ng~ o
inicia	i n i C i a
Director	i r E C t o r
Xiomara	i o m a r a
actividadnan	a k t i v i d a d n a n
adicional	a d i k i o n a l
sirbi	s i r a b i
corecto	k o r e k t o
crece	k r e k e
deporte	d e p o r t e
lamenta	l a m e nt~ a
retonan	r e t o n a n
cobra	k o b r a
come	k o m e
influencia	i n f n i n C i w a
keho	k e h o
pagina	p a x i n a
siguridad	s i g u r i d a d
Oranjestad	r a n o x e s t a d
Uni	n i
emergencia	E m E r x i n C i w a
enorme	e n o r m e
ex	Z i 7
incluyendo	i n k l u y e n d o
prevencion	p b e b e n C i w o n
profesional	p r o f i S i o n a l
daño	d a 5 u
ela	e l a
ocasion	k a s a  o n
reconoce	r E c o n o k e
tera	t E r a
Mericano	e r i C i t a
avion	a g o y o n
comunicacion	k o m u n i C i i o n
confiansa	r o n f i a s a
dato	d a t o
Caya	a y a
Europa	u r o p a
alarma	a l a r m a
fayece	f a y o j e
abao	a b a o
educacion	e d u k a i o n
presentacion	p r e s e n t a  i o n
residente	r e s i d e n t e
Trump	r u m p a
notifica	n a   k a
protocolnan	p r o t o k o l n a n
recorda	r E c o r d a
start	s t a r
Benny	e 5
Maarten	a i t e n
corupcion	k o r b i o n
expertonan	" p e r t o n a n
fabor	f a b e r
lesa	l 3 s a
posicion	p o s i i o n
Algemene	l N g E m E n E
cara	k a r a
representa	r e p r e s e nt~ a
careda	k a r e d a
demanda	d e m a n d a
encera	e n u r a
existi	" i s t i
April	p r i l
isola	i s o l a
les	l e
meter	m e t e r
promer	p r o m e r
specialmente	s p e k i a l m e n t e
tende	t e n d e
Stichting	t i C t i N
enfoca	e n f o k a
september	s e p t e mb~ e r
central	C E n tr~ a l
decisionnan	d e 7 i s i o n n a n
indicacion	i n d i k a i o n
industria	i d u s t r e
remedi	r E m E d i
surgi	s u r g i
color	k o l o r
mensahe	m e sh~ 3 e
Parke	a r k e
anto	a n t o
deshaci	d e S a k i
parlamento	p a l a m e n t o
sushi	s u s i
Diaranzon	i a r a n z o n
politiconan	p o l i t i k o n a n
rekeri	r e k e r i
rol	r o l
De	e
Rekenkamer	e k a n y o m e r
preguntanan	p r e g u n t a n a n
atraco	a t r a k o
email	l e m a l i l
sindicato	s i n d i k a t o
Algun	l g u n
Arends	r e n d
isolacion	i s o l a  i o n
papel	p a
studia	s t u d i a
camber	k a m b e r e
minimo	m i n i m o
transporte	i t r i s p o r t e
TdQ	d
duda	d u d a
intencion	i n t e n C i w o n
investiga	i n v e s t i g a
cifra	i f r a
mehora	m e h o r a
am	a m
simannan	s i m a n a n
Corona	o r o n a
alumnonan	a l u m n o n a n
ladronicia	l a d r o n i k i a
peligroso	p e l i g r o s o
preocupa	p r e o k u p a
wega	w e g a
Europeo	u r o p e o
formulario	f o r m u l a r i o
idea	d e a
Lopez	o p e z
distanciamento	d i s t a n C i w a m e n t o
Cas	a s
Raad	k i m a t o
drecha	d r e C a
funciona	f u n C i i o n a
musica	s i k a
practica	p r a k t i k a
servicionan	s e r i i o n a n
Esnan	s n a n
opcion	o p i o n
ordo	u r d o
turistico	t u r i s t  o
Plan	l a n
inverti	i n e r t i
rijbewijs	r e j o b e w i j
yen	y e n
Cultura	u l t u r a
amplio	a m p l i o
aunke	a u n k e
queda	k e d a
lansa	l a s a
muri	m u r i
o	o
premio	p r e m i o
premira	p r e m i r a
blanco	b l a*  o
cabes	k a b e sy~ s
consisti	k o ns~ i s t i
dedica	d e d i k a
entrevista	e n t r e i s t a
operacion	o p e r a i o n
Ban	a n
Mirando	i r a n d o
Su	u
abo	a b o
canando	k a n a n d o
consideracion	k o s i d e r a i o n
limpi	l i m p i
pensamento	p e s a m i n t o
Enseñansa	s e 5 a s a
Lotto	o t t o
contenido	r o n t e n i d o
drumi	d r u m i
grandinan	g r a w
adres	a d r e
construccion	k o s t r u C a i o n
splicacion	s p l i k a i o n
Debi	e b i
alumno	a l u m
habitantenan	h a b i t a n t e n a n
januari	h a n u a r i
mr	m r
pasonan	p a s o n a n
Tanki	a n k i
antes	a n c i
pariba	p a r i b a
toque	t o k E
training	tr~ a i n i N
Corsow	u r s o
atento	a t e n t o
muhe	m u e
representante	r e p r e s e n t a n t e
urgencia	u r g e n C i w a
Dios	i o s
Tjon	h o n
empresa	3 mp~ r e s a
esfuerso	e s pw~ e r s o
acusa	a k u s a
gruponan	g r u p o n a n
mocion	m o k i o n
prestamo	p r e s t a m o
stroba	s t r o b a
coleganan	k o l e 7 a n a n
implementa	i m p l E m E n t a
preveni	p b e b e n i
sentencia	s e n t e n C i w a
concerni	r o n C E r n i
enfermedad	e n f s a y m 3 d a d
aglomeracion	a g l o m e r a i o n
naturalesa	n a t u r a l 3 s a
cua	k u a
piso	p i s o
reacciona	r e a k i o n a
regresa	r e g r e s a
prioridad	p r i o r i d a d
trabounan	tr~ a b o u n a n
Afl	f
Koolman	o l 3 m
Otro	t r o
miedo	m i e d o
real	r e a l
exitoso	" i t o s o
funcion	f u n C i w o n
gara	g a r a
inicio	i n i C y o
sindicatonan	s i n d i k a t o n a n
voto	v o t o
Pasco	a s k o
Savaneta	m a v a n e t a
comete	k o m e t e
docentenan	d o k e n t e n a n
elabora	e l a b o r a
palo	p a l o
reaccion	r e a k i o n
sexual	s e S u a l
amplia	a m p l i a
bezig	b e z i g
determina	d e t e r m i n a
encontra	i n C i o* t r a
supervision	s u p e r i s i o n
tal	t a l
vision	v i s i o n
Aeropuerto	E a z u e r t o
Mesora	e s o r a
akinan	u ly~ o
alcohol	a l k o h o l
andando	a n nd~ o
apertura	a p e r t u r a
exito	" i t o
stimula	s t i m u l a
yegando	y e g a n d o
palabranan	p a l a b r a n a n
termino	t E r m i n o
vigor	v i g o r
Arubianonan	r u b i a n o n a n
La	a
conhuntamente	r o n u n t a m e n t e
cuadra	k u a d r a
denuncia	d e n u n C i w a
entidad	e n t i d a d
integridad	i n t e g r i d a d
marca	m a* r k a
planea	p l a y i n e a
candidato	k a nd~ i d a t o
comerciante	k o * r i a n t e
diferencia	d i f e r e n C i w a
kizas	k i c~ 3 s
respeta	r e s p e t a
valido	v a l i d o
abusa	a b u s a
bisando	b i s a n d o
boca	b o k a
dentro	d e n t r o
elimina	e l i m i n a
scoge	s k o g e
vuelonan	v u e l o n a n
caha	k a h a
coriendo	k o r i e n d o
cultura	k u l t u r a
escolar	e s k o l a r
huur	h u r
klas	k l o s
prohibi	p r o h i b i
referi	r e f e r i
Kiwanis	i w a n i s
peso	m i o
poblacion	p o b l a n k i o n
procedura	p r o k e d u r a
temponan	t e m p o n a n
Andin	n t i n
amigo	a m i g o
beach	b a
bebe	b e b e
cinco	i nC~ o
discusion	d i s k u s i o n
februari	f e b r u a r i
informacionnan	i n h i o* n a n
moderno	m o d E a n o
nenga	n 3 N a
policial	p o l i i a l
profesionalnan	p r o f i S i o n a l
relato	r e l a t o
acceso	a k u s o
encuesta	e n kw~ e s t a
excepcion	" u p i o n
mag	m a g
reduccion	r e d u k i o n
respet	r E 8 p e n e t
safe	s a f e
viola	v i o l a
Seroe	e r o e
alcansa	a l C i s a
aporte	a p o r t e
condena	r o n d e n a
contene	r o n t e n e
esencial	e s i n C i w a l
preparacion	p r e p a r a i o n
rumbo	r u mb~ o
Asuntonan	s u n t o n a n
areanan	a r e a n a n
defende	d e f e n d e
laboratorio	l a b o r a t o r i o
orario	o r a r i o
participacion	p e r t i k i p a k i o n
planta	p l a y i nt~ a
Cuido	k i d o
Playa	l a y a
confisca	r o n f i s k a
docter	d o k t e r
interesa	i n t e r e s a
orguyoso	u r g u y o s o
patras	p a t a s
sintomanan	s i n t o m a n a
the	th~ e
Recientemente	e T i e n t E m E n t e
Venezolano	e n e z o r a n o
buscando	s k a n d o
comienso	k o m i e s o
obligatorio	o b l a i g a t o r i o
Februari	e b r u a r i
Hunto	u n t o
comprende	k o m p r e n d e
disfruta	d i s f k a 7 a n
fronteranan	f r o n t E r a n a n
gasta	g a s t a
mishi	m i S i
porciento	p o r i e n t o
Cuba	u b a
Howell	o w e l o
anual	a n u a l
docente	d o k e n t e
examen	" a m e n
familiar	f a m i l i a r
Tourism	o u r i s m
asuntonan	a s u n t o n a n
minuut	m i n u r e t
Bonaire	o n a i r
Internacional	t E r n a g a o n a l
Siman	i m a n
demas	d e m a s
exigencia	" i g 3 n C i w a
nace	n a k e
recientemente	r E C y e n t E m E n t e
sconde	s k o nd~ e
sostenibel	s o s t e d i b o
Actualmente	k t u a l m e n t e
Aworaki	w o r a k i
Salubridad	a l u b r i d a d
The	e
ademas	a d e m a s
comportacion	k o m p o r t a i o n
plataforma	p l a y i t a h m a
presion	p r e s i o n
analisa	a n a l i s a
asisti	a s i s t i
autoridadnan	a u t o r i d a d n a n
conocemento	r o n o k E m E n t o
consulta	r o n r e p e n t a
husticia	h u s t i i a
posible	p o s i b l e
presta	p r e s t a
retiro	r e t i r o
Comision	o m i s i o n
Curaçao	u r a a o
aporta	a p o r t e
comunica	k o m u n i k a
establecimento	e s t a b l e k i m e n t o
importa	i m p o r t e
iniciativa	i n i C y a t i v a
recomenda	r E c o m e n d a
retira	r e t i r a
Rutte	u t t e
fiscal	f i s k a l
hayando	h a y a n d o
het	h e t
suplica	s u p l i k a
Authority	u t h o r i t u s
inscribi	s k r i b i
Danki	a n k i
Sindicato	i n d i k a t o
Ya	a
acto	a k t o
admiti	a d m i t i
haber	h a b e r
patruyanan	p a t r u y a n a n
pe	p e
Mundial	u n d i a l
aeropuerto	a e r o p u e r t o
inversion	i n e r S i o n
maestro	m a a* 7
organiza	u r g a n i c a
toca	t o k a
En	n
categoria	k a t e g o r i a
conseha	r o n c e h a
departamentonan	d e p i t a m e n t o n a n
dunando	d u n a n d o
orden	u r d e n
petroleo	p e t r o l e o
ruman	r u m a n
señal	s e ny~ a l
socede	s o k e d e
Bureau	u r E a u
Oficina	f i k i n a
brote	b r o t e
casa	k a s a
ekipo	r p o
experto	" p e r t o
idioma	d i o m a
organizacion	u r g a n i r o i o n
pickup	p i S k u p
salida	s a l i d a
situacionnan	s i t u a i o* n a n
tremendo	t r e m e n d o
Sint	i n t
Virus	i r u s
adulto	a d u l t o
hotelnan	h o t e l n a n
realmente	r e a l m e n t e
rosea	r o s e a
satisfecho	s a t i s f C o
strategia	s t r a t e g i a
ticket	t i S k e t
trankilidad	tr~ a n k i l i d a d
Directiva	i r E C t i v a
President	r e s i d e n t
aire	a i r
apelacion	a p e l a i o n
apesar	a p e s a r
aprobacion	a p r o b a i o n
media	m e d i a
principalmente	p r i n k i p a l m e n t e
skirbi	s k i r b i E
Cora	o r a
alrededor	a l r e d e d o r
bringa	b r i Ng~ a
debidamente	d e b i d a m e n t e
habitante	h a b i t a n t e
impone	i m p o n e
intensivo	i n t e n k u b o
lugarnan	g a r n a n
maestronan	m a e s t r o n a n
structura	s t r u k t u r a
Desaroyo	e s e r o y o
competencia	k o m p e t e n C i w a
computer	k o m p u t e r
disciplina	d i S e p l i n a
haña	h a 5 a
menor	m E n o r
sectornan	s e k t o r n a n
violando	v i o r a n d o
Palm	a l m
Sin	i n
Universidad	n i v e r i d a d
asumi	a s u m i
ban	b a n
detecta	d e t e k t a
hacie	h a c i e
oficialmente	o f i h i a l m e n t e
reapertura	r e a p e r t u r a
surpasa	s u r p a s a
vigila	v i g i l a
Hotel	o t e l
concepto	r o n C i e p t o
destinacion	d e s t i n a g a o n
la	l a
otorga	k o t o r g a
trempan	t r 3 mp~ a n
Center	e n t e r
Personal	e r s o n a l
coalicion	k o a l i i o n
colega	k o l e g a
conexion	r o n " i o n
dollar	d o l l a r
laba	l a b a
lomba	l o m b a
sinembargo	s i n e m b a l i m a g o
teniendo	e n d o
urgi	u r g i
wowo	w o w o
Romero	e r o
biahe	b i a e
celebracion	k e l e b r a i o n
conduci	r o n d u k i
curso	k u r s o
descubri	d e s k u b r i
eherce	e h e r e
falso	f a l s o
finalisa	f i n a l i s a
Aunke	u n k e
Door	o r
cuestiona	kw~ e s t i o n a
dialogo	d i a l o g o
domina	b i n a
exigencianan	" i g 3 n C i w a n a n
felicita	f e l i k n e n
gubernamental	g u b E a n a m e n t a l
promove	p r o m o v e
risico	r i s i k o
scapa	s k a p a
curason	k u r a s o*
perhudica	p e r u d i k a
siendo	s i e n d o
sobrevivi	s o b b e b i v i
vigente	v i g 3 n t e
Nacionnan	a c i o n n a n
claridad	k l a r i d a d
consecuencianan	r o n e kw~ e n C i w a n a n
democratico	d e m o k r a t  o
par	p a r
trabaonan	tr~ a b a o n a n
weekend	w e n y
Locual	o k w a l
abordo	a b " a l d o
areglo	a r e L o
averahe	E b e r a e
deficit	d e f i k i t
deseo	d e s a i o
independiente	i n d e p e n d i e n t e
mey	m e
midi	m i d i
nombra	n o mb~ r a
resto	r e s t o
Health	e a l t
Rosa	o s a
Warda	a r d a
adverti	a d e r t i
bar	b a r
consciente	r o n S e e n t e
cortico	k o r t  o
emiti	e m i t i
incertidumbre	i n k  t i d u mb~ r e
october	o k t o b e r e
scondi	s k o n d i
solicita	s o l i k n e n
Airport	i r p o r
Scol	k o l
amor	a m o r
energia	e n e r g i a
gratis	g r a t i s
ocupacion	o k u p a k i o n
perdida	p e o n d a 7
proba	p l o b a
restaurant	r e s t a u r a nt~
sentido	s e n t i d o
America	m e r i k a
bula	b u l a
colaboracion	k o l 3 b u a o r a i o n
ganador	g a n a d o r
medionan	m e d i o n a n
residentenan	r e s i d e n t e n a n
truck	t o u k
cabez	k a b e z
laat	l a t
plachi	p l a y i C i
preferencia	p r e f e r e n C i w a
sorpresa	s o r p r e s a
Economico	r o n o m i  o
Leendert	e a n d a m i t e r
alivio	a l i v i o
ataca	a t a k a
experencia	" p e r e n C i w a
protesta	p r o t e s t a
tapa	t a p a
tecnologia	t e k n o l o g i a
update	u p d a t e
Advies	d v i e
Pos	o s
Respaldo	e s p a l d o
Union	n i o n
aviso	a v i s o
belasting	b e l a s t i N
construi	k o s t r u i
menaza	m E n a z a
seyo	s e y o
stima	s t i m a
storia	s t o r i a
victimanan	v i k t i m a n a
Van	a n
ami	a m i
brandweer	b r a n d o n d w e r e
comerciantenan	k o * r i a n t e n a n
dura	d u r a
estatal	e s t a t a l
hudicial	h u d i k i a l
mondi	m o n d i
motor	m o t o r
partidonan	p e r t i d o n a n
tempran	t 3 mp~ r i
vulnerabel	v u l n e r a b e l
Sevinger	p i r i N e r
Varios	a ry~ o s
beneficio	b e n e f i n i o
concreto	r o n C i r e t o
crecemento	k r E C E m E n t o
derechonan	d e r e C o n a n
dunador	d u n a d o r
libertad	b e r t a d
ola	o l a
Deporte	a p o r t e
casnan	k a s n a n
club	k l u b "
conforme	r o n h m e
custumber	k u s t u* b e r e
datonan	d a t o n a n
existente	" i s t e n t e
negocia	n e g o k i a
preto	p r e t o
registracion	r e g i s t r a i o n
Miyon	i y o n
Online	n l i n e
apenas	a p o n 3 s
confianza	r o n f i a n c a
detaye	d e t a y e
resumen	r e s u m e n
reunionnan	r e u n i o n n a n
screening	s k h r e n i N
venidero	f e n i d e r o
Guardacosta	u a r d a k o s t a
Thijsen	h i j e n
alerta	a l e r t e
colmo	k o l m o
coopera	k o o p e r a
dushi	d u S i
gusta	g u s t a
obliga	o b l a i g a
popular	p o p u l a r
reforma	r E h m a
specifico	s p e k   o
subida	s u b i d a
Aña	5 a
Papiamento	a p i a m e n t o
espera	e s p e r a
grave	g r a v e
identifica	d e n t i f i k a
metanan	m e t a n a n
obstante	o b s t a n t e
tapaboca	t a p a b o k a
Dakota	a k o t a
Hende	e n d e
amigonan	a m i g o n a n
april	a p r i l
huridico	h u r i 7 d i k o
instala	s t a l a
move	m o v e
ocupa	o k u p a
principio	p r i n k i p i o i
severo	s e b e r o
trayecto	tr~ a y o j t o
velocidad	v e l o v e l o i d a d
New	e w a
Paradera	a r a d e r a
bolter	b o l t e r
brug	b r u g
cancer	k a n C E r
controlnan	r o n t r o l n a n
cuestionario	kw~ e s t i o n a r i o
saludabel	s a l u d a b e l
virtual	v i r t u a l
Corsou	u r s o u
aspectonan	a 8 p e n e k t o n a n
autonan	a u t o n a n
dispuesto	d i s p u e s t o
dunado	d u n a d o
efectonan	e f e k t o n a n
generacion	g e n e r a i o n
hogar	h o g a r
instruccion	s t r u C a i o n
interno	i n t E r n o
motibonan	m o t i b o n a n
op	o p
priminti	p l i m i n t i
urgente	u r g 3 n t e
Dos	o s
Fraccion	r a k i o n
Glenbert	l E n k
Kock	T
actonan	a k t o n a n
critica	k r i t i k a
desconoci	d e s k o n o k i
diripiente	d i r i p i e n t e
organo	u r g a
relata	r e l a t a
revela	b e b e l a
Candelaria	a n d e l a r i a
Mescos	e s k o s
cancela	5 u k u n C i e l a
corto	k o r t o
crusada	k r u s a d a
encuanto	e n kw~ a n t o
enfasis	e n f a s i s
fayecimento	f a y o j i m e n t o
forza	f o r c a
genera	g e n e r a
haltura	h a l t u r a
transmision	i t r i s m i s i o n
transparencia	i t r i s p a d e i a
Comercio	o * i o
Directie	i r E C t i e
Señora	e 5 o r a
brommer	b r o m e r
contract	r o n tr~ a k s
esunnan	e s S
lamentablemente	l a m e n t a b l E m E n t e
serca	s e r k a
tarifa	t a r i f a
vakantie	v a k a n t i e
yudanza	y u d a n c a
Alto	l t o
Robert	o b e r
acusacion	a k u s a k i o n
avisa	a v i s a
back	b a k
bieu	b i e u
boluntario	b o l u n t a r i o
deber	d e b e r
discuti	d i s k u t i
esfuerzo	e s pw~ e r o
exactamente	" a k t a m e n t e
panico	p a n i k o
rekisitonan	r e k i s i t o n a n
reserva	r e s E r v a
CAft	f
airport	a i r p o r
contribucion	r o n b u k i o n
costo	k o s t o
cuatro	k u a t r o
existencia	" i s t i n C i w a
maltrato	m a l tr~ a t o
mundialmente	nd~ i a l m e n t e
pasaheronan	p a s a h e r o n a n
pensioen	p e ns~ i o e n
precaucion	p r E c a u k i o n
treci	t r E c i
Dominicana	i n i k a n a
Elmar	l m a r
Famia	a m i a
Labor	a b e r
Macuarima	a 7 kw~ a r i m a
claro	k l a r o
infecta	i n f k t a
ranca	r a n k a
representantenan	r e p r e s e n t a n t e n a n
seccion	s e k i o n
wanta	w a nt~ a
Casino	a s i n o
Entre	t r e
analisis	a n a l i s i s
aparato	a p a r a t o
basha	b a s a
clave	k l a v e
empresanan	3 mp~ r e s a n a n
facilita	f a c i l i t a
guera	g e r a
pabao	p a b a o
pagonan	p a g o n a n
proposicion	p r o p o s i i o n
articulonan	i t i k u l o n a n
demasiado	d e m a s i a d o
gremionan	g r e m i o n a n
historico	h i s t o i cy~ o
invitacion	i n v i t a i o n
partner	p e r t n e r
plannan	p a nz~ n a n
profundo	p r o f u n d o
ruta	r u t a
union	u n i o n
violencia	v i o l e n C i w a
Corda	u r d a
Entrante	t r a n t e
Rocco	o kh~  o
aplicacion	a p l i k a i o n
dado	d a d o
estricto	e k i cy~ t o
fiansa	f i a s a
manifesta	n i f e s t a
multa	l t a
practicamente	p r a k t i k a m e n t e
reparti	r e p i t i
sospechosonan	s o s p e C o s o n a n
General	e n e r a l
School	C o l
Vos	o s
Watty	a t
bastante	b a s t a n t e
comenta	k o m e nt~ a
creativo	k r e a t i b o
robes	r o b e sy~ s
tristo	t r i s t o
Republica	e p u b l i k a
completa	k o m p l e t a
crucero	k r u z i r u
electoral	e l e k t o r a l
honra	h o n r a
mediano	m e d i a
mondkapje	m o n d a  ph~ e
nacionalidad	n a g a o n a l i d a d
natural	n a t u r a l
penal	p e n a l
rapido	r a  d o
rapportnan	r a p p o r t n a n
recien	r E C y e n
Comisario	o m i s a r i o
Comunidad	n i d a d
Guarda	u a r d a
Meza	d a
Statuut	t a t u h
democracia	d e m o k r a c i a
evaluacion	p i r a l u a i o n
factor	f a k t o r
infeccion	i n f k i o n
infrastructura	i n f r a s t r u k t u r a
kiko	k i k o
logro	l o g r o
ocasiona	o k a s i o n a
portanan	p o r t a n a n
scenario	s k e n a r i o
veld	f e l
Donald	o n a l
Eagle	y l e
contrario	r o n t r a r i o
drastico	d r E s t  o
ministerio	m i n i S t E r i o
soluciona	s o b e l i o n a
supermercado	s u p e r m i l a y
Bubali	u b a l i
Pakico	a k i k o
Tanto	a n t o
afspraak	a f s p r a k
bien	b i e n
condolencia	r o n d o l e n C i w a
cuater	k u a t e r
entradanan	e n t r a d a n a n
tog	t o
Ayera	y e r a
Foundation	o u n d a t i o n 3
Sabana	a b a n a
apoyo	a p o y o
bisiña	b i s i 5 a
burachi	b u r a C i
decada	d e k a d a
destruccion	d e s t r u C a i o n
efectivo	e f e k t i b o
haye	h a y e
introduccion	i n t r o C u k i o n
niun	n i u n
trankil	tr~ a a q i l
Besaril	e s a r i l
Grandi	r a nd~ i
Tjin	h i
arte	i t e
desaster	d e s a s t e r e n
edicion	p i e d w C i w r o n
ehemplo	e h 3 mp~ l o
enfoke	e n f o k e
etapa	e t a p a
grado	g r a d o
hamas	h a m a s
helicopter	h e l i k o p t e r
mita	m i t a
opta	o p t a
realiza	r e a l i c a
simplemente	s i m p l E m E n t e
Juan	u a n
alabes	a l a b e sy~ s
bibando	b i b a n d o
buskeda	s k e d a
combersacion	k o mb~ e r sw~ i o n
dedicacion	d e d i k a i o n
diario	d i a r i o
discurso	d i s k u r s o
gasolin	g a s o l i n
intento	i n t e n t o
legalmente	l e 7 a l m e n t e
localidad	l o k a l i d a d
reitera	r e i t E r a
salubridad	s a l u b r i d a d
sano	s a n o
situa	s i t u a
speransa	s p e r i s a
Reina	e i n a
Richard	i C a r d
automaticamente	a u t o m a t i k a m e n t e
calamidad	k a l a m i d a d
cuestion	kw~ e s t i o n 3
deal	d e a l
enseñanza	e n s 5 a z a
fastioso	f a s t i o s o
modelo	m o d e l o
participante	p e r t i k i p a n t e
preparando	p r e p a r a n d o
procesa	p r o k 3 s a
publicacion	p u b l i k a i o n
refleha	r e f l e h a
Infrastructura	n f r a s t r u k t u r a
Setar	e t a r
cocaina	k o k a i n a
extende	e S e
hefe	h e f e
horcan	h o r k a n
opera	o p e r a
pilar	p i l a r
school	S o l
Subsidio	u b i d i o
Wardacosta	a r d a k o s t a
corona	k o r o n a
cumpliendo	k u m p l i e n d o
ilustra	i l u s t r a
internet	i n t E r n
los	l o s
perspectiva	p e r 8 p e n e k t i v a
surplus	s u r p l u s
Rey	u y
bashi	b a S i
comprension	k o m p r e ns~ i o n
constantemente	k o s t a n t E m E n t e
cultural	k u l t u r a l
facebook	f a k r o k
kendenan	k e n d e n a n
to	t o
transmiti	i t r i s m i t i
viahe	v i a e
Association	a d a m i a t i o n 3
International	t E r n a t i o n a l
Sneek	n e k
al	a l
aparentemente	a p a r e n t E m E n t e
comienzo	k o m i e n z o
container	r o n t a i n 3 q
cora	k o r a
honor	h o n o r
husto	h u s t o
levemente	l E Ng~ e r e p i N t e
segundo	s e g u n d o
seis	s e i s
turno	t u r n o
Alan	l a n
Boulevard	o l e b E r d
Caribbean	a r i b G e l n
Mientrastanto	i e n t r a s t a n t o
Recherche	e T h i l l a g
actitud	a k t i t u d
ahusta	a h u s t a
atendi	a t e n d i
calcula	k a l k u l a
carchi	k a g i C i
compromiso	k o m p r o m i s o
dak	d a k
destina	d e s t i n a
detenido	d e t e n i d o
finalmente	f i n a l m e n t e
gerencia	g e r e n C i w a
huy	h u y
mantencion	m a n t e n C i w o n
reclama	r E c l a m a
webinar	w o r i n a r
Ambulance	b u l a n k o e
Ningun	i N u n
Raymond	a i m a N
Resort	e s o r
fe	f e
importacion	i m p o r t a i o n
nissan	n i 7
pabien	p a b i e n
participantenan	p e r t i k i p a n t e n a n
perdi	p e r d i
remarke	r E m a r k e
Ainda	i n d a
Chauffeur	h a u f e u r
aprecia	a p r E c i a
bahando	b a h a n d o
critico	k r i t  o
hustamente	h u s t a m e n t e
innovacion	i n n o w a i o n
negociacion	n e g o k a i o n
obligacion	o b l a i g a i o n
observa	o b e r v a
oro	o r o
rabia	r a b i a
Apesar	p e S a r
Code	o d e
Codigo	o d i g o
Economia	r o n o m i a
Otmar	m a r
Plaza	l a z a
Sigur	i g u r
York	u r
balansa	b a l a s a
kiebro	k i e b r o
porfin	p o r f i n
recauda	r E c a u d a
weganan	w e g a n a n
Brazil	r a z i l
ImSan	m a n t a
Salario	a l a r i o
atene	a t e n e
femenino	f a m E n i n o
financiamento	f i n a n C i w a m e n t o
gabinete	g a b i n e t e
huma	h u m a
misa	m i s a
paña	p a 5 a
pida	a t e
preventivo	p b e b e n t i b o
regular	r e g u l a r
sistemanan	s i s t e m a n a
Marlon	a r l o n
Mundo	u n d o
bestia	b e s t a
comun	k o m u n
conclusion	r o n k l u z e o n
covid	k o v i d
debenan	d e b e n a n
igual	i g u a l
serie	s e r i e
straño	s t r a 5 u
wardando	w a r d a n d o
Chikito	h i k i t o
comunicado	k o m u n i C i
dus	d u s
empleo	3 mp~ l e o
establecimentonan	e s t a b l e k i m e n t o n a n
imagen	i m a g 3 n
lidernan	l i d E a n a n
merece	m e r e k e
pecho	p e T h o
pio	p i o i
prefera	p r e f e r a
preocupante	p r e o k u p a n t e
señor	s e 5 o r
specialista	s p e k i a l i s t a
Ambiente	b i e n t e
Lamentablemente	a m e n t a b l E m E n t e
advertencia	a d e r i a
conocido	r o n o k i d o
crimen	k l i m e n
divulga	d i v u l g a
educa	e d u k a
encuentro	e n kw~ e n t r o
especialmente	e s p E kh~ a m e* i a l m e n t e
garantia	g a r a n t i a
interesante	i n t e r e s a n t e
malesanan	m a l e s a n a n
panort	p a n o r
parada	p a r a d a
sorto	s o r t o
tarda	t a r d a
up	u p
Blanco	l a*  o
Boekhoudt	N o u d
Camacuri	k i t a
Chris	h r i s
Huez	u e z
Sero	e r o
avansa	a b a s a
biento	s o N t o
compra	k o m p r a
describi	d e s k r i b i
drechi	d r e C i
movecion	m o p e m u i o n
negociacionnan	n e g o k a i o* n a n
probecha	p l o b e C a
pusha	p u s a
sigi	s i g i
totalmente	t a t a l m e n t e
Alabes	l a b e sy~ s
Kelly	i L
Mucha	u C a
Vrolijk	r o l i j
awendia	a w e n d i a
conciente	r o n C y e n t e
consumidor	k o s u m i d o r
criminalidad	k l i m i n a l i d a d
desinfecta	d e s i n f k t a
ehecucion	e h e kw~ i o n
expande	" p a nd~ e
fuente	f u e n t e
hisa	h i s a
individual	i n d i v i d u a l
ladron	l a d r o n
laman	l a m a n
mehoracion	m e h o r a i o n
recherche	r e 5  C e
revisa	r E i s a
sanger	s a N g e r
sociedad	s o k i e d a d
Intensivo	t e n k u b o
Patrishi	a t r i S i
Sharline	h a l i n e
artista	i t i s t a
aun	a u n
bombero	b o mb~ e r o
estilo	e s t i l o
molester	o l e s t e r e n
normalmente	n o r m a l m e n t e
pan	p a n
pelea	p e l e a
stress	s t r e s
tarheta	t a r h e t a
yobida	y o b i d a
Ambos	b o s
Happy	a p py~
Parlamentarionan	a r l a m e n t a r i o n a n
acusacionnan	a k u s a i o* n a n
agenda	a g e n d a
dignatario	d i g i E 5 E t E d i t o o
draai	d r E a i
edificionan	  i o n a n
musical	s i k a l
normanan	n o r m a n a
oido	o i d o
pasenshi	p a s S i
procedente	p r o k e d e n t e
roadservice	r o a d s g a r 3 v i j e
College	o l l e g e
Estado	s t a d o
Finalmente	i n a l m e n t e
Geerman	e r m a n
afor	a f o r
anuncio	n u i o
baranca	b a r a C a
cartera	k i t E r a
drs	d r
duradero	d u r a d e r o
hyundai	h y u n d a i
informantenan	i n h t e n a n
keri	k e r i
materia	m a t e r i a
origen	u r i g 3 n
regula	r e g u l a
Algo	l g o
Defensa	e f e s a
Esakinan	y u ly~ o
Hasta	a s t a
Homber	d o mb~ e r
Mark	a r
Mayoria	a y o r i a
Relaciona	e l a c i o n a
bijstand	b i j s t a nd~
biyon	b i y o n
conecta	r o n e k t a
defensa	d e f e s a
dune	d u n e
humanitario	h u m a n i t a r i o
kima	k i m a
maltrata	m a l tr~ a t a
ministernan	m i n i S t E r n a n
peligro	p e l i g r o
titulo	t i t u l o
transparente	i t r i s p a r e n t e
Airlines	i r l i n i
Arikok	r i k o k
Asunto	s u n t o
Rijkswet	g i y k s w e t
Secretario	e T r e t a r i o
Semper	3 mp~ e r
Servicio	e r i i o
agente	a g 3 n t e
berde	b E r d e
condicional	r o n d i k i o n a l
institui	s t i t u i
mustrando	s t r a n d o
reactiva	r e a k t i v a
reconoci	r E c o* t i
regalo	r e g a l o
scohe	s k o h e
tanten	t a n t e n
viaha	v i a h a
violacion	v i o l a  i o n
vocero	v o S a sk~ a
zona	z o n a
Brandweer	r a n d o n d w e r e
Camara	a m a r a
Group	r o u p
Medio	e d i o
Sociaal	T a l
adicto	a d i k t o
aparece	a p a r e k e
apartamento	a p i t a m e n t o
ceremonia	C E r E m o n t a 5 i a
cupo	k u p o
epoca	a p o k a
finaliza	f i n a l i c a
garantiza	g a r a n t i c a
vivienda	v i v i e n d a
App	p p
Awo	w o
Jamaica	a m a i k a
celular	C E l u l a r
contact	r o n t a
criminal	k l i m i n a l
cuminsando	k u m i s a n d o
dicho	d i T o
doñonan	d o 5 o n a n
formal	f o r m a l
hand	h a n d
herencia	h e r e n C i w a
normalidad	n o r m a l i d a d
oportunidadnan	L o k t u n i d a d n a n
oposicion	o p o s i i o n
papiando	p a p i a n d o
place	p l a y i j e
show	S o
stranhero	s t r a h e r o
tankinan	t a n u ly~ o
tareanan	t a r e a n a n
totalidad	t a t a l i d a d
usando	u s a n d o
Cuanto	u a nt~ o
Island	s l a n d
Kamer	a m e r
Maria	a r i a
activa	a k t i v a
alma	l 3 m
ciudad	i u d a d
codigo	k o d i g o
continuamente	r o n t i n u a m e n t e
cuerpo	kw~ e r p o
decreto	d e 7 r e t o
destino	d e s t i n o
feliz	f e l i z
lesnan	l e s n a n
liher	l i h e r
lora	l o r a
mascota	s k o t a
pabou	p a b o u
particular	p e r t i k u l a r
procesonan	p r o k e s o n a n
rueda	r u e d a
Dowers	o w e r
Eddy	d dy~
Grupo	n i n o
aerolinea	a e r o l i n e a
asiento	a s i e n t o
ciere	C y e r e
circula	l r u l a
civil	i v i l
claramente	k l a r a m e n t e
convenci	r o n e nC~ i
establece	e s t a b l e k e
inmediatamente	i n d dy~ a t a m e n t e
limite	l i m i t e
mañan	m a 5 a n
padilanti	p a d i l a n t i
partinan	p e r t i n a n
primario	p l i m a r i o
propone	p r o p o n e
resumi	r e s u m i
santo	s a n t o
stakeholders	s t a k e h o l d e r
temanan	t e m a n a
unicamente	u n i C i C e n t e
vehiculonan	e i k u l o n a n
Muchanan	u C a n a n
Piedra	i e d r a
Ponton	o n t o n
alegria	a l e 7 r i a
cancion	5 u k u n C i w o n
carnaval	k a g i n a b a l
dificultad	d i f i k u l t a d
enfatiza	e n f a t a c a
facilidad	f a c i l i d a d
faya	f a y a
inscripcion	s k r i p i o n
paz	p a z
peticionnan	p e t i i o* n a n
porcentahe	p o r e n t a e
probablemente	p l o b a b l E m E n t e
progreso	p r o g r e s o
saco	s a k o
secreto	s e k r e t o
solucionnan	s o b e l i o n n a n
tranche	tr~ a n C e
transcurso	i t r i s k u r s o
Boneiro	n e r o
Dienst	s d a
Haag	a g
RdA	d
capta	k a p t a
causando	k a u s a n d o
corte	k o r t e
expresion	" p r e s i o n
fia	f i a
grita	g r i t a
kisas	k i s a s
maske	s k e
pafor	p a h
parlamentarionan	p a l a m e n t a r i o n a n
prolonga	p r o l o n g a
similar	s i m i l a r
stuur	s t u r
testigo	t e s t i g o
Bar	a r
Enseñanza	s y u* k a* a n c a
Lacle	a k l e
Latino	a t i n o
Paso	a s o
Rijbewijs	g i y b e w i j
apoya	a p o y a
carera	k a r e r a
constitucion	k o s t i t u k i o n
cruzada	k r u w Z a d a
insisti	s i s t i
kilo	k i l o
lockdown	l o k k d o w n
oficialnan	o f i h i a l
organisacionnan	u r g a n i s a i o* n a n
plachinan	p l a y i C i n a n
post	p o s
prohibicion	p r o h i b i i o n
proyecta	p r o y o j t a
record	r E c o r d
strategico	s t r a t e g i k o
tas	t o s
tienda	t i e n d a
waf	w a f
Arubahuis	r u b a w i s
Dollar	o l l a r
Florida	l o r i d a
Ombudsman	m b u j m a n
ambulante	a m b u l a t e
app	a p p
atendiendo	a t e n d i e n d o
awanan	a w a n a n
baby	b a b a
combina	k o mb~ i n a
culpa	k u l p a
curashi	k u r a S i
es	m 3 s
funda	f u n d a
goberna	g o b E a n a
implementacion	i m p l E m E n t a  i o n
indice	i n d i k e
motiva	m o t i v a
oferta	o f e r t e
seno	s e n o
solido	s o l i d o
tiro	t i r o
Plat	l a t
aplaudi	a p l a y i u d i
beslag	b e s l o g
biniendo	b i n i e n d o
canta	k a nt~ a
colecta	k o l e k t a
consehonan	r o n c e h o n a n
daña	d a 5 a
debido	d e b i d o
defini	d e f i n i
desastre	d e s a s t r e
diabetes	d i a b e t e
disculpa	d i s k u l p a
emocional	e m o k i o n a l
escala	e s k a l a
esfuersonan	e s pw~ e r s o n a n
hamber	h a m b e r e
loonsubsidie	l o s u b i d i e
meld	m e l
muestra	m u e s t r a
norma	n o r m a
on	o n
pelicula	p e l i k u l a
personalmente	p e r s o n a l m e n t e
promedio	p  o
sospecha	s o s p e C a
tropical	t r o p i k a l
zorg	z o r
Canada	a n a d a
Eynan	y n a n
Horacio	o r a i o
Rudy	u d
Staten	t a t e n
compras	k o m p a s
consumo	k o s u m o
contribuyente	r o n b u y e n t e
dunadornan	d u n a d o r n a n
eleccionnan	e l e k i o* n a n
estadia	e s t a d i a
facilidadnan	f a c i l i d a d n a n
formacion	f o r m a c i o n
kwartaal	kw~ i t a l
linea	l i n e a
nocturno	n o k s u r n o
pospone	p o s p o n e
renoba	r e n o b a
salba	s a l b a
saliendo	s a l i e n d o
sanitizer	s a n i t i 8 e
tercer	t E r 5 i r a t
Arthur	r t u r
Hoben	o b e n
Iran	r a
Museo	u s a i o
Ponson	o s o n
bancario	b a n k a r i o
bomberonan	b o mb~ e r o n a n
cadena	k a d e n a
crucial	k r u C a i a l
custumbra	k u s t u mb~ r a
diariamente	d i a r i a m e n t e
enberdad	e n k d a d
exposicion	" p o s i i o n
eyden	b d e n
formula	f o r m u l a
gobernantenan	g o b E a n a n t e n a n
graba	g r a b a
horario	h o r a r i o
inversionista	i n e r S i o n i S th~ a
investigacionnan	i n v e s t i g a i o* n a n
march	m a* r
maritimo	m a r i t i m o
monitor	m o n i t o r
muraya	m u r a y a
planificacion	p l a y i  k a i o n
propiedad	p r o p i e d a d
scur	s k u r
sentimento	s e n t i m e n t o
sesion	s e s i o n
soño	s o 5 u
tecnico	t e k n i k o
tendencia	t e n d e n C i w a
Biyon	i y o n
Docter	o k t e r
Hecho	e T h o
Park	a r
Parkietenbos	a r k i e t e n b o s
Ronella	o i L a
Sector	e k t o r
Sinterklaas	i n t E a X l a
Transporte	r a s p o r t e
World	u r l
bancarota	b a n k a r o t a
confia	r o n f i a
data	d a t a
encurasha	e n k u r a s a
informativo	i n f o r m a t i b o
inicial	i n i C y a l
manifestacion	n i f e s t a k i o n
masculino	s k u l i n o
mitiga	m i t i g a
naturalmente	n a t u r a l m e n t e
staciona	s t a k i o n a
temporalmente	t e m p o r a l m e n t e
unidadnan	u n i d a d n a n
Arubus	r u b u s
Biblioteca	i b l i o t e k a
Finanzas	i n a n c~ 3 s
Inglatera	N l a t e r a
Kiermen	i e s a y m 3 n
Miami	i a m i
Ni	i
Promer	r o m e r
adelanta	a d e l a nt~ a
apunta	a p u n t a
atake	a t a k e
caro	k a r o
cende	k e n d e
combersa	k o mb~ e r s a
conscientisacion	r o n S e e n t i s a k i o n
contracto	r o n tr~ a k t o
culpable	k u l p a b l e
equipo	e k i p o
eventonan	e b e n t o n a n
fayecido	f a y o j i d o
grandemente	g r a n d E m E n t e
gremio	g r e m i o
impresion	i m p r e s i o n
incluso	i n k l u s o
inversionistanan	i n e r S i o n i s t a n a n
ladronnan	l a n a n
lagando	l a g a n d o
miles	l e
pazuid	p a a f o i
promesa	p r o m 3 s a
radio	r a d i o
recomendacion	r E c o m e n d a i o n
talento	t a l e n t o
varia	v a r i a
vecindario	s k a* b i n d a r a o
voluntario	v o l u n t a r i o
Cacique	a c i k E
Caribense	a r i b e s e
Chines	h i n e
Madiki	a d i k i
One	n e
Prensa	r e s a
Uno	n o
accionnan	a k i o* n a n
alternativa	a l t E r n a t i v a
anticipa	a n t i k i p a
barconan	b a r k o n a n
bentana	b e n t a n a
bibo	b i b o
candidatonan	k a nd~ i d a t o n a n
constitucional	k o s t i t u k i o n a l
copia	k o p i a
cushina	k u s i n a
dr	d r
fuera	f u e r a
keha	k e h a
marihuana	m a r i w a n a
page	p a g e
piedra	p i e d r a
pinta	p i t a
pronostica	p r o n o s t i k a
reconocimento	r E c o n o k i m e n t o
renobacion	r e n o b a i o n
separa	s e p a r a
transferi	i t r i s f e r i
valioso	v a l i o s o
voor	v o r
Asociacion	s o k a i o n
Bombero	d o mb~ e r o
Democratico	e m o k r a t  o
Lago	a g o
Mansur	s u r
agradecido	a b o ch~ b i d o
awacero	a w a S a sk~ a
banconan	b a n k o n a n
cachonan	k a C o n a n
creatividad	k r e a t i v i d a d
cuchiu	k u C i w
fantasia	f a nt~ a s i a
financia	f i n a n C i w a
mascara	s k a r a
mente	m e n t e
moral	m o r a l
obra	o b r a
positivity	p o s i t i b i t
prijsnan	p r i j s n a n
prima	p l i m a
regimen	r e g i m e n
restaurantnan	r e s t a u r a nt~ n a n
sangura	s a N g u r a
shelter	S e l t e r
sikiera	s i k i r e r a
simpel	s i m p e l
sindical	s i n d i k a l
spaar	s p a r
specificamente	s p e k  k a m e n t e
sucedido	s u s e d i d o
television	t e l e i s i o n
Ami	m i
Guaidó	u a i d o
Ministernan	i n i S t E r n a n
Renaissance	e n a i s s a*  e
anda	a n d a
bari	b a r i
caracter	k a r a k t e r
complica	k o m p l i k a
corant	k o r a nt~
cronico	k r o n i k o
escoge	e s k o g e
ideanan	d e a n a n
indicando	i n d i k a n d o
instituto	s t i t u t o
lanza	l a n c a
piscadornan	p i s k i s  o r n a n
programanan	p r o g r a m a n a
raport	r a p o r
resalta	r e s a l t a s a
seriedad	s e r i e d a d
speranza	s p e r a n c a
temporal	t e m p o r a l
topiconan	t o p i k o n a n
Bushiri	u s i r i
Cosecha	o s E r C a
Festival	e s t i w a l
Figaroa	i N a r o a
Hooiberg	o i b a rx~
Italia	t a l i a
Kruis	r u i s
Kustwacht	u s t w o t
Lejuez	j u e z
Manager	a n a g a r
Medico	e d i k o
Nelson	e l o*
Nissan	i s s a n
Real	e a l
Rusia	u s i a
Sea	e a
Task	a s k
agentenan	a g 3 n t e n a n
anteriormente	a n t E r i o s a y m 3 n t e
autonomo	a u t o n o m o
barionan	b a r i o n a n
comentario	k o m e n t a r i o
educativo	e d u k a t i b o
fruta	f k a 7 a n
glas	g l a
gobiernonan	g o b i E a n o n a n
goza	g o y a 7
hereda	h e r e d a
hulandes	h u l a n d e
limitacion	l i m i t a i o n
localnan	l o k a l
mitar	m i t a r
persigui	p e r s i g u i
suministra	s u m i n i s t r a
Amsterdam	m s t E r d a m
Keda	e d a
Personanan	e r s o n a n a n
Reclassering	e k l a s e r i N
Restaurant	e s t a u r a nt~
Santo	a n t o
Tene	e n e
Tweede	w e n d e
adecua	a d e kw~ a
anja	a n j a
atrae	a t r a e
boter	b o t e r i s
botica	b o t i k a
cama	k a m a
contribuyentenan	r o n b u y e n t e n a n
dump	d u m p a
eficiente	e f i C y e n t e
financieramente	f i n a n C y e r a m e n t e
fundeshi	f u n d e s i
mask	s k
necesidadnan	d e* k a* b e s i d a d n a n
pare	p a r e
piloto	p i l o t o
problematica	p l o b l a e m a t i k a
recurso	r E C u r s o
representacion	r e p r e s e n t a  i o n
resolve	r e s o l v e
sacrificio	s a q  i o
secundario	s e k u n d a r a o
sugeri	s u g e r i
tini	t i n i
yabi	y a b i
Avenida	f e n i d a
Boneiru	n e r u
Diferente	f e r e n t e
Euro	u r o
Investigacion	n v e s t i g a i o n
Vanessa	a n 3 s a
acompaña	a k o mp~ a 5 a
acorda	a k o r d a
bez	b e z
bruto	b r u t o
capital	k a p i t a l
cauteloso	k a u t e l o s o
cometi	k o m e t i
continuo	r o n t i n u o
crusero	k r u s e r o
cumbre	k u mb~ r e
delibera	d e l i b e r a
diploma	d i p l o m a
drasticamente	d r E s t i k a m e n t e
exacto	" a k t o
hues	h u i e
link	l i n
musico	s i k o
otorgamento	k o t o r g a m e n t o
paketenan	p a k e t e n a n
pesar	p e S a r
petrolero	p e t r o l e r o
posiblemente	p o s i b l E m E n t e
redaccion	r e d a k i o n
reformanan	r e f o r m a n a
registro	r e g i s t r o
riesgonan	e s g o n a n
rij	r i
sincero	s i n S a sk~ a
solidaridad	s o l i d a r i d a d
sorprendi	s o r p r e n d i
tiramento	t i r a m e n t o
Lions	i o* s
Master	a s t e r e n
aglomera	a g l o m E r a
ancra	5 u k a r a
bus	b u s
casino	k a s i n o
cientifico	C y e n t i f i k o
destaho	d e s t a h o
estableci	e s t a b l E c i
factornan	f a k t o r n a n
gaña	g a 5 a
lus	l u s
mercadonan	m e r k a d o n a n
mortal	m o r t a l
naci	n a k i
plamamento	p l a y i mw~ a mw~ e n t o
potretnan	p o t r e t n a n
solidario	s o l i d a r i o
sorteo	s o r o
structural	s t r u k t u r a l
Akinan	ly~ o
Ambulans	b u l a
Frank	r a n
Pabien	a b i e n
Presupuesto	r e s u p u e s t o
Ultimo	l t i m o
accident	a k i b a 5 a
agresivo	y r e s i b o
bandera	b a n d e r a
bendi	b e n d i
beneficionan	b e n e f i n i o n a n
cash	k 3 s o
concentra	r o n C i e n t r a
contexto	r o n t " t o
desmenti	d e s m e n t i
domestico	b e s t  o
echo	e T h o
expone	" p o n e
fiha	f i h a
instrumento	s t r u m e n t o
likides	l i k i d e
pidiendo	p i d i e n d o
potencial	p o t e n C i w a l
schedule	S E d u l e
todo	t o d o s
Atraco	tr~ a k o
Boso	o s o
City	i t
Companianan	p a n i a n a n
Dellanire	e y a n i r
Food	o d
Force	u r k e
Hubenil	u b e n i l
Importante	p o r t a n t e
Primario	l i m a r i o
Vista	i s t a
bisto	b i s t o
caduca	k a d u k a
canto	k a nt~ o
comporta	k o m p o r t e
ehecutivo	e h e k u t i b o
enfrente	e n f r e n t e
fungi	f u N i
instante	s t a n t e
intermedia	i n t E r m e d i a
inversionnan	i n e r S i o n n a n
mannan	n n a n
oktober	o k t o b e r e
pagando	p a x a n d o
partnernan	p e r t n e r n a n
preocupacionnan	p r e o k u p a i o* n a n
rason	r a s o*
reanuda	r e a n u n d~ a
remedinan	r E m E w
temperatura	t e N p e r a t u r a
tradicional	i t r i w C i w r o n a l
vacacion	v a k a i o n
Guera	u e r a
Plenipotenciario	l E n i p o t e n C i w a r i o
Señor	e 5 o r
Solamente	o l a m e n t e
Tres	r e
acuerdonan	a 7 kw~ e r d o n a n
beneficia	b e n e f i n i a
berguensa	b e r g e s a
bicicleta	b i C i w C i l e t a
boga	b o N a
canal	k a n a l
clima	k l i m a
delito	d e l i t o
dialoga	d i a l o g a
disponible	d i s p o n i b l e
eligi	e l i g i
gobernante	g o b E a n a n t e
hustifica	h u s t i f i k a
inspira	s p i r a
labor	l a b e r
palabracion	p a l a b r a i o n
relacionnan	r e l a i o* n a n
sernan	s E r n a n
traspasa	t r a s p a s a
Finansa	i n a s a
Informacion	n h i o n
Kibrahacha	i b r a h a C a
Linda	i n d a
Of	f
Shelter	h e l t e r
Toyota	o y o t a
adaptacion	a d a p t a i o n
agricultura	y i cy~ u l t u r a
birando	b 3 r a n d o
borchi	b o r C i
calor	k a l o r
capaz	k a p a z
diseña	d i s y u* k a* a
forensico	f o r e ns~ i k o
ganashi	g a n a S i
golpi	g o l p i
imposibel	i m p o s i b e l
inmediato	i n d dy~ a t o
kedando	k e d a n d o
kehonan	k e h o n a n
labora	l a b o r a
leve	l e v e
likidez	l i k i d e z
liña	l i 5 a
mando	m a n d o
operacional	o p e r a c i o n a l
plasma	p l a s m a
portal	p o r t a l
pro	p r o
responsable	r e s p o i r a r u w l e
security	s e k u r i t u s
vocifera	v o k i f e r a
American	m e r i k a n
Berdad	e r d a d
Biden	d e n
Green	r e n
Lider	d e r
Marriott	a r o t t e
Patruya	a t r u y a
Renny	e 5
Rooi	o i
Vocero	o k
Voz	z
acumula	a 7 kw~ N u l g u r
ambtenaar	a m b t e n a r
biblioteca	b i b l i o t e k a
capitan	k a p i t a n
clase	k l a s e
confirmacion	r o n f i r m a c i o n
cualifica	k u a l i f i k a
debito	d e b i t o
despedi	d e 8 p e n e d i
dicta	d i k t a
directora	d i r E C t o r a
era	e r a
fortifica	f o r   k a
getest	g e t e s
is	i s
nanishi	n a n i S i
notificacion	n a   k a i o n
operacionnan	o p e r a i o* n a n
pertenece	p e r t e n e k e
ppt	p p
salvaguardia	s a l v a g u a r d i a
scan	s k a n
spanta	s p a n t a
takelwagen	t a k e l w a g 3 n
taxi	t a x i
tormenta	t o r m e nt~ a
vigilancia	v i g i l a n k o i a
Carnival	a r n i v a l
Cifranan	f r a n a n
CoronaVirus	o r o n a i r u s
Democrata	e m o k r a t a
John	o h E 5
Laga	a g a
Ling	i N
Toch	T h
Wit	i t
acelera	a C E l E r a
adecuado	a d e kw~ a d o
adelante	a d e l a n t e
aniversario	a n i v e r s a r i o
aplicabel	a p l i k a b e l
aserca	a s E r k a
aya	a y a
bebida	b e b i d a
bisiñanan	b i s i 5 a
certificado	C E r   a y
compila	k o m p i l a
desvia	d e s v i a
eleva	e l e v a
funcionamento	f u n C i w o n a m e n t o
generacionnan	g e n e r a i o* n a n
global	g l o b a l
inespera	i n e 8 p e n e r a
intercepta	i n t e r e p t a
internacionalmente	i n t E r n a g a o n a l m e n t e
localidadnan	l o k a l i d a d n a n
memey	m e m
monitorea	m o n i t o r e a
naturaleza	n a t u r a l E z E
obtenibel	o b b e l
ordena	u r d e n a
ponencia	p o n i n C i w a
rapidamente	r a  l o p i N t e
sla	s l a
stap	s t a p
supermarket	s u p e r m a r k e t
teni	t e n i
tension	t e s i o n
toyota	t o y o t a
Civil	i v i l
Clientenan	l i e n t e n a n
Helicopter	e l i k o p t e r
Hunta	u n t a
Mexico	e n  o
Misa	i s a
Organisacion	r g a n i s a k i o n
Ras	a s
asalto	a s a l t o
blauw	b l a u n a
cai	k a i
ehercicio	e h e r C i w C i w r o
keintura	k e i t u r a
liderazgo	l i d e r a z g o
ma	m a
militar	m i l i t a r
minimalisa	m i n i m a l i s a
papelnan	p a  l n a n
pober	p o b e r e
purbando	p u r b a n d o
recomendacionnan	r E c o m e n d a i o* n a n
siguiendo	s i g i e n d o
taxista	t a x i s t a
tayer	t o w u r
terminal	t E r m i n a l
vence	f e n C i e
Albertus	l k t u s
Estadistica	s t a d i s t i k a
Happiness	a p p i n e s
Informantenan	n h t e n a n
Ingles	N l e
Jan	a n
Mama	a m a
Proteccion	r o t e k i o n
Siglo	i L o
Supermarket	u p e r m a r k e t
Total	o t a l
Unda	n d a
Wardakosta	a r d a k o s t a
alivia	a l i v i a
amiga	a m i g a
bise	b i s e
cansa	k i s a
captura	k a p t u r a
carni	k a g i n i
cayente	k a y e n t e
chauffeurnan	C a u f e u r n a n
consehero	k o s e h e r o
der	d e r
dinamico	d i n a m i  o
encargo	e n k a r g o
escenario	e s k e n a r i o
famoso	f a m o s o
fenomeno	f e n o m E n o
fiho	f i h o
finanzas	f i n a n c~ 3 s
fout	f o u t
fresco	f r e s k o
futbol	f u t b o l
geel	g e
griep	g r i 3 p
hit	h i t
inspeccion	s p E kh~ a m e* i o n
luganan	g a n a n
matanan	m a t a n a n
musiconan	s i k o n a n
poniendo	p o n i e n d o
pronostico	p r o n o s t  o
proposito	p r o p o s i t o
reconstrui	r E c o s t r u i
regularmente	r e g u l a s a y m 3 n t e
sperando	s p e r a n d o
status	s t a t u s
suerte	s u e r t e
supera	s u p e r a
terminacion	t E r m i n a g a o n
tire	t i r
yora	y o r a
Balashi	p i S
Care	a r e
Flip	l i p
Ki	i
Maneho	a n e h o
Mayornan	a y o r n a n
Naturalmente	a t u r a l m e n t e
Obispo	b i s p o
Rasmijn	a s m i j n
Sindicatonan	i n d i k a t o n a n
Taxi	a x i
Willemstad	i l l e m s t a d
adultonan	a d u l t o n a n
airco	a i r k o
berdura	b E r d u r a
birada	b 3 r a d a
corectamente	k o r e k t a m e n t e
coy	k o y
dicon	d i k o n
entiero	e n t i e r o
exporta	" p o r t e
festival	f e S t i w a l
gas	x a s
gosa	g o s a
incidente	m a i d e n t e
jong	j o N
labamento	l a b a m e n t o
mericano	m e r i C i t a
nort	n o r
orguyo	u r g u y o
pleno	p l E n o
publicidad	p u b l i k i d a d
pulmon	p u l m o n
rementa	r E m E n t a
specialisa	s p e k i a l i s a
stricto	s t r i C t o
tratado	tr~ a t a d o
verifica	e r  k a
Dama	a m a
Douane	o o d u
Expertonan	S p e r t o n a n
Inspector	s p E kh~ a m e* t o r
Isla	s l a
Masha	a s a
Quota	u o t a
administrativo	a d m i n i s t r a t i b o
alavez	a l a v e z
aprecio	a p r E c i n o
atractivo	a t r a k t i b o
bala	b a l a
cercania	C E r k a n i a
cobransa	k o b r i s a
compromete	k o m p r o m e t e
contratista	r o n tr~ a t i s t a
duracion	d u r a i o n
empeora	3 mp~ e o r a
escrito	e s k r i t o
firme	f E i r m e
gradualmente	g r a d u a l m e n t e
identidad	d e n t i d a d
ministerial	m i n i S t E r i a l
mobilisa	m o b i l i s a
obtene	o b t e n e
operador	o p e r a d o r
patruyando	p a t r u y a n d o
posibilidadnan	p o s i b i l i d a d n a n
principionan	p r i n k i p i o n a n
promocion	p r o m o k i o n
regional	r e g i o n a l
relevante	r e l e v a n t e
repasa	r e p a s a
restriccion	r a i cy~ i o n
Barcadera	a r k a d e r a
Bestuurskantoor	e s t u r s k a n t o o r
Bomberonan	d o mb~ e r o n a n
Fondo	o n d o
Instituto	s t i t u t o
Jossy	o s
Marina	a r i n a
Obispado	b i s p a d o
Place	l a k e
Proyecto	r o y o j t o
Registro	g i s t r o
Smith	m i
Via	i a
Vicente	C " e l e n t e
average	E b e r a g e
barata	b a r a t a
concierto	r o n C y e r t o
conflicto	r o n f l i k t o
conosi	r o n o s i
contrato	r o n tr~ a t o
creacion	k r e a i o n
credito	k r e d i t o
culmina	k u l m i n a
curazon	k u r a z u n
fundamental	f u nd~ a m e n t a l
inconveniencia	i n k o n e 5 i a
interino	i n t E r i n o
limpiesa	l i m p i e s a
moneda	m o n e d a
publicamente	p u b l i k a m e n t e
puesto	p u e s t o
sumanan	s u m a n a
trayectoria	tr~ a y o j t o r i a
Ariba	b a
Bario	a ry~ o
Carlos	a r l o s
Casonan	a s o n a n
Claro	l a r o
Edgard	d a r d
Freewinds	h r e % d
Futuro	u t u r o
Gele	e l e
Industria	d u s t r e
Jacobs	a k o b
Kizas	i r o s
Meta	e t a
Rancho	5 u k u n C o
Wayaca	a y a k a
abase	a b a s e
accidenta	a k i d e nt~ a
animal	a n i m a l
asesinato	a s e s i n a t o
basicamente	b a s i k a m e n t e
botonan	b o t o n a n
creando	k r e a n d o
delicado	d e l i C i
deportivo	d e p o r t i b o
desconfiansa	d e s k o n f i a s a
docternan	d o k t E r n a n
estrecho	e s t r e T h o
fluho	f l u h o
garganta	g a r g a nt~ a
hipoteca	h i p o t e k a
hotelero	h o t e l e r o
kia	k i a
monumento	m o n u m e n t o
paramedico	p a r a m e d i k o
parkinglot	p i i N l o t
periodista	p e r i o d i s t a
posponi	p o s p o n i
proceduranan	p r o k e d u r a n a n
proyeccion	p r o y o j i o n
rescata	r e s k a t a
robez	r o b e z
shinishi	S i n i S i
sink	s i n
top	t o p
vergunning	v e r g u n n i N
vital	v i t a l
workshop	e* C o p
zuid	a f o i
Anto	nt~ o
Control	o t r o l
Daphne	a p n e
Drive	r i v E
Hefe	i f e
Himno	i m
Jurette	u r e t
Pau	a u
Paul	a u l
Pontilius	n t i l i u s
Spaña	p a 5 a
acentua	a k 3 n t u a
alarmante	a l a r m a n t e
animo	a n i m o
antemano	a n c i
artistanan	i t i s t a n a n
buraco	b u r a k o
cercano	C E r k a
colabora	k o l 3 b u a o r a
combinacion	k o mb~ i n a g a o n
considerando	k o s i d e r a n d o
consistiendo	k o ns~ i s t i 3 n d o
debate	d e b a t e
deposita	d e p o s i t a
druk	d r u k
finansas	f i n a sh~ 3 s
herment	h e r m E n t
hombernan	h o b E a n a n
jega	h e g a
memoria	m e m o r i a
mentira	m e n t i r a
museo	s a i o
ocho	T h o
oficinanan	o f i k i n a n a n
paralisa	p a r a l i s a
parke	p e r k e
pension	p e ns~ i o n
prescribi	p r e s k r i b i
profesion	p r o f i S i o n
projecto	p t o n o x e k t o
pruebanan	p r u e b a n a n
rechasa	r e C a s a
reina	r e i n a
resorta	r e s o r t e
stabilidad	s t a b i l i d a d
temblor	t e mb~ l o r
Alex	l E 7
Boluntario	o l u n t a r i o
Bon	o n
Corridor	u r i d o r
Decreto	e T r e t o
Fuera	u e r a
Groningen	r o n i N 3 n
Helder	e l d e r
Informacionnan	n h i o* n a n
Mega	e g a
National	a t i o n a l
Puerto	u e r t o
adiccion	a d i k i o n
aereo	a e r a o
atracadornan	a t r a k a d o r n a n
aumentando	a u m e n t a n d o
centronan	C E n t r o n a n
cero	C E r u
ciclista	C i w C i l i s t a
clubnan	k l u b n a n
contagionan	r o n t a h i r i o n a n
coregi	k o r e g i
cuentanan	kw~ e n t a n a n
detayenan	d e t a y e n a n
diseño	d i s y u* k a* o
disparce	d i s p a r k e
distrito	d i u z i t o
een	e n
frontal	f r o n t a l
instalacion	s t a l a i o n
matutino	m a t u t i n o
mediante	m e d i a t e
mensahenan	m e sh~ 3 a n a n
mensual	m E n s u a l
mln	l
nesesario	n e s e s a r i o
palabracionnan	p a l a b r a i o* n a n
pedofil	p E d o f i l
pic	p i k
preparacionnan	p r e p a r a i o* n a n
ramo	r a m o
relativamente	r e l a t i v a m e n t e
sanitario	s a n i t a r i o
sexo	s e g o
strea	s t r e a
terenonan	t e r e n o n a n
trese	t r e s e
trucknan	t o u k k n a n
votacion	v o t a i o n
yudando	y u d a n d o
Ady	d
Air	i r
Beatrix	e a t r i S
Bida	i d a
Bucuti	u k u t i
Cuminda	m i n d a
Danies	a n i e
Digicel	i g i k
Distanciamento	i s t a n C i w a m e n t o
Entertainment	t E r t a i N m E n t
Francisco	r a n C i s k i s  o
Hesus	e s u s
Musica	u s i k a
Nobo	o b o
Tampoco	a m p o k o
Teritorial	r i t o r i a l
Trahadornan	r a h a d o r n a n
Village	i l l a g e
Waf	a f
Whatsapp	h a c a p p
actualisacion	a k t u a l i s a k i o n
art	a r
bahada	b a h a d a
baki	b a k i
beachnan	b a C n a n
brasa	b r a s a
buelo	b u e l o
cabesante	k a b e s a n t e
cobertura	k o b e r t u r a
conserva	r o n e r v a
descarta	d e s k i t a
determinacion	d e t e r m i n a g a o n
diaranzon	d i a r a n z o n
enfrentando	e n f r e n t a n d o
estadonan	e s t a d o n a n
extenso	e S s o
fuentenan	f u e n t e n a n
innovativo	i n n o w a t i b o
institutonan	s t i t u t o n a n
investigashon	i n v e s t i g a s o n
mashin	S i n
negosacion	n e g o s a k i o n
oracion	o r a i o n
organonan	u r g a n o n a n
piscado	p i s k i s
pushi	p u s i
respiratorio	r e s p i r a t o r i o
sospecho	s o s p e T h o
supuesto	s u p u e s t o
tanda	t a n d a
tradicion	i t r i w C i w r o n
traficacion	tr~ a f i k a i o n
yaris	y a r i s
Accidente	kh~  i d e n t e
Bandera	a n d e r a
Botica	o t i k a
Casi	a s i
Emergencia	m e r g e n C i w a
Henriquez	e n r i k a
Ken	e n
March	a r
Ministerial	i n i S t E r i a l
Post	o s
Reclasering	e k l a s e r i N
Rica	i k a
Romano	a m i a s a
Saba	a b a
Sostenibel	o s t e d i b o
Tabatin	a b a t i n
atravez	a t r a v e z
bendemento	b e n d E m E n t o
boletin	b o l e t i n
cumplimento	k u m p l i m e n t o
depresion	d e p r e s i o n
desastroso	d e s a s t r o s o
disponibilidad	d i s p o n i b i l i d a d
experticio	" p e r w C i w r o
fianza	f i a n c a
formanan	f o r m a n a
fundacionnan	f u nd~ a i o* n a n
gratitud	g r a t i t u d
habilidad	h a b i l i d a d
honda	h o n d a
ideal	d e a l
instrui	s t r u i
intercambio	i n t E r k a m b i o
intimo	i n t i m o
jama	y a m a
mercadeo	m e r k a d e o
mitad	m i t a d
motociclista	t o  C i w C i l i s t a
nacemento	n a C E m E n t o
obvio	o b i o
pier	p i e r
placer	p l a y i 5 i r a t
provee	p r o p e m u e
resta	r e s t a
rico	r i k o
salarionan	s a l a r i o n a n
saldo	s a l d o
sosega	s o s e N a
suavisa	t a i s a
suela	s u e l a
tolera	t o l e r a
train	tr~ a i n
tranca	tr~ a C a
transaccion	i t r i s a k i o n
trato	tr~ a t o
vulnerable	v u l n e r a b l e
yerba	y e r b a
zink	5
Academy	k a d e m
Hyundai	y u n d a i
Net	e t
Nunca	u n k a
Organization	r g a n i z a t i o n 3
Parce	a r k e
administracion	a d m i n i s t r a i o n
agencia	y i n C i w a
asociacion	a s o* k a i o n
avanza	m a v a n c a
balornan	b a l o r n a n
bebi	b e b i
berdadero	b E r d a d e r o
competi	k o m p e t i
cunukero	k u n u k e r o
cuponan	k u p o n a n
deliberacion	d e l i b e r a i o n
detenidonan	d e t e n i d o n a n
districto	d i s t r i C t o
download	d o w n l o a d
enemigo	i n i m i g o
especial	e s p E kh~ a m e* i a l
habon	h a b o n
hogarnan	h o g a r n a n
incorecto	i n k o r e k t o
ingreso	i N X i e s o
inhusto	L u s t o
magnitud	m a h n i t u d
materialnan	m a t e r i a l
matrimonio	m a t r i m o* i o
original	u r i g i n a l
paspoort	p a s p o r
poderoso	p o d e r o s o
precedente	p r E C E d e n t e
provoca	p r o v o k a
realistico	r e a l i s t  o
satisfaccion	s a t i s f a k i o n
screen	s k r e n
sucu	s u k u
videonan	v i d e o n a n
Blok	l o k
Blvd	l i N d
Business	u s i n e s
Gran	r a
Hato	a t o
Shaba	h a b a
Sigui	i k i h
Triple	r i p l e
alimentacion	a l i m e n t a  i o n
atraves	a t r a v e
boluntarionan	b o l u n t a r i o n a n
castigonan	k a s t i g o n a n
cellular	C E L u l a r
chevrolet	C e b r o l e t
compleho	k o m p l e h o
conference	r o n f m i n C i e
documentacion	d o k u m e n t a  i o n
dokternan	d o k t E r n a n
ekipa	e k i p a
electronicamente	e l e k t r o n i k a m e n t e
estudionan	e s t u d i o n a n
evaluando	p i r a l u a n d o
flexibilisa	f l " i b i l i s a
funcionario	f u n C i w o n a r i o
intercambia	i n t E r k a m b i a
localmente	l o k a l m e n t e
machine	m a C i n e
manager	m a n a g a r
manipula	n i p u l a
mentalidad	m e n t a l i d a d
necesariamente	d e* k a* b e s a r i a m e n t e
notario	n o t t a r i o
numbernan	n u mb~ v e l a n a n
plantacion	p l a y i nt~ a i o n
propaganda	p r o p a g a n d a
red	r e d
regreso	r e g r e s o
rescate	r e s k a t e
run	r u n
transferencia	i t r i s f m i n C i w a
voz	v o
Aduana	d u a n a
Garage	a r a g e
Humano	u m a n o
Mary	a r
Paisnan	a i s n a n
Refineria	e f i n e r i a
Ruiz	k i z
Service	e r v i k e
Taekwondo	a a k w o n d o
Trinidad	r i n i d a d
Tropical	r o p i k a l
University	n i v e r s i t
Washington	a S i N r t o n
academico	a c a d 7 e m i  o
ameno	a m e n o
animalnan	a n i m a l
aventura	E b e n t u r a
baila	b a i l a
bordo	b o r d o
coleccion	k o l e k i o n
cunukeronan	k u n u k e r o n a n
dentista	d e n t i s t a
diversificacion	d i e r   k a i o n
encamina	e n k a m 3 n a
fatal	f a t a l
fauna	f a u n a
gemeente	g e m e n t e
grabacion	g r a b a i o n
hubenil	h u b e n i l
instruccionnan	s t r u C a i o* n a n
kiermeen	k i e r m e n
mientrastanto	m i e n t r a s t a n t o
optimal	a t i m a l
parcialmente	p i r i a l m e n t e
pensionadonan	p e ns~ i o n a d o n a n
peor	p e o r
plastic	p l a y i s t
psicologo	p s i k o l o g o
recesion	r E c o n
restaura	r e s t a u r a
retraso	r E t r a s o
seriamente	s e r e a m e n t e
shock	S o k
significante	s i g  k a n t e
smartphone	s m i t f o n e
sufriendo	s u f r i e n d o
telefoon	t e l e f o n
uniform	u n i h m
uzando	u z a n d o
Aparentemente	p a r e n t E m E n t e
Auto	u t o
Autoridad	u t o r i d a d
Derecho	e r e T h o
Fase	a s e
Halto	a l t o
Hendenan	E d i n a n
Joe	o e
Michael	i C a
Onderwijs	d i n w i j
Peru	e r u
Rico	i S
Roadservice	o a d s g a r 3 v i j e
Roberto	o b e r t o
Shady	h a t a
Taskforce	a s k h r e
Teniendo	e n d o
apropia	a p r o p i a
azeta	a z e t a
boluntad	b o l u n t a d
brindando	b r i d a n d o
buska	s k a
camera	k a m E r a
cannabis	k a* n a b i s
cargamento	k a r g a m e n t o
circumstancianan	l r u m s t a n C i w a n a n
communidad	k o m u n i d a d
conocimento	r o n o k i m e n t o
conscientisa	r o n S e e n t i s a
contagioso	r o n t a h i r i o s o
continuacion	r o n t i n u a i o n
convence	r o n e nC~ e
creciente	k r E C y e n t e
desempleo	d e s 3 mp~ l e o
desicion	d e s i i o n
dignidad	d i g i E 5 i d a d
discriminacion	d i s k l i m i n a g a o n
doloroso	d o l o r o s o
drentando	d r e n t a n d o
expansion	" k ns~ i o n
ganadornan	g a n a d o r n a n
graduado	g r a d u a d o
impacta	i m p a k t a
indocumenta	i d o k u m e nt~ a
inspiracion	s p i r a i o n
integral	i n t e g r a l
live	l i v E
lock	l o k
miyones	m i o n i
mutuo	m u t u o
nabega	n a b e g a
pata	p a t a
permanente	p e r m a n e n t e
piscadonan	p i s k i s  o n a n
president	p r e s i d e n t
primordial	p l i m o r dy~ a l
rebaho	r e b a h o
reconocemento	r E c o n o k E m E n t o
rekisito	r e k i s i t o
sorprende	s o r p r e n d e
stock	s t o k
stoel	s t o
stof	s t o f
suministro	s u m i n i s t r o
teritorial	t e r i t o r i a l
trapa	tr~ a p a
trimester	l i m e s t e r e n
vez	p e m u
wela	w e l a
Activo	k t i b o
Atrobe	t r o b e
Consecuentemente	o* s e kw~ e n t E m E n t e
Fort	u r
Huis	k i s
Integridad	t e g r i d a d
Jose	o s e
Kia	i a
Linear	i n e a r
Matutino	a t u t i n o
Miss	i s
Ricardo	i k a r d o
accesibel	a k k b e l
admira	a d m i r a
aerolineanan	a e r o l i n e a n a n
angustia	a n g u s t a
bela	b e l a
combersacionnan	k o mb~ e r sw~ i o* n a n
comosifuera	k o m o s i pw~ e r a
confusion	r o n f u s i o n
conmemora	r o n m e m o r a
conteo	r o n t e o
costanan	k o s t a n a n
deduci	d e d u k i
desaparece	d e s a p a r e k e
devastador	d e b E s t a d o r
electronico	e l e k t r o n i k o
enbes	e n b e sy~ s
encarcela	e n C i r e l a
entretenimento	e n t r e t e n i m e n t o
facilmente	f a c i l m e n t e
fix	f i S
honesto	h o n e s t o
hospitaliza	h o s p i t a l i n c a
increibel	m a r e i b e l
militarnan	m i l i t a r n a n
molestia	o l e s t a
monetario	m o n e t a r i o
muda	r u g a
obhetivo	o b h e t i b o
pool	p o l
presidencial	p r e s i d i n C i w a l
presupuesta	p r e s u p u e s t a
resiliente	r e s i l i e n t e
stabil	s t a b i l
supletorio	s u p l e t o r i o
tanki	t a n k i
taxistanan	t a x i s t a n a n
unit	u n i t
visibel	v i s i b e l
Abogado	b o g a d o
Antes	nt~ m 3 s
Baby	a b "
Baly	a l
Digital	i g i L a l
Divi	i v i
Josephine	o s e p h i n e
Kavel	E b e l
Liber	i b e r
Metal	e t a l
Metanan	e t a n a n
Papa	a p a
Seccion	e T i o n
Spaño	p a 5 u
Tara	a r a
Trigt	x
Unidad	n i d a d
Valdes	a l d e
Vice	i k e
Werleman	e r l 3 m a n
Zodiac	o d i a k
aclarea	a k l a r e a
adkiri	a d 7 i r i
aviacion	a g o y a i o n
añadi	a 5 a d i
bos	b o s
calculacion	k a l k u l a k a i o n
cendi	k e n d i
cobranza	k o b r a n c a
constelacion	k o s t e l a i o n
cuero	kw~ e r o
deposito	d e p o s i t o
desordo	d e s o r d o
economicamente	e k o n o m i C i C e n t e
epidemia	a p i d e m i a
esei	e s e i
esencia	e s i n C i w a
eyfo	b f o
fiestanan	f i e s t a n a n
ful	f u l
gesto	g e s t o
hancra	h a n C i r a
holo	h o l o
hubentud	h u b 3 n t u d
interogacion	i n t E r o g a i o n
kg	k
luznan	% i s n a n
mercancia	m e r 5 u k u n C i w a
metodo	m e t o t o
motorisa	m u t u r i s a
negligencia	n e g l i g 3 n C i w a
peaton	p e a t o n
percela	p e r e l a
playa	p l a y i l a
prestamonan	p r e s t a m o n a n
primordialmente	p l i m o r dy~ a l m e n t e
proponi	p r o p o n i
propuesta	p r o p u e s t a
recursonan	r E C u r s o n a n
reemplasa	r E 3 mp~ l a s a
repatriacion	r e p a t r i a i o n
respectivamente	r e s p E kh~ a m e* t e  e n t e
seco	s e k o
significa	s i g  k a
silencio	s i l 3 n C i w o
skerpi	s k e r p i
slachtofferhulp	s l o t  f a i b p
splika	s p l i k a
superior	s u p e r i o r
supervisa	s u p e r i s a
trauma	tr~ a u m a
urna	u r n a
visual	v i s u a l
vooral	v o r a l
Asamblea	s a m b l e a
Cumana	u m a n a
Cura	u r a
Dirks	i r k
Entrada	t r a d a
Fiesta	e s t a
Francia	r a n C i w a
Fun	u n
Jenny	e 5
Kòrsou	a l E s o u
Mastercard	a s t E r k a r d
Ministronan	i n i s t r o n a n
Normalmente	o r m a l m e n t e
Olimpico	l i m p i k o
Panama	a n a m a
Parada	a r a d a
Republicano	e p u b l i k a
Scolnan	k o l n a n
Shark	h a r
Toezicht	o d i t
actuacion	a k t u a i o n
agradabel	a g r a d a b e l
asegurado	a s e g u r a d o
baca	b a k a
bom	b o m
camara	k a m a r a
canalnan	k a n a l
castigabel	k a s t i g a b e l
comprobante	k o m p l o b a nt~ e
conhunto	r o n u n t o
conservacion	r o n e r v a i o n
cortamento	k o r t a m e n t o
corupto	k o r b t o
costumber	k o s t u* b e r e
deadline	d e a d l i n e
detaya	d e t a y a
diversifica	d i e r   k a
excepcional	" u p i o n a l
exitosamente	" i t o s a m i n t e
explora	" p l o r a
extraordinario	" tr~ a o r d i n a r i o
extremo	e S a m o
eybanda	e y b a n d a
felicidad	f e l i k i d a d
gang	g a N
hibe	h i b e
humanidad	h u m a n i d a d
hunta	h u n t a
instrumentonan	s t r u m e n t o n a n
jetBlue	h e
kavel	k a b e l
lasonan	l a s o n a n
logico	l o g i k o
mande	m a nd~ e
mentor	m e n t o r
ministro	m i n i s t r o
muhernan	m u h e r n a n
obhecion	o b u i o n
plaka	p l a k a
practico	p r a k t  o
pretende	p r e t e n d e
privacidad	p r i v a c i d a d
recuperando	r E C u p e r a n d o
rednan	r e d n a n
reflexiona	r e f l " i o n a
ricibiendo	r i i a n d o
rondona	d o nd ~ o n a
skina	s k i n a
sobrebibi	s o b r e  b i
specialistanan	s p e k i a l i s t a n a n
tino	t i n o
tour	t o u r
transforma	i t r i s h m a
traspaso	t r a s p a s o
traves	t r a v e
Alfonso	l f o s o
Antia	t i a
Articulo	r t i k u l o
Basa	a s a
Bernadina	E a n i w
Centraal	e n t r a l
Defensor	e f e Th~ o r
Edwin	d w i n
Mahuma	a h u m a
Media	e d i a
Miembronan	i e mb~ r o n a n
Plas	l a
Prins	r i n
Sali	a l i
Sons	o* s
Studiantenan	t u d i a t e n a n
Taxistanan	a x i s t a n a n
Test	e s t
alerto	a l e r t o
ansha	a n C a
argumento	a r g u m e n t o
automobilistanan	a u t o m o b i l i s t a n a n
autorisacion	a u t o r i s a k i o n
baho	b a h o
card	k a r d
cardinal	k a r d i n a l
cortesia	k o r t e s i a
cria	k r i a
cruel	k
desconfianza	d e s k o n f i a n c a
desperdicio	d e 8 p e n e r w C i w r o
disgusto	d i s g u s t o
fisicamente	f i s i k a m e n t e
grafico	g r a f i k o
hero	h e r o
incorpora	i n k o r p o r a
influenza	i n f m b u g z a
lamentabel	l a m e n t a b e l
libremente	b r E m E n t e
lidera	l i d e r a
mandato	m a nd~ a t o
menu	m E n u
pasashi	p a s a s i
pasion	p a s i o n
positivismo	p o s i t i i s m o
reemplaza	r E 3 mp~ l a z a
reglamento	r e g l a m e n t o
regulacion	r e g u l a k a i o n
representando	r e p r e s e n t a n d o
rumannan	r u m a n n a n
spaño	s p a 5 u
super	s u p e r
suspende	s u s p e n d e
suspendi	s u s p e n d i
task	t 3 s o k
teritorio	t e r i t o r i o
testigonan	t e s t i g o n a n
texto	t e S o
tips	t e p
trailer	tr~ a i l e r
tripulacion	t r e p u l a k a i o n
ubica	u b i k a
worry	w o r
Abo	b o
Abuso	s o
Alemania	l E m a n i a
Awendia	w e n d i a
Balentina	a l e n t i n a
Bay	a y
Bijstand	g i y s t a nd~
Dam	a m
Departamentonan	a p i t a m e n t o n a n
Educacion	d u k a i o n
Haci	a c i
Henk	e n
Inmediatamente	e g w i t a dy~ a t a m e n t e
Inspectie	s p E kh~ a m e* t i e
Luna	u n a
Miembro	i e mb~ r o
Organizacion	r g a n i r o i o n
Palabra	a l a b r a
Poco	o k o
Ruben	u b e n
Solutions	o l u t i o* s
Stef	t e f
Tchong	C o N
Teishi	e i S i
Velasquez	e l a s k a
Wilhelmina	i l h e l m i n a
alaves	a l a v e
amienda	a m i e n d a
aresta	a r e s t a
automobilista	a u t o m o b i l i s t a
autor	a u t o r
avance	m a v a n u k a e
baile	b a i l e
botter	b o t u t e r e n
cautela	k a u t e l a
charla	C a l a
choller	C o l l e r
code	k o t e
colga	k o l g a
comparacion	k o m a r a i o n
compaña	k o mp~ a 5 a
complicacion	k o m p l i k a i o n
declaracionnan	d e k l a r a i o* n a n
dividi	d i v i d i
drama	d r a m a
excelente	" s e l e n t e
frecuentemente	f r e kw~ e n t E m E n t e
fuertemente	f u e r t E m E n t e
holor	h o l o r
huramenta	h u r a m e nt~ a
infunda	i n f u n d a
investigando	i n v e s t i g a n d o
kilometer	k i l 3 e t e r
logronan	l o g r o n a n
luchando	% l u s a nd~ o
machete	m a C e t e
manipulacion	n i p u l a k a i o n
metodonan	m e t o d o n a n
optimista	a t i m i s t a
paki	p a k i
pas	p a s
practicanan	p r a k t i k a n a n
realisacion	r e a l i s a k i o n
renombra	r e n o mb~ r a
restauracion	r a a  i o n
sagrado	s a g r a d o
score	s k o r e
seminario	s e m i n a r i o
siglo	s i g l o
sostenibilidad	s o s t e n i b i l i d a d
standard	s t a n r d
sumo	s u m o
supuestamente	s u p u e s t a m e n t e
tan	t a n
unanimamente	u n a n i m a m e n t e
wiel	w i
Catiri	a t i r i
Diego	i e g o
Directora	i r E C t o r a
Erasmus	r a s m u s
Eva	v a
Financiero	i n a n C y e r o
Hernandez	E a n a n d e z
Horcan	u r k a n
Intensive	t e ns~ i v E
Los	o s
Nisbet	i s b e t
Sur	u r
Unabes	n a b e sy~ s
United	n i
Valero	a l e r o
Willem	i l l 3 m
adelanto	a d e l a n t o
aloca	a l o k a
artificial	a r   i a l
atletanan	a t l e t a n a n
bais	b a i s
boa	b o a
call	k a l o
caos	k a o s
circunstancia	l r i s t a n C i w a
circunstancianan	l r i s t a n C i w a n a n
ciudadnan	i u d a d n a n
confrontacion	r o n f r o n t a  i o n
consensus	r o n w o u s
datos	d a t o s
decadanan	d e k a d a n a n
del	d e l
delitonan	d e l i t o n a n
eficiencia	e f i C y e n C i w a
emocion	e m o k i o n
entusiasmo	e n t u s i a s m o
eror	e r o r
esfuerzonan	e s pw~ e r z o n a n
evidencia	p i r i d i n C i w a
exportacion	" p o r t a i o n
fayo	f a y o
focus	f o k u s
huicio	w i i o
incumplimento	m a e mp~ l i m e n t o
interactivo	i n t E r a k t i b o
interesado	i n t e r e s a d o
interesadonan	i n t e r e s a d o n a n
kwihi	kw~ i 7 i
manteniendo	n e n d o
pensando	p e s a n d o
per	p e r
prolongacion	p r o l o N a C i w o n
reclamo	r E c l a m o
redobla	r e d o b l a k
regala	r e g a l a
regarda	r e g a r d a
responde	r e s p o nd~ e
rifa	r i b u Ng~ a
scrap	s k r a p
seleccion	s e l e k i o n
sponsor	s p o Th~ o r
staf	s t a f
supermercadonan	s u p e r * r a d o n a n
transicion	i t r i s i i o n
vacunacion	v a k u n a g a o n
version	e r S i o n
Alexander	l E a n d e r
Anne	a n n e
Anthony	nt~ o n
Caminda	a m i n d a
Card	a r d
Cratz	r a c
Cual	u a l
Dirksz	i r k
Eustatius	u s t a t i u s
Evita	v i t a
Gobernacion	o b E a n a g a o n
Henter	e n t e r
Hubentud	u b 3 n t u d
Kudawecha	u d a w e C a
Local	o k a l
Man	a n
Masnoticia	a s n o t i i a
MetaCorp	e t a o r p
Otronan	t r o n a n
Pablo	a b l u
Pedagogico	e d a g o g i k o
Placa	l a k a l
Rotary	o t a r
Salazar	a l a z a r
Tempo	3 mp~ o
Tratado	r a t a d o
Venezolanonan	e n e z o r a n o n a n
actualisa	a k t u a l i s a
benidero	b e n i d e r o
bestianan	b e s t i a n a n
brainstorm	b r a s t o r m
bukinan	b u k i n a n
center	C E n t e r
circulacion	l r u l a k a i o n
comproba	k o m p l o b a
consenshi	k o s S i
costoso	k o s t o s o
cuminsamento	k u m i s a m i n t o
cursonan	k u r s o n a n
delivery	d e l i e r
dera	d e r a
desgracia	d e s b o ch~ i a
despedida	d e 8 p e n e d i d a
distribui	d i s t r e g u bw~ i
divisa	d i v i s a
drive	d r i v E
ehemplar	e h 3 mp~ l a r
embargo	e m b a l i m a g o
empresario	3 mp~ r e s a r i o
encuentronan	e n kw~ e n t r o n a n
flexibilisacion	f l " i b i l i s a k i o n
flora	f l o r a
fortalece	f o r t a l e k e
gravedad	g r a v e d a d
imagennan	i m a g 3 n
inaceptabel	i n a k e p t a b e l
indirecto	i n d i r E C t o
innecesario	i n d e* k a* b e s a r i o
inseguridad	s e g u r i d a d
involucra	i n v o b e l r a
join	j o i n
landa	l a n d a
meymey	m e y *
monton	m o* t o n
motivacion	m o t i v a i o n
negosha	n e g o s a
oxigeno	o* x e n o
pantaya	p a n t a y a
pareu	p a r e u
plazo	p l a y i r o
precario	p r E c a r i o
radar	r a d a r
razzia	r a z 5 a
resisti	r e s i s t i
resort	r e s o r
respecto	r e s p E kh~ a m e* t o
reta	r e t a
rio	r i o
rudia	r u d i a
semanal	s e m a n a l
subsidia	s u b i d i a
teoria	t e o r i a
tiendanan	t i e n d a n a n
tip	t i p a
tratando	tr~ a t a n d o
usuarionan	u s u a r i o n a n
Americano	m e r i C i t a
Belgica	e l g i k a
Cualkier	w E l d a k i e r
Desiree	r e
Fin	i n
Haiti	a y t i
Jennifer	3 n f e r
Kapel	a p e l
Kende	e n d e
Kleuterschool	l E u t E r S o l
Landsbesluit	a n d s b e s  i t
Landsrecherche	a n d s r e 5  C e
Lee	e
Management	a n a g E m E n t
Meijer	e i h e r
Ministerraad	i n i S t E r a
Rincon	i n k o n
Rond	o
Services	e r i u
Supervision	u p e r i s i o n
Suriname	u r i n a m e
Una	n a
Veer	e l
Volksgezondheid	o l k s g e z o n d  i d
Youth	o u c
anciano	5 u k a i a
apela	a p e l a
areglonan	a r e g l o n a n
bishitando	b i S i t a n d o
bleki	b l e k i
buelonan	b u e l o n a n
circulando	l r u l a n d o
circular	l r u l a r
colectivo	k o l e k t i b o
consecuentemente	r o n e kw~ e n t E m E n t e
containernan	r o n t 3 E a n a n
controlando	r o n t r o r a n d o
coordina	k o r d i n a
dengue	d e N g w e
desconocidonan	d e s k o n o k i d o n a n
descuento	d e s k u e n t o
destinacionnan	d e s t i n a g a o* n a n
detenshon	d e t e n T u n
dirigentenan	d i x e n t e n a n
disgusta	d i s g u s t a
dispone	d i s p o n e
disposicion	d i s p o s i i o n
donjo	d o* h o
efectua	e f e k t u a
escogencia	e s k o g e n C i w a
factura	f a k t u r a
fomenta	f o m e nt~ a
gram	g r a m
gym	gy~ m
ignora	i N n i o r a
inmenso	i n m E n s o
interesnan	i n t e r e s n a n
internamente	i n t E r n a m e n t e
lamentable	l a m e n t a b l e
liter	t e r
logrando	l o g r a n d o
mayan	m E n
mire	m i r
obligacionnan	o b l a i g a i o* n a n
ofreci	o f r E c i
pesca	m i C
planeta	p l a y i n e t a
posesion	p o s e s i o n
proyeccionnan	p r o y o j i o* n a n
residencia	r e s i d i n C i w a
sembra	s e mb~ r a
sentimentonan	s e n t i m e n t o n a n
substancial	s u b s t a n C i w a l
teatro	t e a t r o
tiplijn	t e p l i j n
traduci	tr~ a d u k i
trankilo	tr~ a n k i l o
vloer	v l o e r
voluntarionan	v o l u n t a r i o n a n
Adicionalmente	d i k i o n a l m e n t e
Afdeling	f d e l i N
Antonio	t o o
Arqueologico	r s o X o l o g i k o
Aruparking	n i n i N
Brasil	r a s i l
Ciencia	i n C i w a
Constitucion	o s t i t u k i o n
Dande	a n e
Daniel	a n i
Dokter	o k t e r e n
Domingo	o m i Ng~ o
Dus	u s
Esun	s u n
Hapon	a p o n
Hogeschool	o g 3 s C o l
Interino	t E r i n o
Kier	i e r
Luz	u
Maske	a s k e
Mental	e n t a l
Mervin	e r v i n
Mil	i l
Miljard	i l y a r d
Muhe	a e
Nederland	p i e d r xy~ E kw~ a n d i g
Obama	b a m a
Orman	r m a n
Planea	l a n e a
Politie	o l i t i e
Rotterdam	o t t E r d a m
Sallestraat	a ly~ a* 7 a t
Scheepvaart	C e e p  a r
Specialmente	p e k i a l m e n t e
Tanten	a n t e n
Tarabana	a r a b a n a
Tormenta	o r m e nt~ a
Tuma	u m a
Turistanan	u r i s t a n a n
Weststraat	e k s t r a t
absoluto	a b " s o l u t o
accent	a k u a 5 a
acomoda	a k o m o d a
acomodacion	a k o m o d a i o n
acompañante	a k o mp~ a 5 a t e
alrespecto	a l r e s p E kh~ a m e* t o
ampliacion	a m p l i a i o n
apart	a p a r
asilo	a s i l o
ateriza	a t e r i c a
autorisa	a u t o r i s a
bataya	b a t a y a
bateria	b a t e r i a
baño	b a 5 u
calma	k a l m a
cantante	k a nt~ a n t e
cartanan	k i t a n a n
castiga	k a s t i g a
chance	% p i s k a n C i e
circulo	l r u l o
comestibel	k o m e s t i b e l
confiabel	r o n % b i j a b e l
cunucu	k u n u k u
dam	d a m
dat	d a t
debil	d e b i l
descripcion	d e s k r i p i o n
detencionnan	d e t e n C i w o* n a n
digitalisa	d i g i t a l i s a
distribucion	d i s t r e i o n
down	d o w n
electricidad	e l e k i cy~ i d a d
eroneo	e r o n e o
fila	b i l a
firmamento	f E i r m a m e n t o
fraude	f r a u d e
frecuente	f r e kw~ e n t e
gradicimento	g r i w C i w r m e n t o
habriendo	h a b r i e n d o
hari	h a r i
huesped	h u i e 8 p e n e d
huez	h u i e z
humilde	h u m i l d e
imagina	i m a g i n a
inmunologico	i n m u n o l o g i k o
integro	i n t e g r o
inventa	i n v e nt~ a
klasnan	k l a s n a n
laso	l a s o
mapa	m a p a
medaya	m e d a y a
mete	m e t e
motoriza	m u t u r i c a
obstaculo	o b s t a k u l o
orarionan	o r a r i o n a n
organizacionnan	u r g a n i r o i o* n a n
parehanan	p a r e h a n a n
parkeer	p i e r e
permisonan	p e r m i s o n a n
pick	p i k
piki	p i k i
planifica	p l a y i  k a
pos	p o s
protehi	p r o t e h i
receta	r E c e t a
rechaza	r E C l a p i a
reforza	r E h r a
rekesitonan	r e k e s i t o n a n
reservanan	r e s E r v a n a n
semi	s e m i
sucursal	s u k u r s a l
sugerencia	s u g e r e n C i w a
tecnologico	t e k n o l o g i k o
tristeza	t r i S t E z E
veredicto	v e r e d i k t o
wayanan	w a y a n a n
yame	y a m e
yude	y u d e
Alaves	l a v e
Alivio	l i v i o
Aviacion	v i a i o n
Avianca	v i a C a
Bernabela	E a n a b e l a
Catolico	a t o l i k o
Colorado	o l o r a d o
Dicon	i k o n
Empleadonan	p l e a d o n a n
Haime	a i m e
Hildward	i l 7 w a r d
Joan	o a n
Militair	i l i t a i r
Nivel	i v e l
Obra	b r a
Parti	i t i
Pastoor	a s t u o r
Quandt	u a nd~
Rapport	a p p o r
Representantenan	a p r e s e n t a n t e n a n
Resultado	e s u l t a d o
Rodgers	o d g e r
Slachtofferhulp	l a t o f a i b p
Sport	p o r
West	e s t
acera	a C E r a
activamente	a k t e  e n t e
agredi	y r e d i
agresion	y r e s i o n
alegre	a l e g r e
alimento	a l i m e n t o
anticurpa	a n t  p a
atraccion	a t r a k i o n
bringando	b r i N a n d o
bruha	b r u h a
consecutivo	r o n e n i u t i b o
contestanan	r o n t e s t a n a n
crusa	k r u s a
culpabel	k u l p a b e l
damanan	d a m a n a
delinea	d e l i n e a
diagnostico	d i a g n o s t  o
directornan	d i r E C t o r n a n
discusionnan	d i s k u s i o n n a n
euro	u
exclui	" k l u i
fada	f a d a
finansa	f i n a s a
food	f o d
formularionan	f o r m u l a r i o n a n
hechonan	h e C o n a n
hibando	h i b a n d o
horizonte	h o r i  b u* d a k
independencia	i n d e p e n d e n C i w a
indesea	i n d e s a i a
inicialmente	i n i C y a l m e n t e
inmunidad	i n m u n i d a d
inocente	i n o k e n t e
invitado	i n v i t a d o
juda	x u d a
km	k m
lancha	l a n C a
landamento	l a n m e n t o
lectornan	l e k t o r n a n
limpieza	l i m p i e z a
listra	l i s t r a
loco	l o k o
mahos	m a h o s
marino	m a r i n o
medicinal	m e d i k i n a l
meimei	m e i m e i
nombernan	n o m b E a n a n
ok	o k
opcionnan	o p i o* n a n
panorama	p a n o r a m a
payroll	p a y r o l o
percepcion	p e r e p i o n
pista	p i s t a
reconstruccion	r E c o s t r u C a i o n
reforsa	r E h s a
sero	s e r o
socionan	s o k i o n a n
staff	s t a f
stichting	s t i C t i N
storianan	s t o r i a n a n
titula	t i t u l a
tosamento	t o s a m i n t o
tristesa	t r i s t i 3 s a
turbulencia	t u r l e n C i w a
usuario	u s u a r i o
votado	v o t a d o
waya	w a y a
yamado	y a m a d o
Alavez	l a v e z
Avestruz	f e s t r u
Basico	a s i k o
Cacho	a c
Conforme	o h m e
Contrario	o t r a r i o
Dilanti	i l a n t i
Dominicano	i n i C i t a
Escudero	s k u d e r o
Fast	s d a
Fonds	d
Give	i v E
Guillfred	u i l f r e d
Hotelnan	o t e l n a n
Libertador	i b e r t a d o r
Marketing	a r k e t i N
Medidanan	e d i d a n a n
Page	a g a
Persona	e r s o n a
Ports	u r c
Pronto	r o n t o
Recien	e T i e n
Rijksministerraad	g i y k s m i n i S t E r a
Sanicolas	a n i k o l a
Segunda	e g u n d a
Tobago	o b a g o
Trahadonan	r a h a d o n a n
Weg	g
WhatsApp	h a c p p
alternativo	a l t E r n a t i b o
balie	b a l i e
bendicion	b e n w C i w r o n
bendiciona	b e n d i k i o n a
bono	b o n o
bringamento	b r i N a m e n t o
camindanan	k a m i n d a n a n
clausura	k l a u s u r a
click	k l i k
confrontando	r o n f r o n t a n d o
continente	r o n t i n e n t e
coordinador	k o r d i n a d o r
corespondiente	k o r e s p o n d i e n t e
credibilidad	k  b i l i d a d
debernan	d e b e r n a n
destaca	d e s t a k a
detayes	d e t a y e
digitalisacion	d i g i t a l i s a k i o n
divisas	d i v i s a s
empuhe	3 mp~ e
fam	f a m
fechanan	f e C a n a n
figura	f i g u r a
force	f o r k e
funcionarionan	f u n C i w o n a r i o n a n
genero	g e n e r o
habrimento	h a b l i m e n t o
heeft	h e f
intentonan	i n t e n t o n a n
invalido	i n v a l i d o
keur	k e u r
marcha	m a* r C a
mision	m i s i o n
muy	m u y
negosacionnan	n e g o s a i o* n a n
nombracion	n o mb~ r a i o n
ofertanan	o f e r t a n a n
panel	p a n e l
particularmente	p e r t i k u l a s a y m 3 n t e
perfecto	p e r f e k t o
piscanan	p i s k i s  a n a n
ponencianan	p o n i n C i w a n a n
preserva	p r e s E r v a
prizon	p r i z o n
quizas	k i c~ 3 s
referente	r e f e r e n t e
reporta	r e p o r t e
resa	r e s a
saludable	s a l u d a b l e
seccionnan	s e k i o* n a n
sosodiendo	s o s o d i e n d o
sub	s u b
testing	t e s t i N
treciendo	w a m i C y e n d o
work	e*
Arashi	r a S i
Astec	s t e k
Autoridadnan	u t o r i d a d n a n
Basora	a s o r a
Bestuur	e s t u r
Buki	u k i
California	a l i f o r n i a
Cft	f
Chevrolet	h e b r o l e t
Child	h i l 7
Comunicacion	n i C i i o n
Dentro	e n t r o
Djis	h i s
Electoral	l e k t o r a l
Esta	s t a
Exprodesk	S p r o d e s k
Filomena	i l o m e n a
George	e o r g e
Google	o g l e
Guardian	u a r dy~ a n
LabHOH	a b "
Lenny	e 5
Mes	m 3 s
Miles	i l a
Mini	i n i
Moko	o k o
Nada	a d a
Norte	u r t e
Plataforma	l a t a h m a
Politico	o l i t  o
Prof	r o f
Royal	o y a l
Senado	e n a d o
Tienda	i e n d a
Tratamento	r a t a m e n t o
Valdez	a l d e z
Visa	i s a
Yaris	a r i s
aan	a n
adopta	a d o p t a
afectando	a f e k t a n d o
artistico	i t i s t  o
asbest	a s % s a m a
asta	a s t a
ata	a t a
audiencia	a u d i i n C i w a
biahamento	b i a h a m e n t o
blokea	b l o k e a
boei	b o e i
campañanan	k a m a 5 a
capa	k a p a
capacita	k a p a k n e n
cayanan	k a y a n a n
cien	C y e n
clinica	k l i n i k a
complice	k o m p l i k e
constante	k o s t a n t e
contacta	r o n t a  t a
crudo	k r u d o
desesperacion	d e s a i 8 p e n e r a i o n
desplega	d e s p l e g a
diferencianan	d i f e r e n C i w a n a n
elementonan	l E l E m E n t o n a n
elogio	e l o g i o
enfermedadnan	e n f s a y m 3 d a d n a n
ensera	e n e r a
entidadnan	e n t i d a d n a n
envez	e n p e m u
felicitacion	f e l i k i t a i o n
frena	f r e n a
fuel	f u e l
gradua	g r a d u a
heroe	h e r o e
inteligencia	i n t e l i g 3 n C i w a
interveni	i n t E r f e n i
kaso	k a s o
lage	l a g e
lansamento	l a s a m i n t o
luhoso	l u h o s o
moratorio	m o r a t o r i o
netamente	n e t a m e n t e
nivelnan	n i v e l n a n
obviamente	o b i a m e n t e
ocacion	o k a i o n
origina	u r i g i n a
plastico	p l a y i s t  o
pobresa	p o b r e s a
productivo	p r o C u k t i b o
profundamente	p r o f u nd~ a m e n t e
rasa	r a s a
raspa	r a s p a
saluda	s a l u d a
session	s e s s i o n
set	s e t
sosteni	s o s t e n i
studio	s t u d i o
tosa	t o s a
yamadanan	y a m a d a n a n
Argentina	r g 3 n t i n a
Arubalening	r u b a l e n i N
Awg	w
Back	a k
Bao	a o
Bin	i n
Booshi	o S i
Cliente	l i e n t e
Colombiano	o l o m b i a
Conferencia	o f m i n C i w a
Cumpra	u m p r a
David	a b i d
Daño	a 5 u
Derechonan	e r e C o n a n
Diesel	e s
Docternan	o k t E r n a n
Edward	d w a r d
Elite	t e
End	nd~
Finansas	i n a sh~ 3 s
Ford	u r d
Gomez	o m e z
Grandinan	r a n w
House	o u s e
Illes	L m 3 s
Instancia	s t a n C i w a
Juffrouw	u f r o u n a
King	i N
Luis	k i s
Mario	a ry~ o
Mediador	e d i a d o r
Milieu	i l i e u
Mundialmente	u n d i a l m e n t e
Pandemia	a n d e m i a
Pfizer	f i 8 e
Rotaract	o t a r a k s
Siendo	i e n d o
Sosten	o s t e i n
Tata	a t a
Telearuba	e l e a r u b a
Telefon	e l e f o n
Tevreden	p i r r e d e n
Town	a u n
Unit	n i t
Zaken	a k e n
Zuid	u i
advies	a d v i e
ambtenaarnan	a m b t e n a r n a n
amistad	a m i s t a d
ansiedad	s i e d a d
aparte	a p i t e
asigna	a s i g n a
atraca	a t r a k a
awasero	a w a s e r o
balora	b a l o r a
biahenan	b i a h e n a n
biña	b i 5 a
bofon	b o f o n
by	b i e
cantica	k a n t i k a
cena	k e n a
certifica	C E r   k a
confidencial	r o n f i d i n C i w a l
contamina	r o n t a m 3 n a
criteria	k r i t E r i a
debati	d e b a t i
delegacion	d e l e 7 a i o n
dependiendo	d e p e n d i e n d o
diabetico	d i a b e t  o
diagnostica	d i a g n o s t i k a
djies	d n o x e
duidelijk	d u i d e l i j
eerste	e l s t e
ekiponan	r p o n a n
exclusivo	" k l u s i b o
externo	" t E r n o
higiene	h i x i E n E
homenahe	h o m E n a e
igualdad	i g w E l d a N a d
impresiona	i m p r e s i o n a
insinua	s i n u a
institucion	s t i t u k i o n
interpreta	i n t E r p r e t a
interpretacion	i n t E r p r e t a i o n
intervencion	i n t E r f e n C i w o n
kibrando	k i b r a n d o
kustwacht	k u s t w o t
medicina	m e d i k i n a
miseria	m i s e r i a
modera	m o d e r a
monumentonan	m o n u m e n t o n a n
nombramento	n o mb~ r a m e n t o
nomina	n o m i n a
ohala	o h a l a
operadornan	o p e r a d o r n a n
originalmente	u r i g i n a l m e n t e
park	p e r
parkeerplaats	p i e l p l a n i n a c
partners	p e r t n e r
piscamento	p i s k i s  e n t o
plaso	p l a y i s o
productor	p r o C u k t o r
prometedor	p r o m e t e d o r
reaccionnan	r e a k i o* n a n
restriccionnan	r a i cy~ i o* n a n
sapato	s a p a t o
seconde	s e k o nd~ e
secuestra	s e kw~ e s t r a
spearfishing	s p e a r f i S i N
stul	s t u l
subiendo	s u b i e n d o
sushedad	s u S e d a d
tawatin	t a w a t i n
temor	t e m o r
tine	t i n e
track	tr~ a k
unabes	u n a b e sy~ s
vandalismo	v a nd~ a r i s m o
verbal	e r b a l
votadonan	v o t a d o n a n
wordu	e* d u
zonido	z o n i d o
Abao	b a o
Anual	n u a l
Arutram	r u t r a m
Basta	a s t a
Bosman	o s m a n
Bou	o u
Cabay	a b a y
Cantidad	a n t i d a d
Casa	a s a
Day	a y
Desk	e s k
Development	u s k u a m E n t
Diabetes	i a b e t e
Docentenan	T E n t e n a n
Duna	u n a
Ecuador	k u a d o r
Eleccion	l e k i o n
Gonzalez	n z a l e z
Historia	i s t o r i a
Hitler	i L e r
Hulandesnan	u l a n d e s n a n
Hyatt	y a t
Internet	t E r n
Loonsubsidie	o s u b i d i e
Lucia	u C i a
Malmok	a l m o k
Mangel	a N
Monumentenfonds	n u m e n t e n f o n d
Natuur	a t u r
Pavia	a b i a
Pickup	i S k u p
Prijs	r e j o
Protocol	r o t o k o l
Region	g i o n
Regreso	g r e s o
RevPAR	e v
Sasakiweg	a s a k i w e
Segundo	e g u n d o
actuando	a k t u a n d o
alimenta	a l i m e nt~ a
anti	a n t i
autorizacion	a u t o r i r o i o n
barcode	b a r k o t e
bebemento	b e b e m e n t o
bonus	b o n u s
cabalmente	k a b a l 3 m e n t e
cambernan	k a m b E a n a n
capitulo	k a p i t u l o
cargo	k 3 y
categorianan	k a t e g o r i a n a n
cel	k
clarifica	k l a r i f i k a
concentracion	r o n C i tr~ a i o n
condecoracion	r o n d e k o r a i o n
continuidad	r o n t i n u i d a d
cosecha	k o s E r C a
cubo	k u b o
danjo	d a n T i
dependiente	d e p e n d i e n t e
die	d i e
diesel	d i e s
dunabo	d u n a b o
elmar	e l m a r
elogia	e l o g i a
estimulo	e s t i m u l o
expectativa	" p E kh~ a m e* t a t i v a
exponi	" p o n i
fotografia	f o t o g r a f i a
gradual	g r a d u a l
herido	h e r i d o
himno	h i m
hobenan	h o b e n a n
horeca	h o r e k a
hospitalisa	h o s p i t a l i s a
huurdo	h u r d o
inciso	m a i s o
industrial	u z i a l
informando	i n f o r m a n d o
intermediacion	i n t E r * dy~ a i o n
kaminda	k a m i n d a
klapchi	k l o p C i
libera	b e r a
liga	l i g a
literatura	t E r a t u r a
masterplan	s t E r p l a n k o
migracion	m i b o ch~ i o n
morde	m o r d e
operando	o p e r a n d o
organisando	u r g a n i s a n d o
paro	p e r o
parokia	p e r o k i a
participando	p e r t i k i p a n d o
personan	p e r s o n a n
placentero	p l a y i C E n t e r o
pleito	p l e i t o
premionan	p r e m i o n a n
preparatorio	p r e p a r a t o r i o
preso	p r e s o
prioridadnan	p r i o r i d a d n a n
prosperidad	p r o 8 p e n e r i d a d
rango	r a n g o
razon	r a z u n
recibo	r E c i b o
rehen	r e h e n
religion	r e l i g i o n
resistencia	r e s i s t i n C i w a
rumor	r u m o r
sacrifica	s a q  k a
segunda	s e g u n d a
siguransa	s i g u r a s a
slip	s l i p
sobrevivencia	s o b b e b i v i n C i w a
socio	s o i o
sostenible	s o s t e d i b o l e
spierta	s p i e r t e
spirito	s p i r i t o
stabilisa	s t a b i l i s a
stapnan	s t a p n a n
studiando	s t u d i a d o
substancia	s u b s t a n C i w a
sucesonan	s u s e s o n a n
systema	s i m s t e m a
tardi	t a r d i
transportacion	i t r i s p o r t a i o n
tratadonan	tr~ a t a d o n a n
webo	w o r o
wowonan	w o w o n a n
Atlantico	L a n t  o
Bus	u s
Cunucu	u n u k u
Dificultad	f i k u l t a d
Diripiente	i r i p i e n t e
Ela	l a
Emmastraat	m u s t r a t
Falcon	a l k o n
Falta	a l t a
Fe	e
Gamma	a m a
Gerencia	i d i n C i w a
Jaburibari	a b u l e d a r i
Karibe	a r i b e
Lagoen	a g o e n
Logicamente	o g i t k a m e n t e
Marino	a r i n o
Masterplan	a s t E r p l a n k o
Mr	r
Normal	o r m a l
Piet	i e t
Prueba	r u e b a
Rector	e k t o r
Recurso	e kw~ s o
Sanders	a n d e r
Schakel	a q
Schiphol	C i f o l
Schwengle	C Ng~ E v e Ni l e
Security	e kw~ r i t u s
Specialista	p e k i a l i s t a
Store	t o r e
Suzuki	u z u k i
Taxista	a x i s t a
Trabou	r a b o u
WiFi	i
Zoutman	o u t m a n
abogadonan	a b o g a d o n a n
aclaria	a k l a r i a
adictonan	a d i k t o n a n
afdeling	a f d e l i N
alomenos	a l o m E n o s
armanan	a r m a n a
aseguradonan	a s e g u r a d o n a n
asombra	a s o mb~ r a
atleta	a t l e t a
avionnan	a g o y o* n a n
añas	a 5 a s
best	b e s
biaheronan	b i i* o n a n
borchinan	b o r C i n a n
campus	k a m p u s
cariño	k a r i 5 u
celnan	C E l n a n
componente	k o m p o n e n t e
comunista	k o m u n i S th~ a
convoca	r o n v o k a
criadero	k ry~ a d e r o
cruza	k r u w Z a
cuidadano	k u i d a d a
dañino	d a 5
dede	d e d e
diplomatico	d i p xy~ u 7 t  o
documenta	d o k u m e nt~ a
dudoso	d u d o s o
dunadonan	d u n a d o n a n
especie	e s p E kh~ a m e* i e
expresionnan	" p r e s i o n n a n
feedback	f e u t o n g k
handsanitizer	h a n d s a n i t i 8 e
hemchi	h e m C i
hoga	h o g a
hospitalidad	h o s p i t a l i d a d
ilegalnan	i l a  l n a n
implica	i m p l i k a
incinerator	m a i n e r a t o r
informashon	i n h S o n
intencionalmente	i n t e n C i w o n a l m e n t e
iresponsabel	i r e s p o i r a r u w
justicia	x u s t i i a
kleuter	k l e u t e r
lastra	l a s t r a
lema	l E m a
logicamente	l o g i k a m e n t e
mandatarionan	m a n t a r i o n a n
manual	m a n u a l
nochi	n o C i
ofreciendo	o f r E C y e n d o
opone	o p o n e
organizadornan	u r g a n i z a d o r n a n
parse	p i s e
persecucion	p e r e kw~ i o n
piek	p y E k
plamando	p l a y i m a n d o
pobreza	p o b r E z E
progresa	p r o g r e s a
psychiater	p a C i a t e r
reglamenta	r e g l a m e nt~ a
reino	r e i n o
relaha	r e l a h a
restructura	r e s t r u k t u r a
sacando	s a k a n d o
sancion	s a* i o n
selecta	s e l e k t a
sensacion	s e sh~ 3 i o n
sercania	s e r k a n i a
sker	s k a r
software	 tw~ a r e
suave	t a e
superficie	s u p e r f i k i e
take	t a k e
tantisimo	t a n t i s i m o
teme	t e m e
temporario	t e m p o r a r i o
yamando	y a m a n d o
Art	r
Arte	r t e
Biento	i e n t o
Boegoeroei	o e g o e r o e i
Bond	o
Caso	a s o
Commissie	o m m i s s i e
Congreso	o N r e s o
Cria	r i a
Cruise	r u i s e
Curason	u r a s o*
Examen	S a m e n
Famianan	a m i a n a n
Feliz	e l i z
Flamingo	l a m i Ng~ o
Frans	r a n
Gobiernonan	o b i E a n o n a n
Groot	r o u t
Habitantenan	a b i t a n t e n a n
Hoo	o
Hose	o s e
Imelda	m e l d a
Importacion	p o r t a i o n
Inmigracion	n m i b o ch~ i o n
Interact	t E r a k s
Kong	o N
Laba	a b a
Laboral	a b o r a l
Leo	e o
Lito	i t o
Live	i v E
Lottery	o t t E r
Nicolaas	i k o l a
Ocean	C E
Ohala	h a l
Palo	a l o
Pita	i t a
Pro	r o
Qredits	r e d i c
Reunion	u n i o n
Ritz	i c
Seguridad	e g u r i d a d
Sta	t a
State	t a t e
Super	u p e r
Tumba	k i
Veterinaire	e t e r i n a i r
Well	E l o
Women	e n
Wuhan	a a n
abusonan	a b u s o n a n
aceptabel	a k e p t a b e l
acogida	a k o g i d a
adhunto	a d u n t o
alternativanan	a l t E r n a t i v a n a n
aproximadamente	a p r o n l a p i N t e
aresto	a r e s t o
atacha	a t a C a
blokia	b l o k i a
box	b o 7
bureau	b u r e a u
cancelacion	5 u k u n C i e l a i o n
cancionnan	5 u k u n C i w o* n a n
carbon	k a g i b o n
castigable	k a s t i g a b l e
cerebro	C E r e b r o
cielo	C y e l o
ciencia	C y e n C i w a
cientificonan	C y e n t i f i k o n a n
coach	k o a C
coba	k o b a
cognitivo	k o g i E 5 i t i b o
combatimento	k o mb~ a t i m e n t o
combustibel	k o m b u s t i b e l
competente	k o m p e t e n t e
concientizacion	r o n C y e n t i r o i o n
conocirnan	r o n o C i w a n a n
considerabel	k o s i d e r a b e l
considerablemente	k o s i d e r a b l E m E n t e
debolbe	d e b o l b e
decisionan	d e 7 i s i o n a n
despacha	d e s p a C a
dirigente	d i x e n t e
division	d i v i s i o n
documentario	d o k u m e n t a r i o
dramatico	d r a m a t  o
ehecutivonan	e h e k u t i b o n a n
ei	e i
elemento	l E l E m E n t o
empodera	e m p o d e r a
enfermeronan	e n f s a y m 3 r o n a n
entendi	e n t e n d i
escohe	e s k o h e
estrictamente	e k i cy~ t a m e n t e
fiel	f i
fit	f i t
fragil	f t a n g g a i l
galiña	g a l i 5 a
gritonan	g r i t o n a n
hayanan	h a y a n a n
hora	h o r a
inaugura	i n a u g u r a
individuo	i n d i v i d u o
inkomstenbelasting	m i s t e n b e l a s t i N
instalacionnan	s t a l a i o* n a n
intenso	i n t e s o
interior	i n t E r i o r
intrankilidad	i n t r a n k i l i d a d
investigadornan	i n v e s t i g a d o r n a n
jeep	h e 3 p
ke	k e
kerstboom	k e r Sx~ b o s i r
kitando	k i t a n d o
laboratorionan	l a b o r a t o r i o n a n
locura	l o k u r a
lote	l o t e
mamanan	m a m a n a
management	m a n a g E m E n t
met	m e t
multitud	l t i t u d
negociando	n e g o k i a n d o
netto	n e t t o
niet	n i e t
nificacion	n i f i k a i o n
observacion	o b e r v a i o n
ocaciona	o k a c i o n a
odio	o d i o
opleiding	o p l e i d i N
oranje	o r a n j e
perseverancia	p e r s e r a n C i w a
personalnan	p e r s o n a l
piesa	p i e s a
pintura	p i t u r a
pionero	p i o n e r o
placanan	p l a y i k a n a n
primi	p l i m i
pronosticonan	p r o n o s t i k o n a n
propietario	p r o p i e t a r i o
recorido	r E c o r i d o
refugiado	r e f u g w a d o
religioso	r e l i g i o s o
resona	r e s o n a
rijkswet	r i k s a b w e t
sabi	s a b i
sabiendo	s a b i e n d o
segura	s e g u r a
sesionnan	s e s i o n n a n
sex	s e 7
señalnan	s e ny~ a l
silencia	s i l 3 n C i w a
simbolo	s i m b o l o
sonido	s o n i d o
soporta	s o p o r t e
stage	s t a j
suzuki	s u z u k i
tennis	t e i s
tent	t e n t
territorial	t e r i t o r i a l
trastorno	t r a s t o r n o
turtuga	t u r t u g a
unavez	u n a b e z
valve	v a l v e
viaheronan	v i i* o n a n
weso	w e s o
Britania	r i t a n i a
Burger	u r g e r
Casnan	a s n a n
Conchi	n C i h
Condecoracion	d e k o r a i o n
Debit	e b i t
Deportivo	a p o r t i b o
Dushi	u s i
Edad	d a d
Eddie	d i e
Entiteit	t i t a i
Ex	7
Excelencia	a l  e l e n C i w a
Exxon	S S o n
Formacion	o r m a c i o n
Haciendo	a c i e n d o
Hamas	a m a s
Henny	e 5
Hobennan	o b e n
Honda	o n d a
IBiSA	i
Koopmans	o p
Latin	a t i n
Liliana	i l i a n a
Lucky	u C ky~
Ma	a
Maestro	a a* 7
Mitsubishi	t i u b i S i
Negoshinan	e g o s i n a n
Ocupacion	k u ph~ a i o n
Officer	f i C E r
Penal	e n a l
Procurador	r o k u r a d o r
Quanten	u a n t e n
Redaccion	e d a k i o n
Relacionnan	e l a i o* n a n
Rode	o d e
Sousa	u
Tours	o u r
Trade	r a d e
Unico	n i k o
Voogdijraad	o a y a ly~ w r a
Wout	o u t
Young	o u N
aborda	a b " a l d a
accentua	a k k 3 n t u a
accepta	a k u p t a
arubiano	a r u b i a
autobus	a u t o b u s
auxilio	 i l i o
balance	b a l a n k o e
balans	b a l a n
barnan	b a r n a n
bestuur	b e s t u r
cabay	k a b a y
cambiando	k a m b i a n d o
cent	C E n t
chekeo	C e k e 7 o
chiquito	c i k i t o
colegio	k o l e g i o
comisario	k o m i s a r i o
concientisacion	r o n C y e n t i s a k i o n
contaminacion	r o n t a m i n a g a o n
cortina	k o r t i n a
criterianan	k r i t E r i a n a n
cuarto	k u a r t o
cube	k u b e
damnan	d a m n a n
desafio	d e s a f i o
direct	d i r E C
distincion	d i s t i n C i w o n
dobel	d o b e l
doctor	d o k t o r
efectividad	e f e k t i v i d a d
empresarial	3 mp~ r e s a r i a l
entretene	e n t r e t e n e
eseynan	e s b n a n
excusa	e Z u k w s a
ford	f o r d
habilidadnan	h a b i l i d a d n a n
hygiena	h i i e n a
illegal	i l l e 7 a l
imigracion	i m i b o ch~ i o n
impedi	i m p E d i
imponi	i m p o n i
innova	i n n o v a
insulta	s u l t a
kap	k a p
kleuterschool	k l e u t E r S o l
lamper	l a m p e r
laptop	l a p t o p
lokaal	l o a l
medianan	m e d i a n a n
muhenan	m u h e n a n
numa	n u m a
obheto	o b h e t o
obranan	o b r a n a n
ocupante	o k u p a n t e
opina	o p i n a
optimismo	a t i m i s m o
pacientnan	p a k i e n t n a n
paramediconan	p a r a m e d i k o n a n
parcial	p i r i a l
pase	p a s e
patient	p a t i E n t
pensionado	p e ns~ i o n a d o
plus	p l u s
preferi	p r e f e r i
preliminar	p r e l i m i n a r
primanan	p l i m a n a
proceder	p r o k e d e r
productornan	p r o C u k t o r n a n
protegi	p r o t e g i
refuerzo	r E pw~ e r o
reservacion	r e s E r v a i o n
restitucion	r e s t i t u k i o n
ritmo	r e m o
scooter	s k o o t e r i s
sede	s 3 d e
significativo	s i g  k a t i b o
signo	s i g n o
sobresali	s o b r e s a l i
stabiel	s t a b i
sticker	s t i S k a r
sucursalnan	s u k u r s a l
sunchi	s u n C i h
technico	t e C n i k o
tram	tr~ a m
trapi	tr~ a p i
verf	e r f
victoria	v i k t o r i a
òf	o f
Alberto	l k t o
Amigo	m i g o
Asistencia	s i s t i n C i w a
Atardi	t a r d i
Best	e s t
Boekenfonds	o k b a n f o n d
Bogota	g o t a
Campaña	a m a 5 a
Canal	a n a l
Cancer	a n C E r
Caracas	a r a k a s
Carlton	a r l t o n
Cerca	e r k a
Challenge	h a l l 3 N a
Creek	r E k
Delivery	e l i e r
Democracia	e m o k r a c i a
Funeral	u n e r a l
Genser	e n e r
Governance	o e r a*  e
Grecia	r E c i a
Hospice	o s p i k e
Hubert	u b e r
Imigracion	m i b o ch~ i o n
Innovacion	a n n o w a i o n
Islanan	s l a n a n
Italiano	t a l i a
Klabér	l a b e r
Ladronnan	i n a n
Lancer	a n C E r
Latinoamerica	a t i n o a m e r i k a
Leerorkest	e l u r X a* 7
Lounge	o u N a
Luydens	u y d e n
Maestronan	a e s t r o n a n
Marinierskazerne	a r i e r p 3 l 3 m r i ly~ n e
Melvin	3 l i N i n
Momento	e n t o
Naturalesa	a t u r a l 3 s a
News	e w
Nicole	i k o l e
Notario	o t a r i o
Orden	r d e n
Paramediconan	a r a m e d i k o n a n
Parokia	a r o k i a
Pastor	a s d o r
Pone	o 7
Problema	r o b l 3 m a
Radio	a d i o
Ryan	y a n
Sahara	a h a r a
Shiribana	h i r i b a n a
Siguiendo	i g i e n d o
Sky	ky~
Step	t E p
Tecnologia	e T n o l o g i a
Theo	h e o
Wind	i n d
Yama	a m a
Yarzagaray	a r c a G a r a y
abismo	a b i s m o
abusador	a b u s a d o r
aceptable	a k e p t a b l e
acusado	a k u s a d o
admision	a d m i s i o n
ambiental	a m b i e n t a l
amistadnan	a m i s t a d n a n
anima	a n i m a
anualmente	a n u a l m e n t e
anula	a n u l a
aplicable	a p l i k a b l e
aplicando	a p l i k a n d o
aplicante	a p l i k a n t e
atakenan	a t a k E n a n
atrasa	a t r a s a
ausencia	a u s i n C i w a
automatico	a u t o m a t  o
balente	b a l e n t e
bentaha	b e n t a h a
bij	b " i x
biodiversidad	b i b Ng~ e r e n i d a d
biologico	b i o l o g i k o
bishitanan	b i S i t a n a n
boluntariamente	b o l u n t a r i a m e n t e
bonbini	b o n b i n i
brigada	b r i x a d a
cabey	k a m u y
caidanan	k a i d a n a n
calculacionnan	k a l k u l a k a i o n n a n
campeonato	k a m p e o n a t o
capita	k a p i t a
certificacion	C E r   k a i o n
cluster	k l u s t e r e n
comentarionan	k o m e n t a r i o n a n
comite	k o m i t e
conose	r o n o s e
conseheronan	k o s e h e r o n a n
consumidornan	k o s u m i d o r n a n
contrae	r o n tr~ a e
convenio	r o n f e n i o
converti	r o n e r t i
coordinacion	k o r d i n a g a o n
culminacion	k u l m i n a g a o n
custuma	k u s t u m a
decente	d e 7 e n t e
decir	d e l
demostrando	d e m o s t r a n d o
desespera	d e s a i 8 p e n e r a
diez	d i e z
digitalmente	d i g i t a l m e n t e
drief	d r i f
entama	e n t a m a
fabuloso	f a b u l o s o
fast	f s d a
fiansanan	f i a s a n a n
filma	b i l m a
finalisando	f i n a l i s a n d o
formalisa	f o r m a l i s a
formando	f o r m a n d o
foto	f o t o
garoshi	g a r o S
generalmente	g e n e r a l m e n t e
gusto	g u s t o
harpun	h a r p u n
helpdesk	h e l p b u r
hermentnan	h e s a y m 3 n t n a n
iPad	i a d
imprimi	i m p l i m i
incansabel	m a i r a r u w
indigna	i n y a N n a
infantil	i n f a nt~ i l
inflacion	i n f l a i o n
inkietud	m i e t u d
instructornan	s t r u k t o r n a n
intacto	i n t a  t o
intensifica	i n t e ns~ i f i k a
invitadonan	i n v i t a d o n a n
kimico	k i m i  o
kontakto	k o nt~ a k t o
landsbesluit	l a n d s b e s  i t
lechi	l e C i
lector	l e k t o r
listanan	l i s t a n a n
localiza	l o k a l i c a
loonbelasting	l o b e l a s t i N
luho	l u h o
maleta	m a l e t a
mandando	m a n nd~ o
mangel	m a N
maniobra	n i o b r a
meneer	m E n e r e
mobiliza	m o b i l i c a
normalisa	n o r m a l i s a
om	i r
oost	o s
out	o u t
paraliza	p a r a l i c a
plataformanan	p l a y i t a h t i e C e p o n k
porfabor	p o r f a b e r
posecion	p o s E r i o n
preis	p r e i s
presentacionnan	p r e s e n t a q i o* n a n
psikiatra	p i k i a t r a
rate	r a t e
recherchenan	r e 5  t a C e n a n
reciente	r E C y e n t e
rector	r E c t o r
referendum	r e f e r e n d u m
reflexion	r e f l " i o n
respaldo	r e s p a l d o
respectivo	r e s p E kh~ a m e* t i b o
restart	r e s n a p a
rooi	t o n i
santana	s a n t a n a
scarcedad	s k a r k e d a d
severamente	s e e r a m e n t e
simple	s i m p l e
solicitud	s o l i k i t u d
specializa	s p e k i a l i c a
spiel	s p i e l
stranheronan	s t r a h e r o n a n
tardansa	t a r d a s a
tempu	t e N p u
testimonio	t e s t i m o* i o
time	t i
titular	t i t u l a r
trahe	tr~ a e
transport	i t r i s p o r
turbulento	t u r l e n t o
vuurwerk	f i  w e r
zwaai	z w a a i
Aldrich	l d r i C
Anuesca	n u e s k a
Bahamas	a h a m a s
Bishita	i S i t a
Cambio	a m b i o
Coach	o a C
Considerando	o s i d e r a n d o
Contraloria	o tr~ a l o r i a
Coronel	o r o n e l
Cuida	k i d a
Democrats	e m o k r a c
Diagnostico	y a g n o s t  o
Edjean	a j i
Eerste	e r s t e
Embahador	b a h a d o r
Empresanan	p r e s a n a n
Hendrikstraat	e n d r i k s t r a t
Influenza	n f m b u g z a
Islands	s l a nd~
Ivo	v o
Jairo	a i r o
Juliana	l i a n a
Kibaima	i b a i m a
Korea	o r e a
Laura	a u r a
Leadership	e a d i n S i p
Market	a r k e t
Martijn	i t i j n
Mericanonan	r i k a n o n a n
Meverly	p i r r xy~ E kw~ a
Oceano	C E a
Porfin	u r f i n
Productions	r o C u k ty~ o* s
Punto	u n t o
Request	e k i a* 7
Rio	i o
Roland	o l a n d i g
Santana	a n t a n a
TeleAruba	e l e r u b a
Vision	i s i o n
Webinar	E b 3 n i a r
Zr	r
aleha	a l e h a
alto	a l t o
angulo	a n g u l o
anonimo	a n o n i m o
apto	a p t o
autentico	a u t e n t  o
awacati	a w a k a t i
beneficioso	b e n e f i n i o s o
bononan	b o n o n a n
braza	b r a z a
cabezante	k a b e z a n t e
campeon	k a m p e 7 o n
campo	k a m p o
carece	k a r e k e
carnavalesco	k a g i n a v a l e s k o
carson	k 3 y s o n
celebrando	k e l e b r a n d o
cen	C E n
challenge	C a l l 3 N a
charter	C a r t e r
coi	k o i
comprometi	k o m p r o m e t i
consenso	r o n e s o
contingencia	r o n t i N i n C i w a
contratistanan	r o n tr~ a t i s t a n a n
crew	k r E f
definicion	d e f i n i C i o n
definitivo	d e f i n i t i b o
desapunta	d e s a p u n t a
deseonan	d e s a i o n a n
dienst	d i w o s d a
dies	d i e
difunto	d i f u n t o
diki	d i k i
djente	a j i n t e
dosis	d o s i s
dunamento	d u n a m e n t o
eGovernment	e w e r e g w i t a a 5 a
efectivamente	e f e k t e  e n t e
eherciendo	e h e r i e n d o
electrico	e l e k i cy~ o
enfermeria	e n f s a y m 3 r i a
esunan	e s u n a n
extension	e S s i o n
fabrica	f a b r i k a
familiarnan	f a m i l i a r n a n
flexibel	f l " i b e l
flexibilidad	f l " i b i l i d a d
fotografo	f o t o g r a f o
frieu	f r i u
funeraria	f u n e r a r i a
grito	g r i t o
handle	h a n d l e
handschoen	h a n d s k k u r u m e N
higienico	h i x  o
huespednan	h u i e 8 p e n e d n a n
huntu	h u n t u
ilumina	i l u m i n a
immune	i m u n e
inaceptable	i n a k e p t a b l e
incansablemente	m a i r a r u w l E m E n t e
incompleto	i n k o m p l e t o
indefini	i n d e f i n i
indole	i d o l e
industrianan	u z i a n a n
inhustamente	L u s t a m e n t e
inmoral	i n m o r a l
intenta	i n t e nt~ a
lague	l a g w e
leak	l E a k
legislacion	l E g i w a i o n
legislativo	l E g i s l a t i b o
localisa	l o k a l i s a
lusnan	l u s n a n
malcontento	m a l k o n t e n t o
malgasta	m a l g a s t a
melding	m e l d i N
mina	m i n a
monitoria	m o n i t o r i a
motibu	m o t i b u
nacion	n a g a o n
naturalisacion	n a t u r a l i s a k i o n
paar	p a r
paginanan	p a x i n a n a n
pirata	p i r a t a
presupuestario	p r e s u p u e s t a r i o
previo	p b e b i o
prudente	p r u d e n t e
rand	r a n d
re	r e
recoge	r E c o g e
reparticion	r e p i t i i o n
sabiduria	s a b i d u r i a
sabor	s a b e r
sacudi	s a k u d i
sangra	s a n g r a
siete	s i e t e
spart	s p i t
specifica	s p e k  k a
stakeholder	s t a k e h o l d e r
suplente	s u p l e n t e
susha	s u a
ter	t e r
tolerancia	t o l e r a n C i w a
ultimamente	u l t i m a m e n t e
una	u n a
universidad	u n i v e r i d a d
upload	u p l o a d
usual	u s u a l
utilidad	u t i l i d a d
vacunanan	v a k u n a n a n
votonan	v o t o n a n
workshops	e* C o p
Abuse	s e
Afortunadamente	f o r t u n a d a m e n t e
Angela	g e l a
Angelo	g e l o
Anselmo	n s l 3 m o
Antiano	t i a
Area	r e a
Arubianismo	r u b i a n i S m o
Bisti	i s t i
Cachi	a C i
Carta	i t a
Chiquito	h i k i t o
Cinco	m a o
Clarisca	l a r i s k a
Comandante	t a nd~ a n t e
Comun	n
Contact	n t a
Cuentanan	u e n t a n a n
Debe	e b e
Do	o
Expression	S p r e s s i o n
Exterior	r e r i o r
Global	l o b a l
Go	o
Gruponan	r u p o n a n
Het	e t
Hilton	i l t o n
Imsan	m s a n
Instagram	s t a g r a m
Irausquin	r a u s k i n
Johnson	o h E 5 o*
Junior	u n i o r
Keto	e t o
Kiko	i k o
Land	a n d
Landsverordening	a n d s e r o r d e n i N
Managing	a n a g i N
Marc	a r
Marsman	a r S m a n
Mey	u y
Natural	a t u r a l
Ocho	C o
Oranje	r a n j e
Oro	r o
Pago	a g o
Paskel	a s k
Politiconan	o l i t i k o n a n
Prevencion	r E f i n C i w o n
Remarcabel	e m a r k a b e l
Richi	i C i
Ruth	u c
Safety	a f e t
Saliña	a l i 5 a
Shailiny	h a i l i N
Tamarijn	a m a r i j n
Tele	e l e
Utilities	t i l i t i e
Vroegop	r o e g o p
Weganan	g a n a n
YouTube	o u b e
Zika	i k a
abusado	a b u s a d o
aliento	a l i e n t o
anticua	a n t i g u a
azota	a z o t a
barku	b a r k u
berdaderamente	b E r d a d e r a m e n t e
bezoldiging	b e z o l d i g i N
biahero	b i a h e r o
blo	b l o
board	b o a r d
buske	s k e
cabayero	k a b a y e r o
camp	k a m
campamento	k a m a m e n t o
caretera	k a r e t e r a
cede	C E d e
celebracionnan	k e l e b r a i o* n a n
chines	C i n i
clientela	k l i e n t e l a
colaborador	k o l 3 b u a o r a d o r
comedia	k o m e d i a
competencianan	k o m p e t e n C i w a n a n
comunidadnan	k o m u n i d a d n a n
concientiza	r o n C y e n t i c a
contractnan	r o n tr~ a k t n a n
costonan	k o s t o n a n
crioyo	k r i o y o
cruz	k r u
crèche	k r e C e
cumindanan	k u m i n d a n a n
deportista	d e p o r t i s t a
determinante	d e t e r m i n a n t e
duo	d u o
ehercicionan	e h e r C i w C i w r o n a n
enfocando	e n f o k a n d o
enormemente	e n o r m E m E n t e
espantoso	e s p a n t o s o
explosion	" p l o s i o n
faborabel	f a b o r a b e l
fayonan	f a y o n a n
flexibilizacion	f l " i b i l i r o i o n
fracaso	f r a k a s o
funcionando	f u n C i w o n a n d o
funcionnan	f u n C i w o* n a n
gobernador	g o b E a n a d o r
hefenan	h e f e n a n
horor	h o r o r
huurgrond	h u r g r o n d i
inovacion	i n o w a i o n
interoga	i n t E r o g a
it	i t
kas	k a s
kiebra	k i e b r a
lift	l i f
linear	l i n e a r
mail	m a i l
mall	m o l
manehando	m a n e h a n d o
manteni	m a n t e n i
mentalmente	m e n t a l m e n t e
mereci	m e r a T i
modernisa	m o d E a n i s a
muha	m u h a
naar	n a r
noble	n o b l a e
noticianan	n o t i i a n a n
ofishi	o f i S i
olanan	o r a n a n
papiamento	p a p i a m e n t o
paradanan	p a r a d a n a n
pensamentonan	p e s a m i n t o n a n
permanece	p e r m a n e k e
pica	p i k a
pidie	p i d i e
popularidad	p o p u l a r i d a d
presupuestonan	p r e s u p u e s t o n a n
prevalece	p b e b a l e k e
procede	p r o k e d e
propiedadnan	p r o p i e d a d n a n
publicacionnan	p u b l i k a i o* n a n
quorum	k o r u m
refugio	r e f u g w i o
relatonan	r e l a t o n a n
reparacion	r e p a r a i o n
reputacion	r e p u t a i o n
riñon	r i 5 o n
rolluik	r o L u i k
rutanan	r u t a n a n
salvo	s a l i N o
scenarionan	s k e n a r i o n a n
scuridad	s k u r i d a d
separacion	s e p a r a i o n
shop	S o p
sicario	s i k a r i o
simanan	s i m a n a
sociaal	s o k a l
solar	s o l a r
spuit	s p u i
strena	s t r e n a
stuurgroep	s t u r g r o 3 p
suficientemente	s u f i C y e n t E m E n t e
suspenso	s u 8 p e n e ty~ s o
timon	t i m o n
trend	w a m i n d
tripulantenan	t r e p u l a n t e n a n
vacatura	v a k a t u r a
viahenan	v i a h e n a n
webinars	w o r i n a r
welga	w e l g a
welo	w e l o
x	7
yobe	y o b e
zijn	z i j n
Abou	b o u
Americas	m e r i k a s
Artificial	r   i a l
Arubaanse	r u b a s e
Aseguro	s e g u r o
Barbados	a r b a d o s
Big	i g
Blue	l u e
Boca	o k a
Boeing	N i N
Breaking	r E k i N
Car	a r
Christmas	h r i s t m a s i
Conrado	o r a d o
Consulado	o r e p e n a d o
Cultural	u l t u r a l
Dianan	i a n a n
Federacion	e d e r a i o n
Finalisando	i n a l i s a n d o
First	i r s d a
Fresh	r e S
Gonzalo	n z a l o
Goshen	o S e n
Grand	r a n d
Hall	o l
Hendrik	e n d r i k
In	n
Incinerator	n u X a i n e r a t o r
Inteligencia	t e l i g 3 n C i w a
Janine	a n i n e
Jeon	e 7 o n
Kabinet	a b i n e t
Kort	u r
Leynan	b n a n
Mainta	a i n a m l a n i
Martin	i t i n
Mihor	i h o r
Museum	u s e u m
Noka	o k a
Nomber	d o mb~ e r
Old	l
Partidonan	i t i d o n a n
Rosel	o s e l
Sagrado	a g r a d o
Seguro	e g u r o
Sharina	h a r i n a
Simar	i m a r
Simplemente	i m p l E m E n t e
Situacion	i t u a i o n
Smart	m a* r
Soca	o k a
Solange	o r a n g e
Spaans	p a n
Subway	u b w a y
Surinam	u r i n a m
Takelwagen	a k e l w a g 3 n
Tipline	i p l i n e
Tisa	i s a
Toets	o e c
Tour	o u r
Truck	r u C a
Tuitt	k i t
Turista	u r i s t a
Web	e
Wega	e g a
Williams	i ly~ i m
Yuda	u d a
abilidad	a b i l i d a d
academia	a c a d 7 e m i a
account	a k k o u n t
acercamento	a C E r k a m e n t o
aclaracion	a k l a r a i o n
actor	a k t o r
afortunadamente	a h t u n a d a m e n t e
agricultornan	y i cy~ u l t o r n a n
alcance	a l 5 u k u n C i e
aliado	a l i a d o
all	o l
anochinan	a n o C i n a n
atmosfera	a t n o S f e r a
atracador	a t r a c a d 7 o r
babuca	b a b u k a
batata	b a t a t a
blvd	b l a d
bolo	b o l o
cabando	k a b a n d o
candidata	k a nd~ i d a t a
ceramento	C E r a m e n t o
chofer	C o f e r
cinema	i n i m a
colorido	k o l o r i d o
compasion	k o mp~ a s i o n
compensacion	k o m p e sh~ 3 i o n
comprencion	k o m p m i n C i w o n
comprendibel	k o m p r e n d i b e l
concurso	r o n k u r s o
contactonan	r o n t a  t o n a n
contradeci	r o n tr~ a d e k i
creciendo	k r E C y e n d o
crecimento	k r E c i n e n e n t o
cueste	kw~ e s t e
decora	d e k o r a
deporta	d e p o r t e
desayuno	d e s a y u n o
deteccion	d e t e k i o n
diesdos	d i e s d o s
digno	d i g i E 5 o
disciplinario	d i S e p l i n a r i o
disertacion	d i s E r t a i o n
dolornan	d o l o r n a n
eigenlijk	e i g 3 n l i j
empresarionan	3 mp~ r e s a r i o n a n
encarecidamente	e n k a r E c i d a m e n t e
encaso	e n k a s o
entrenamento	e n t r e n a m e n t o
erornan	a ph~ n a n
error	e r o r
especienan	e s p E kh~ a m e* i e n a n
espectaculo	e s p E kh~ a m e* t a  l o
etica	e t i k a
eventualmente	p i r 3 n t u a l m e n t e
extendi	e S i
fasenan	f a s e n a n
fracasa	f r a k a s a
frecuencia	f r e kw~ e n C i w a
gasoline	g a s o l i n e
gewoon	g e o n
gigante	g i g a n t e
grill	g r i l
hincamento	h i n k a m e n t o
hole	h o l e
horibel	h o r i b e l
hungando	h u N a n d o
identificacion	d e n t i f i k a i o n
ingles	i N l e
intencional	i n t e n C i w o n a l
intension	i n t e ns~ i o n
interupcion	i n t E a m i o n
jeans	h e a*
juffrouw	x u f r o u n a
kWh	k
licencia	l i k i n C i w a
logo	l o g o
mandatorio	m a nd~ a t o r i o
materno	m a t E r n o
merca	m e r k a
mokete	m o k e t e
moviendo	m o v i e n d o
nister	n i S th~ E r
nuebe	n u e b e
nunka	n u n
pacient	p a k
pasco	p a s k o
periodismo	p e r i o d i s m o
podernan	w a b E a n a n
policlinica	p o l i k l i n i k a
pompstation	p o m p s t a t i o n 3
profesionalismo	p r o f i S i o n a l i s m o
prohimo	p r o h i m o
promesanan	p r o m e s a n a n
propaga	p r o p a g a
proposicionnan	p r o p o s i i o* n a n
psycologo	p s S e k o l o g o
puntre	p u n t r e
quadracer	k 7 t a d r a C e r i t
rapidez	r a  d e z
recomendabel	r E c o m e n d a b e l
recordatorio	r E c o r d a t o r i o
recreacion	r E c r e a i o n
refinancia	r e f i n a n C i w a
restructuracion	r e s t r u k t u r a i o n
revista	r E i s t a
revolver	r E f o l v e r i
riguroso	r i g u r o s o
salanan	s a l a n a n
saliente	s a l i e n t e
scarsedad	s k a g i s 3 d a d
secretario	s e k r e t a r i o
shete	S e t e
speech	s p e n
splike	s p l i k e
sufrimento	s u f l i m e n t o
susto	s u s t o
telefonico	t e l e f o n i k o
tercera	t E r u r a
toke	t o k e
traductor	tr~ a d u k t o r
trampa	tr~ a m p a
transaccionnan	i t r i s a k i o* n a n
transmicion	i t r i s C u w C i w r o n
tripulante	t r e p u l a n t e
tuberia	t u b e r i a
tucson	t u k o*
tèst	t 3 7 s d a
urgentemente	u r g 3 n t E m E n t e
videoclip	v i d e o k l i p
visa	v i s a
Academia	k a d e m i a
Action	k t i o n 3
Agricultura	g r i k u l t u r a
Andicuri	n t i k u r i
Antiyas	t i y a s
Apenas	p e n 3 s
Apple	p p l e
Baho	a h o
Bienestar	i e n e s t a r
Black	l a k
Cabana	a b a n a
Cafe	a f e
Cambionan	a m b i o n a n
Choudhry	h o u d r
Cien	i e n
Compara	p a r a
Consul	o* s u l
Copa	o p a
Corporate	u r p o r a t e
Cuminsando	m i s a n d o
Dabian	a b i a n
Department	a p i t m E n t
Depresion	a p r e s i o n
Fatima	a t i m a
Fitch	i t
Fuerte	u e r t e
Gaalen	a l e n
Glenda	l e n d a
Grant	r a nt~
Growell	r o w e l o
Hulp	u l p
Imeldahof	m e l d a h
Impact	p a k s
India	n t i a
Infantil	n f a nt~ i l
Interest	t e r e s
James	a m e
Jet	e t
Kamp	a m p
Kendrick	i cy~
Kids	d
Laboratorio	a b o r a t o r i o
Mantene	a n t e n e
Mayor	a y o r
Miguel	i g
Moderna	o d E a n a
Montaña	o* t a 5 a
Montenegro	o t e n e g r o
Motibo	o t i b o
Nes	m 3 s
Nuhad	a h a
Oost	o s
Open	p e n
POREDmep	m e p
Palace	a l a k e
Papilon	a p i l o n
Paula	a u l a
Pedro	p i e d r o
Piscadonan	i s k a d o n a n
Prison	r i S o n
Progreso	r o g o r e s o
Public	u b l i k
Richardson	i C a r j u n
Rosario	o s a r i o
Rumbastraat	u mb~ a s t r a t
Sagicor	y i k o r
Sostenible	o s t e d i b o l e
Special	p e k i a l
Stadhuis	t a d w i s
Tera	e r a
Terminal	e r m i n a l
Texier	" i e r
Trabao	r a b a o
Traimerdia	r a i * d i a
Unavez	n a b e z
Vondellaan	d e y a
Walk	a l
Week	e k "
absolutamente	a b " s o l u t a m e n t e
aconseha	a k o s e h a
ader	a d e r
adresa	a d r e s a
afirma	a f i r m a
agresor	y r e s o r
aparatonan	a p a r a t o n a n
artikel	i t i k e l
auspicio	a u s p i i o
bacteria	b a k t E r i a
baseball	b a s e b o l
binidero	b i n i d e r o
bisindario	b i s i n d a r a o
body	b o t a
boost	b o s i r
bosonan	b o s o n a n
burocracia	b u r o k r a c i a
camaranan	k a m a r a n a n
caracterisa	k a r a k t E r i s a
caracteristicanan	k a r a k t E r i s t i k a n a n
caravana	k a r a v a n a
checklist	C e k k 3 l i p s d a
ciclo	C i w C i l o
circumstancia	l r u m s t a n C i w a
civico	i v i k o
clapchi	k l a p C i
clinico	k l i n i k o
cocolishi	k o k o l i S i
combate	k o mb~ a t e
comodo	k o m o t o
compensa	k o m p e s a
competitivo	k o m p e t i t i b o
complicacionnan	k o m p l i k a i o* n a n
compornde	k o m p o r nd~ e
comunismo	k o m u n i S m o
condicionan	r o n d i k i o n a n
conducta	r o n d u k t a
congreso	k o N r e s o
consistente	k o ns~ i s t e n t e
cualnan	k u a l
cuartal	k u a r t a l
cuidador	k u i d a d o r
cyclista	ky~ k l i s t a
d	d
dañonan	d a 5 o n a n
debilita	d e b i l i t a
deleita	d e l e i t a
desigualdad	d e s i g w E l d a N a d
desmantela	d e s t e l a
deze	d e z e
discucion	d i s k u k i o n
dive	d i v E
ecosistema	e k o s i s t e m a
educacional	e d u k a c i o n a l
enfaticamente	e n f a t i k a m e n t e
engrandece	g r a n d e k e
entusiasma	e n t u s i a s m a
epicentro	a p C " e l e n t r o
excelencia	" s e l e n C i w a
explosivo	" p l a n u k u b o
festivo	f e S t i b o
file	b i l e
free	f r e
front	f r o n s
frontliners	f r o n t l i n e r
fructifero	f r u k ty~ f e r o
greppel	g r e p p e l
hasiendo	h a s i e n d o
heridanan	h e r i d a n a n
hobby	h o b b i e
imparcial	i m p i r i a l
inauguracion	i n a u g u r a i o n
indicadornan	i n d i k a d o r n a n
indirectamente	i n d i r E C t a m e n t e
inspecciona	s p E kh~ a m e* i o n a
interumpi	i n t E r u m p i
inventario	i n f e n t a r i o
invisibel	i n i s i b e l
joyas	j o y a s
kaba	k a b a
komo	k o m o
lastimamente	l a s t i m a m e n t e
logistica	l o g i S t i k a
logistico	l o g i S t  o
maestra	m a e s t r a
mancha	m a n C a
manifestacionnan	n i f e s t a k i o n n a n
manifiesto	n i f i e s t o
minuutnan	m i n u t n a n
misterio	m i s t E r i o
mondmasker	m o n d a s k a r
moringa	m o r i Ng~ a
multiple	l t e p l e
natacion	n a t a i o n
neglisha	n e g l i S a
nervioso	n e r i o s o
notando	n o t t a n d o
obligatoriamente	o b l a i g a t o r e a m e n t e
off	o f
opinionnan	o p i n i o n n a n
oponentenan	o p o n e n t e n a n
oportuno	L o k t u n o
organisacionan	u r g a n i s a k i o n a n
pacifico	p a k   o
pagara	p a g a r a
parkeo	p i 7 o
patientnan	p a t i E n t n a n
pedofilnan	p e 8 r o f u k a C n a n
perdiendo	p e r d i e n d o
pianan	p y a n a n
pico	p i k o
pilarnan	p i l a r n a n
plaats	p l a y i a c
probecho	p l o b e T h o
procesverbaal	p r o k e s e r b a l
proclama	p r o k l a m a
pura	p i r a
puro	p u r o
reactivacion	r e a k t i v a i o n
recobra	r E c o b r a
recompensa	r E c o m p e s a
reenforsa	h r e n h s a
reglamentonan	r e g l a m e n t o n a n
rekesito	r e k e s i t o
remarcabel	r E m a r k a b e l
responsabilisa	r e s p o i r a r u w i l i s a
restante	r e s t a n t e
restonan	r e s t o n a n
retene	r e t e n e
selecciona	s e l e k i o n a
short	S o r
sintonisa	s i n t o n i s a
slow	s l o
speedboat	s p e u t o n a a t
sunu	s u n u
supla	s u p l a
taira	t a i r a
tardando	t a r d a n d o
taskforce	t a s k h r e
tecnica	t e k n i k a
thee	3 th~ i
tilda	t i l d a
tragedia	tr~ a g e d i a
tribi	t r i b i
unilateralmente	u n i l a t e r a l m e n t e
util	u t i l
validez	v a l i d e z
variacion	v a r i a i o n
venezolano	f e n e z o r a n o
vitamina	v i t a m 3 n a
windshield	w i d S i e l
yuinan	y u i n a n
Abraham	b r a h a m
Acaso	k a s o
Andre	n d r e
Andrew	n d r E f
Animal	n i m a l
AruBIG	r u
Banconan	5 u k a o n a n
Benchi	i n C i h
Bill	i l
Bisiñanan	i s i 5 a
Bloomberg	l o m b a rx~
Board	o a r d
Calidad	a l i d a d
Cannabis	a n n a b i s
Caribisch	a r i b i S
Carolina	a r o l i n a
Comerciantenan	e r i a n t e n a n
Comite	o m i t e
Compania	p a n i a
Computer	i m p u t e r
Cuna	u n a
Dado	y i
Dengue	g w e
Dijkhoff	g i y o f
Douaneronan	o u a n e r o n a n
Droga	r o g a
Duarte	u a r t e
Elements	l E m E nt~ u
Emanstraat	s t r a t
Encuanto	n kw~ a n t o
Escolar	s k o l a r
Financia	s a m a i a
Fontein	o t a i n
Frances	r a n C i m 3 s
Frere	r e r e
Futura	u t u r a
Garcia	a r i a
Garden	a r d e n
Gemeente	e m e n t e
Gradus	r a d u s
Great	r e a t
Halloween	o l  w e n
High	i t
Iglesia	g l e s i a
Integriteit	t e g r i t a i
Jeep	e 3 p
Jucuri	u k u r i
Kerstboomlandia	e r Sx~ b o m l a n d i a
Kisas	i s a s
Kralendijk	r a l e n d i j
Kwartaal	w a r t a l
LaSorte	a o r t e
Lanta	a n t a
Little	i t
Mabon	a b o n
Mall	o l
Marchena	r x e n a
Mercado	i l a y
Molina	o l i n a
Movimiento	o v i m i e n t o
Muher	u h e r
Number	u mb~ e r
Nunes	u n i
Paramedico	a r a m e d i k o
Pashentnan	a s u N t n a n
Patrick	a t i cy~
Pelican	e l i k a n
Percura	e r k u r a
Peterson	e t e r o*
Presente	r e s e n t e
Preto	r e t o
Problemanan	r o b l 3 m a n a
RAiZ	i
Red	3 d
Relacionista	e l a c i o n i S th~ a
Ruso	u s o
Samenscholingsverbod	a m e s C o l i N s e r b o d
Sostenemi	o s t i n i m i
Speransa	p e r i s a
Testnan	e s t n a n
Thomas	h o m a s
Tico	i S
Turibana	u r b a n a
Wak	a k
Winklaar	m l a r
Zoom	o m
adaptacionnan	a d a p t a i o* n a n
annual	a n a l
aplauso	a p l a y i u s o
argumentonan	a r g u m e n t o n a n
aruba	a r u b a
autismo	a u t i s m o
auxiliar	 i l i a r
beyesa	b e y 3 s a
bieuw	a w e n
bisabo	b i s a b o
budget	b u d k
buelta	b u e l t a
cadenanan	k a d e n a n a n
camanan	k a m a n a
careteranan	k a r e t e r a n a n
centenares	C E n t e n a r e
chat	C a t
ciruhano	l a
clasico	k l a s i k o
clip	k l i p
conrector	r o n r E C t o r
controle	r o n t r o l e
cordialidad	k o r dy~ a l i d a d
coremento	k o r E m E n t o
correcto	k o r e k t o
database	d a t a b a s e
debit	d e b i t
decoracion	d e k o r a i o n
decreta	d e 7 r e t a
derota	d e r o t a
discrepancia	d i s k r e p a n C i a
discrimina	d i s k l i m i n a
dispensacion	d i 8 p e n e ty~ sw~ i o n
do	d o
domino	b i*
donacionnan	d o n a g a o* n a n
economianan	e k o n o m i a n a n
elo	e l o
embahada	e m b a h a d a
emplea	3 mp~ l e a
encabesa	e n k a b e s a
encuestanan	e n kw~ e s t a n a n
endemico	e n d e m i  o
enfermero	e n f e r m e r o
envolvimento	e n v o l g o y e n t o
equiponan	e k i p o n a n
estafa	e s t a f a n a
evidente	p i r i d e n t e
exigiendo	" i g i e n d o
experencianan	" p e r e n C i w a n a n
fantasma	f a nt~ a s m a
favor	f a v o r
formato	f o r m a t o
formulanan	f o r m u l a n a n
friu	f r i u
ganado	g a n a d o
gigantesco	g i g a nt~ L w E  o
good	g o d
gracia	b o ch~ i a
grato	g r a t o
habitat	h a b i t a t
haf	h a f
hanja	h a n j a
huiswerk	w i S w e r
ilegalidad	i l a  l i d a d
individualmente	i n d i v i d u a l m e n t e
informal	i n f o r m a l
iniciativanan	i n i C y a t i v a n a n
input	i n p u t
insigur	s i g u r
insiguridad	s i g u r i d a d
institucionnan	s t i t u i o* n a n
instructor	s t r u k t o r
interaccion	i n t E r a k i o n
international	i n t E r n a t i o n a l
ja	y a
karentena	k a r e n t e n a
klasse	k l a s s e
laborando	l a b o r a n d o
lantamento	l a nt~ a e n t o
legitimo	l E g i t i m o
lineanan	l i n e a n a n
liñanan	l i 5 a
lobby	l o b b i e
mala	m a l a
marcanan	m a* r k a n a n
market	m a* r k e t
masal	m a s a l
medicamento	m e d i k a m e n t o
menornan	m E n o r n a n
mensualmente	m E n s u a l m e n t e
mini	m i n i
mobil	m o b i l
mortalidad	m o r t a l i d a d
movimento	m o v i m e n t o
natal	n a t a l
navega	n a b e g a
neishi	n e i S i
network	n e t w o r
nr	n r
observacionnan	o b e r v a i o* n a n
omo	o m o
onderwijs	d i n w i j
parecido	p e r E c i d o
patruyahe	p a t r u y a e
pena	p e n a
perhudicando	p e r u d i k a n d o
pleita	p l e i t a
poko	p o k o
porshento	p o r S e n t o
precisamente	p r E c i s a m i n t e
premie	p r e m i e
procedimento	p r o k  m e n t o
profila	p r o f i l a
prominente	p r o m i n e n t e
proteina	p r o t e i n a
protestanan	p r o t e s t a n a n
rabo	r a b o
raiz	r a i z
rating	r a t i N
recicla	r E c i k l a
recuerdo	r e kw~ e r d o
refleho	r e f l e h o
regionnan	r e g i o n n a n
regulacionnan	r e g u l a k a i o n n a n
rek	r E k
renovacion	r e n o w a i o n
responsabilidadnan	r e s p o i r a r u w i l i d a d n a n
rutina	r u t i n a
samenscholingsverbod	s a m i Th~ C o l i N s e r b o d
sanea	s a n e a
scogi	s k o g i
sende	s e n d e
service	s e r v i k e
skol	s k i
soborno	s o b o r n o
sobrepasa	s o b r e p a s a
soledad	s o l e d a d
sondea	s o n d e a
statuto	s t a t u t o
stem	s t e m
suv	s u
tabel	t a b e l
tenso	t e s o
tipico	C o* a* o
toxico	t o n  o
viahero	v i a h e r o
vigilando	v i g i l a n d o
wave	w a b e
whatsapp	wh~ E a c a p p
yudabo	y u d a b o
yui	y u i
Armando	r m a n d o
Asia	s i a
BaluArte	a l u r t e
Biemans	i e
Bingo	i Ng~ o
Boliviastraat	o l i v i a s t r a t
Boston	o s t o n
Britanico	r i t a n i k o
Brown	r o w n
Buena	u e n a
Café	a f e
Cali	a l i
Candela	a n d e l a
Casibari	a s i bh~ a r i
Centre	e n t r e
Chef	h e f
Chief	hy~ e f
Cierto	i e r t o
Colony	o l o n
Consensus	o* s u s
Constantemente	o s t a n t E m E n t e
Contabilidad	o* t a b i l i d a d
Corupcion	u r b i o n
Cumbre	u mb~ r e
Dentista	e n t i s t a
Dump	u m p a
Economische	r o n o m i s C e
Entrega	t r e g a
Ernesto	r n e s t o
Eugene	t u g e n e
Faro	a r o
Financien	i n a n C y e n
Frido	r i d o
Futbol	u t b o l
Gezaghebber	e c a G b a s k
Goedhoop	o e d o o p
Gumbs	u mb~
Heights	e i t
Helpdesk	e l p b u r
Higiena	i g i e n a
Inn	n n
Insurance	s u r a n C i e
Irani	r a n i
Jairzinho	a i r 5 h o
Jordan	u r d a n
Jorge	u r g e
Koningstraat	q o n i N s t r a t
Korps	u r p
Legislation	g i s l a t i o n 3
Lidernan	d E a n a n
Life	f e
Medical	e d i k a l
Meiveld	a i  E l d u r
Mimi	i m i
Minimarket	i n i m a r k e t
Naturalisacion	a t u r a l i s a k i o n
Night	i t
Nort	u r
Odillia	d i l l i a
Olsen	l e n
Patruyanan	a t r u y a n a n
Pereira	e r e i r a
Pesca	e s k a
Pesei	e s e i
Poets	o e c
Port	u r
Preguntanan	r e g u n t a n a n
Prinses	r i n e
Probablemente	r o b a b l E m E n t e
Program	r o g r a m
Psicologo	s i k o l o g o
Realidad	e a l i d a d
Registracion	g i s t r a i o n
Rene	e n e
Rep	3 p
Reposicionando	a p o s i i o n a n d o
Rodenburg	o d e nb~ u r
Rolando	o l a n d o
Ruyter	u 3 t e r
Schloss	C l o s
Scientology	C y e n t o l o Z
Sustainable	u s t a i n a b l e
Tapaboca	a p a b o k a
Telecomunicacion	e l e k o m u n i C i i o n
Teller	e l l e r
Temporada	e m p o r a d a
Trafico	r a f i k o
Traveler	r a v e l e r
Uzi	z i
Villas	i l l a
Virgin	i r g i n
Vitamina	i t a m 3 n a
Zeewijk	e w i j
agencianan	y i n C i w a n a n
agradable	a g r a d a b l e
ambicioso	a m b i i o s o
anota	a n o t a
argumenta	a r g u m e nt~ a
asfalt	a s f a l t a s
asientonan	a s e i n t o n a n
asocia	a s o* k i a
awenochi	a w e n o C i
balanza	b a l a n c a
bariga	b a r i g a
baña	b a 5 a
beschikking	b e s C i k i N
bloki	b l o k i
briya	b r i y a
bulando	b u l a d o
bulto	b u l t o
business	s i n e s
cahanan	k a h a n a n
cantidadnan	k a n t i d a d n a n
caranan	k a r a n a n
caritativo	k a r i t a t i b o
carteranan	k i t E r a n a n
carton	k i t o n
casamento	k a s a m i n t o
casualidad	k a s u a l i d a d
catolico	k a t o l i k o
cedula	C E d u l a
charlanan	C a l a n a n
cierre	C y e r
comandante	k o m a n d a n t e
combustible	k o m b u s t i b l e
comestibles	k o m e s t i b l e
comisionnan	k o m i s i o n n a n
compilacion	k o m p i l a i o n
componentenan	k o m p o n e n t e n a n
concientisa	r o n C y e n t i s a
constant	k o s t a nt~
constructivo	k o s t r u k t i b o
contrata	r o n tr~ a t a
coperacion	k o p e r a i o n
crash	k r a S
credit	k r e d i t
creencia	k h r e n C i w a
cultiva	k u l t i v a
cup	k u p
custumbernan	k u s t u* b E a n a n
deliberadamente	d e l i b e r a d a m e n t e
demonstra	d e m o* s t r a
descansa	d e s k a s a
desinfectante	d e s i n f k t a n t e
dibiaha	d i b i a h a
dibo	d i b o
dictatorial	d i k t a t o r i a l
dimension	d i * ns~ i o n
dividendo	d i v i d e n d o
double	t o u b l e
edadnan	e d a d n a n
eficaz	e f i C i
embahador	e m b a h a d o r
emision	e m i s i o n
entregamento	e n t r e g a m e n t o
entregando	e n t r e g a n d o
entrena	e n t r e n a
envelope	e n v e l o v e l o p e
evacua	p i r a g u a
exclusivamente	" k l u s i w a* m e n t e
excluyendo	" k l u y e n d o
experienciando	" p e r i n C i w a n d o
facultad	f a k u l t a d
fake	f a k e
favorito	f a v o r i t o
felis	f e l i s
filosofia	b i l o s o f i a
findishi	f i n d i S i
florece	f l o r e k e
formalmente	f o r m a l m e n t e
foyeto	f o e t o
give	g i v E
grandura	g r a d u r a
hancho	h a n C i o 7
hera	h e r a
hobencita	h o b i n C i w a
hospeda	h o s p e d a
hulp	h u l p
hòmber	h o mb~ e r
ilegalmente	i l a  l m e n t e
iluminacion	i l u m i n a g a o n
impeachment	i m p e a C m E n t
implementando	i m p l E m E n t a n d o
imposible	i m p o s i b l e
impresionante	i m p r e s i o n a n t e
impulso	i m p u l s o
indicenan	i n d i C E n a n
informenan	i n h m E n a n
ingresonan	i N X i e s o n a n
innecesariamente	i n d e* k a* b e s a r i a m e n t e
inspector	s p E kh~ a m e* t o r
integra	i n t e g r a
intensidad	i n t e s i d a d
invadi	i n v a d i
jet	h e t
lancer	l a n C E r
landsverordening	l a n d s e r o r d e n i N
loteria	l o t e r i a
mascotanan	s k o t a n a n
mencion	m E n C i w o n
mentornan	m e n t o r n a n
mexicano	m e S i k a
ministerionan	m i n i S t E r i o n a n
miyonario	m i o n a r i o
mondmask	m o n d a s k
motorcycle	m u t u r Ty~ k l e
municipio	m u n i C i p i o i
nubia	n u b i a
onderzoek	d i n t k
opositornan	o p o s i t o r n a n
optimalisa	a t i m a l i s a
opvang	o p v a N
pakiko	k i k o
piedad	p i e d a d
plantamento	p l a a nt~ a e n t o
poesia	p o e s i a
porcierto	p o r i e r t o
positivamente	p o s i t i v a m e n t e
prestigioso	p r e s t i g i o s o
print	p r i nt~
propagacion	p r o p a g a i o n
radical	r a d i k a l
rebelde	r e b e l d e
rectifica	r E c   k a
recuri	r E C u r i
referencia	r e f e r e n C i w a
refinerianan	r e f i n e r i a n a n
rehabilita	r e h a b i l i t a
remedia	r E m E d i a
reportahe	r e p o r t a e
resolvi	r e s o l w i
sacamento	s a k a m e n t o
sancionnan	s a* i o* n a n
satelite	s a t e l i t e
scirbi	s l b i
sentra	s e n t r a
sexualmente	s e m a l m e n t e
share	S a r e
sindicalista	s i n d i k a l i s t a
sintie	s i n t i e
snacks	s n a k k
socialista	s o k i a l i s t a
solidarismo	s o l i d a r i s m o
sondeo	s o n d e o
sonrisa	s o n r i s a
speculacion	s p e k u l a k a i o n
splicando	s p l i k a n d o
stagna	s t a j
stakeholdernan	s t a k e h o l d E a n a n
suceso	s u s e s o
support	s u p p o r
suspension	s u 8 p e n e ty~ s i o n
tanta	t a n t a
tatanan	t a t a n a n
telefonicamente	t e l e f o n i k a m e n t e
tellernan	t E l l E a n a n
temporadanan	t e m p o r a d a n a n
tokante	t o k a n t e
tools	t o L
torneo	t o r S o
tos	t o s
tot	t o t
touch	t o u C
transcuri	i t r i s k u r i
transitorio	i t r i s i t o r i o
transmission	i t r i s m i s s i o n
u	u
use	u s e
vangrail	v a n g r a i l
violento	v i o l e n t o
visible	v i s i b l e
west	w e s
winstbelasting	% s t b e l a s t i N
Accent	kh~
Administracion	d m i n i s t r a i o n
All	l o
Antillas	t e l l a
Arubadag	r u b a d a g
Arubig	r u b i g
Autobus	u t o b u s
Awa	w a
Bachelor	a g l o r
Ben	e n
Benjamin	e n c a m i n
Beverage	e e r a g e
Birgen	i r g 3 n
British	r i t i S
Cabesante	a b e s a n t e
Chikungunya	h i k u N u 5 a
Chile	h i l e N
Choller	h o l l e r
Cientificonan	i e n t i f i k o n a n
Clinton	l i n t o n
Coca	o k a
Comerciante	e r i a n t e
Complex	i m p l E 7
Concierto	o C y e r t o
Condé	d e
Conhuntamente	o h u n t a m e n t e
Conservation	o* s e r v a t i o n 3
Cruises	r u z o s
Decision	e T i s i o n
Dor	o r
Dorp	u r p
Doño	w o
Eduardo	d u a r d o
Ehecutivo	h e k u t i b o
Embahada	b a h a d a
Entrevista	t r e i s t a
Envez	n p e m u
Eric	r i k
Financial	s a m a i a l
Financiamento	s a m a e a m e n t o
Financieel	s a m a i e l
Flora	l o r a
Frontera	r o n t E r a
Gina	i n a
Goeloe	o e l u d
Grace	r a k e
Guillermo	u i l e r m o
Gusto	u s t o
Hoek	o k
Hong	o N
Hooyboer	o a* o e r
Horeca	o r e k a
Hub	u b
Idioma	d i o m a
Iniciativa	n i C y a t i v a
Interior	t E r i o r
Jade	a d e
Jetblue	e t bl~ a
Kas	a s
Korpschef	u r p S E f
Lab	a b "
Las	a s
Lighthouse	i t  o u s e
Lisette	i s e t
Marine	a r i n e
Marquez	a r k a
Martinez	i t i n e z
Meteorologico	e t e o r o l o g i k o
MiSVb	i
Migracion	i b o ch~ i o n
Milio	i l i o
Mira	i r a
Monarch	o n a dy~ o
Movies	o v i e
Music	u s i k
Myron	y r o n
Nast	s d a
Nederlandse	p i e d r xy~ E kw~ a nd~ s e
Network	e t w o r
Nightclub	i t  k l u b "
Orde	r d e
Orlando	r l a n d o
Pacifico	a k   o
Paraguana	a r a g u a n a
Paris	a r i s
Participacion	i t i k i p a k i o n
Pasa	a s a
Pecho	e T h o
Pelea	e l e a
Penha	n h a
Petronia	a t 3 r o n i y a
Plus	l u s
Posiblemente	o s i b l E m E n t e
Positivo	o s i t i b o
Programa	r o g r a m a
Project	t o n o x e k s
Pronk	r o n
Punta	u n t a
Quality	u a ty~ e
Quant	u a nt~
Rampen	a m p e n
Rapportnan	a p p o r t n a n
Rescue	e s k u e
Rodriguez	o d r i g e z
Sacrificio	a k  i o
Scan	k a n
Seis	e i s
Seyo	e y o
South	o u c
Surnam	u r n a m
Theater	h e a t e r
Thru	h r u
Travel	r a v e l
Wernet	E r n
Wil	i l
Wilhelminastraat	i l h e l m i n a s t r a t
abilidadnan	a b i l i d a d n a n
aceptacion	a k e p t a i o n
acreditacion	a k r e d i t a i o n
adecuadamente	a d e kw~ a d a m e n t e
agilisa	y i l i s a
ahustacion	a h u s t a k i o n
alentador	a l e n t a d o r
analiza	a n a l i c a
ancianonan	5 u k a i a n o n a n
anhela	a n e l a
artesania	i t e s a n i a
asbesto	a s b e s t o
asegura	a s e g u r a
asesina	a s e s i n a
ataka	a t a k a
auditoria	a u d i t o r i a
averigua	E b e r i g u a
bakinan	b a k i n a n
bandanan	b a n d a n a n
barancanan	b a r 3 n k a n a n
batayon	b a t a y u n
beleid	b e l e i d
beyeza	b e y e r a
bisami	b i s a m i
brabo	b r a b o
bruin	b r u i n
buffer	f f e r
campa	k a m p a
cantantenan	k a nt~ a n t e n a n
cashi	k a S i
categorisa	k a t e g o r i s a
censo	C E s o
censura	C E s u r a
ciclon	C i w C i l o n
cobrando	k o b r a n d o
comunitario	k o m u n i t a r i o
conceptonan	r o n C i e p t o n a n
concretisa	r o n C i r e t i s a
conocir	r o n o k i r
contempla	r o n t 3 mp~ l a
conteniendo	r o n e n d o
contractonan	r o n tr~ a k t o n a n
corantnan	k o r a nt~ n a n
coro	k o r o
cumbini	k u mb~ i n i
daggeldvergoeding	d a x g e l d e r g o i N
dental	d e n t a l
depresivo	d e p r e s i b o
desconecta	d e s k o n e k t a
difamacion	d i f a m a c i o n
directivanan	d i r E C t i v a n a n
disco	d i s k o
distingui	d i s t i N gw~ i s
districtonan	d i s t r i C t o n a n
disturbio	d i s t u r b i E o
diversidad	d i e r i d a d
diverso	d i e r s o
divorcio	d i v o r i o
donante	d o n a n t e
dosnan	d o s n a n
edicionnan	p i e d w C i w r o* n a n
educador	e d u k a d o r
elegi	e l e g i
emocionnan	e m o i o* n a n
enrikece	e n X i t t a u 8 o k a
er	e r
erfpacht	e r f p a X t
eventual	p i r 3 n t u a l
evitando	p i r i t a n d o
expectativanan	" p E kh~ a m e* t a t i v a n a n
expo	" p o
eybao	e y b a o
faha	f a h a
first	f a y s
flexibiliza	f l " i b i l i c a
foi	f o i
forensyco	f o r e s S e k o
fraccionnan	f r a k i o* n a n
gaba	g a b a
gritamento	g r i t a m e n t o
group	g r o u p
guardia	g u a r d i a
hayabo	h a y a b o
heridonan	h e r i d o n a n
hermana	h e r m a n a
heroenan	h e r o e n a n
hinka	h i n
hinke	h i n k e
hospitalnan	h o s p i t a l
house	h o u s e
hurista	h u r i 7 s t a
hustificacion	h u s t i f i k a i o n
ilustracion	i l u s t r a i o n
impuestonan	i m p u e s t o n a n
inclusivo	i n k l u s i b o
indicacionnan	i n d i k a i o* n a n
infeccionnan	i n f k i o* n a n
infraccion	i n f r a k i o n
ingrediente	i N X i  e n t e
ingresa	i N X i 3 s a
inn	i n n
insulto	s u l t o
inteligente	i n t e l i g 3 n t e
intensivamente	i n t e s i w a* m e n t e
intimida	i n t i m i d a
inunda	i n u n d a
inusual	i n u s u a l
inventarisa	i n f e n t a r i s a
lealtad	l E a l t a d
legado	l e 7 a d o
legalisa	l e 7 a l i s a
legitimidad	l E g i t i m i d a d
letter	l e t t e r
light	l i t
line	l i n e
listramento	l i s t r a m e n t o
lokaalnan	l o a l
lucrativo	% l u s r a t i b o
maluza	m a l u z a
maneranan	m a n e r a n a n
meti	m e t i
migrante	m i g r a n t e
modelonan	m o d e l o n a n
momentu	m o p i N t u
morocoy	m o r o k o y
motorunit	m u t u r u n i t
movecionnan	m o p e m u i o* n a n
musca	m u s k a t
noordwest	n o r dw$ a* 7
nubianan	n u b i a n a n
nulo	n u l o
observador	o b e r v a d o r
oraño	o r a 5 u
orientacion	u r i n t a  i o n
overtime	o e r t i m e
paciente	p a k i e n t e
paliativo	p a l i a t i b o
palonan	p a l o n a n
paranda	p a r a n d a
parha	p i i
part	p e r t
pasamento	p a s a m i n t o
patria	p a t r i a
perdidanan	p e r d i d a n a n
periodistico	p e r i o d i s t  o
piesanan	p i e s a n a n
plania	p l a y i n i a
plat	p l a y i
politicamente	p o l i t i k a m e n t e
populacion	p o p u l a k a i o n
posibelmente	p o s i b e l m e n t e
posicionnan	p o s i i o* n a n
positive	p o s i t i v E
postura	p o s t u r a
poz	p o
problematico	p l o b l a e m a t  o
procesamento	p r o k e s a m i n t o
profundidad	p r o f u nd~ i d a d
promé	p w e
psicologico	p s i k o l o g i k o
que	k E
raad	r a
recepcion	r E C E p E i o n
regalonan	r e g a l o n a n
regio	r e g i o
repatria	r e p a t r i a
respalda	r e s p a l d a
respetando	r E 8 p e n e t a n d o
restablece	r e s t a b l e k e
revision	r E i s i o n
sacrificionan	s a q  i o n a n
saka	s a k a
sake	s a k e
salbaguardia	s a l b a g u a r d i a
schoolnan	S o l n a n
schouder	S o u d e r
shopping	S o p p i N
sifuera	s i pw~ e r a
sigaria	s i g a r i a
simbolico	s i m b o l i k o
size	s i z e
siñamento	s i 5 a m e n t o
smart	s r
socialisa	s o k i a l i s a
speed	s p e 3 d
stempel	s t e N p e l
sumario	s u m a r i o
surseance	s u r s a*  e
tamaño	t a m a 5 u
tarhetanan	t a r h e t a n a n
tasa	t a s a
terminonan	t E r m i n o n a n
tocando	t o k a n d o
tono	t o n o
trainingnan	tr~ a i n i N n a n
transformacion	i t r i s h i o n
transplante	i t r i s p l a n t e
trip	t r i p
vanguardia	v a N g w a r d i a
versa	e r s a
veterinario	f e t e r i n a r i o
volumen	v o l u m e n
wardanan	w a r d a n a n
web	w e
werki	w e r
Accion	k i o n
Adventista	d f e n t i s t a
Alzheimer	l z  i *
Amalia	m a l i a
Ambtenaar	mb~ t e n a r
Andres	ndr$ e
Anteriormente	t E r i o s a y m 3 n t e
Anti	t i
Aressa	r e s
Argus	r g u s
Asegurado	s e g u r a d o
Ata	t a
Aurora	u r o r a
Autismo	h o 7 o t i p 3 m o
Barconan	r o n a n
Biba	i b a
Bloemond	l o e m o n d a
Britten	r i t
Brokke	r o k k e
Cabai	a b a i
CableTV	a b l e
Castigo	a s t i g o
Catalina	a t a l i n a
Categoria	a t e g o r i a
Celebracion	e l e b r a i o n
Centronan	e n t r o n a n
Chavez	h a v e z
Ciudadano	i u d a d a
Cola	o l a
Communicatie	o m u n i k a t i e
Compleho	i m p l e h o
Convention	o f e n t i o n 3
Creando	r e a n d o
Cubano	u b a
Dialogo	i a l o g o
Dogcatcher	o g i k a th~ a p 3 E r
Driemasterstraat	r i e m a S t E r s t r a t
Drs	r
Dunadornan	u n a d o r n a n
Duque	u kw~ i
Empleado	p l e a d o
Empresa	p r e s a
Esunnan	s u n n a n
Excellence	a l  m u S i n C i e
Franklin	r a n k l i n
Golfo	o l f o
Gomes	o 8 i m 3 s
Haseth	a s
Havenstraat	E b e s t r a t
Hogarnan	o g a r n a n
Holding	o l d i N
Hudicial	u d i k i a l
Huize	k i z e
Huridico	u r i d i k o
Instancianan	s t a n C i w a n a n
Integracion	t e b o ch~ i o n
Interes	t e r e
Interno	t E r n o
Iron	r o n
Japon	a p o n
Jessica	e s s i k a
Joaquin	o a k i n
Kawaiah	a w a i 3 h
Kennedy	3 n b
Kiwanistico	i w a n i S t  o
Koningin	q o n i N i n
Kranwinkel	r a n %
Lama	a m a
League	E w e a
Lid	s e i
Lion	i o n
Locura	o k u r a
London	d o n
Lorentzstraat	o r e n c s t r a t
Mahestad	m a h e s t a d
Mando	a n d o
Massive	n i i v E
Mesun	e s u n
Monseigneur	o* s e i N n i s u r
Monserat	o s 3 r a t r i
Moringa	u r i Ng~ a
Mucho	u C o
Nathaly	a th~ a l u k
Nature	a t u r e
Nest	e s t
Nota	o t a
Novel	o p e l
Oficialmente	f i i a l m e n t e
Openbare	p e n bh~ a r e
Ordenansa	r d e n a s a
Pabao	a b a o
Padu	a d u
Paloma	a l o m a
Parlamentonan	a r l a m e n t o n a n
Pasaheronan	a s a h e r o n a n
Peter	e t e r
Picanto	i k a nt~ o
Play	l a y
Politica	o l i t i k a
Porta	u r t e
Produccion	r o C u k i o n
Radisson	a d i s o*
Rampenbestrijding	a m p e n b e s t r e d i N
Recupera	e kw~ p e r a
Regis	g i s
Resiliente	e s i l i e n t e
Resorts	e s o r c
Reyes	e y e
Rhuggenaath	h u g g e n a u
Ritmo	i t m o
Roos	o s
Run	u n
Saladin	a l a d i n
Scoop	k o o p
Sexual	" u a l
Signs	i N n i
Siguientemente	i g i n t E m E n t e
Silva	i l a a
Smartphone	m a* r t f o n e
Snor	n o r
Society	T i e t
Staatsregeling	t a c r e  l i N
Stella	t e l a
Superfood	u p e r f o d
Titular	i t u l a r
Trupialen	n i n i a l e n
Turkia	u r k i a
Ultimamente	l t i m a m e n t e
Unidadnan	n i d a d n a n
Up	p
Vehiculo	e h i k u l o
Vis	i s
Webb	e b
Wiki	i k i
Wyatt	y a t
accesibilidad	a k k b i l i d a d
acercando	a C E r k a n d o
acta	a k t a
adaptando	a d a p t a n d o
admiracion	a d m i r a i o n
agradeci	a g r a d e k i
ahustacionnan	a h u s t a k i o n n a n
alcanza	a l k a n c a
alegra	a l e 7 r a
alergia	a l e r g i a
algu	a l g u
altezza	a l t e z c a
ampliamente	a m p l i a m e n t e
an	a n
asintomatico	a s i n t o m a t  o
asistente	a s i s t e n t e
astronomico	a s t r o n o m i  o
atrapa	a t r a p a
atribui	a t r i b u i
autoriza	a u t o r i c a
avancenan	m a v a n C E n a n
ayo	a y o
balanan	b a l a n a n
baldadi	b a l d a d i
balia	b a l i a
bankroet	b a n k r o e t
barrio	b a r o
behes	b e h e s
bestel	b e s t e l
bestuurskantoor	b e s t u r s k a n t o o r
bingo	b i Ng~ o
blaas	b l a
boternan	b o t E r n a n
bril	b r i l
buena	b u e n a
buraconan	b u r a k o n a n
cabuya	k a b u y a
canabis	k a n a b i s
cansancio	k i s a* i o
carchinan	k i r h i n a n
care	k a r e
catastrofe	k a t a s t r o f e
causante	k a u s a n t e
cayendo	k a y e n d o
cerando	C E r a n d o
certamen	C E r t a m e n
certidumbre	C E r t i d u mb~ r e
cine	T i n e
claim	k l a i m
clasificacion	k l a s  k a i o n
comestible	k o m e s t i b l e
complementa	k o m p l E m E n t a
composicion	k o m p o s i i o n
conferencianan	r o n f m i n C i w a n a n
conforma	r o n h m a
consequencia	r o n s k i n C i w a
consultanan	r o n r e p e n t a n a n
consumi	k o s u m i
contradictorio	r o n t r i w C i t o r i o
coordinadornan	k o r d i n a d o r n a n
cordialmente	k o r dy~ a l m e n t e
corolla	k o r o ly~ a
creditornan	k r e d i t o r n a n
criminalnan	k l i m i n a l
cuando	k u a n d o
cumpre	k u m p r e
curiculo	k u r i k u l o
dao	d a o
decisivo	d e 7 i s i b o
desaroyadornan	d e s e r o y a d o r n a n
desaroyando	d e s e r o y a n d o
diciplina	d i k i p l i n a
digitalizacion	d i g i t a l i n n d r o i o n
dimas	d i m a s
dinamismo	d i n a m i s m o
diputado	d i p u t a d o
dominio	b i n i o
drempel	d r e N p e l
economisa	e k o n o m i s a
ekivalente	e k i v a l e n t e
embarazo	e m b a l i m a l o
emisora	e m i s o r a
empeño	3 mp~ y u* k a* o
empleada	3 mp~ l e a d a
enfermo	e n f e r m o
entendimento	e n t e n d i m e n t o
escalacion	e s k a l a i o n
escohi	e s k o h i
escritor	e s k r i t o r
estadistica	e s t a d i s t i k a
estadisticanan	e s t a d i s t i k a n a n
eta	e t a
eventualidad	p i r 3 n t u a l i d a d
examennan	" a m e n
exigente	" i g 3 n t e
extranhero	" tr~ a h e r o
f	f
fayecidonan	f a y o j i d o n a n
figuranan	f i g u r a n a n
finalisacion	f i n a l i s a k i o n
fini	f i n i
flota	f l o t a
fotografianan	f o t o g r a f i a n a n
freezer	f h r e 8 e
fundador	f u n d a d o r
gedoogbeleid	g e d o gb~ e l e i d
genetico	g e n e t  o
gerente	g e r e n t e
graduacion	g r a d u a i o n
graduadonan	g r a d u a d o n a n
habla	h a b l a
hazaña	t r o n d r o 5 a
hospice	h o s p i k e
hungadornan	h u N a d o r n a n
iglesia	i g l e s i a
impactante	i m p a k t a n t e
incidentenan	m a i d e n t e n a n
indicador	i n d i k a d o r
infeccioso	i n f k i o s o
inhumano	L u
inhusticia	L u s t i i a
instiga	s t i g a
integrantenan	i n t e g r a n t e n a n
intensiva	i n t e n k u b a
kentel	k e nt~
kies	k i e
lachi	l a C i
landspakket	l a n d s l o k e t
larga	l a r g a
lid	l i d
malisimo	m a l i s i m o
maltratando	m a l tr~ a t a n d o
margen	m a* r g 3 n
mashinnan	S i n t i
mediador	m e dy~ a d o r
meer	m e e r
menasanan	m E n a s a n a n
menase	m E n a s e
miembrecia	m i e mb~ r E c i a
miya	m i y a
moda	m o d a
modo	m o t o
monumental	m o n u m e n t a l
motornan	m u t u r n a n
multanan	l t a n a n
nek	i k
nieto	n i e t o
nietonan	n i e t o n a n
night	n E i t
obstaculonan	o b s t a k u l o n a n
occasion	T k a s i o n
orador	o r a d o r
oral	o r a l
organizando	u r g a n i r o n d o
pagado	p a x a d o
parhanan	p a r a n a n
pasivo	p a s i b o
patronchi	p a t r o n C i h
pedofilia	p e 8 r o f u k a C i a
penoso	p e n o s o
planes	p l a y i n i
platonan	p l a y i t o n a n
populista	p o p u l i s t a
porvenir	p o r f e n i r
pre	p r e
preferiblemente	p r e f e r i b l E m E n t e
preisnan	p r e i s n a n
presidi	p r e s i d i
primeramente	p r i *  e n t e
project	p t o n o x e k s
protehe	p r o t e e
racha	r a C a
raportahe	r a p o r t a e
raro	r a r o
refresco	r e f r e s k o
remarka	r E m a r
restringi	r e s t r b i N i
risiconan	r i s i k o n a n
saconan	s a k o n a n
salo	s a l o
sangrando	s a n g r a n d o
sanitizers	s a n i t i r i ly~
sclama	s k l a m a
seca	e n i n
separadamente	s e p a r a d a m e n t e
setup	s e t u p
sinceridad	s i n z i r i d a d
skeiro	s k e i r o
specialismo	s p e k i a l i s m o
sponsornan	s p o Th~ o r n a n
sportage	s p o r t a j
steun	s t e u n
strobando	s t r o b a n d o
subidanan	s u b i d a n a n
sugerencianan	s u g e r e n C i w a n a n
suppose	s u p p o s e
tactica	t a k t i k a
talentonan	t a l e n t o n a n
tasnan	t a s n a n
teamnan	t e a m n a n
terapia	t e r a p i a
tercel	t e r
teror	t E r o r
terorismo	t E r o r i s m o
tesis	t e s i s
thru	t r u
tim	t i m
tirando	t i r a n d o
toets	t o e c
toezicht	t o e z i t
tracing	tr~ a c i N
trafica	tr~ a f i k a
transferencianan	i t r i s f m i n C i w a n a n
triunfo	t r e u n f o
tsunami	c u n a m i
tubo	t u b o
uit	u i
uitkering	k i t k e r i N
unanime	u n a n i m e
unilateral	u n i l a t e r a l
universidadnan	u n i v e r i d a d n a n
variante	v a r i a n t e
variedad	v a r i e d a d
virtualmente	v i r t u a l m e n t e
vitrina	v i t r i n a
voorzitter	v o L i t t e r
zodiacal	z o dy~ a k a l
zomaar	m a q 3 a r
zonanan	z o n a n a n
zoom	t a* N m
zwaailicht	z w a i l i t
Acto	k t o
Adriaan	d r i a
Africa	f r i k a
Agencia	g e n C i w a
Airbus	i r b u s
Alarma	l a r m a
Anochi	n o C i
Astrid	s t r i d
Aumento	u m e n t o
Award	w a r d
Aworo	w o r o
Ayo	r o x
Belasting	e l a s t i N
Bermudez	e r m u d e z
Biezen	i e z a n
Bolivar	o l i v a r
Boroncana	o r o n k a n a
Boto	o t o
Branch	r a n C
Carlo	a r l o
Casinonan	a s i n o n a n
Cayman	a i m a n
Centrum	e n t r u m
Chito	h i t o
Ciudadanonan	i u d a d a n o n a n
Company	p a n
Conclusion	n k l u z e o n
Conducta	d u k t a
Corporation	u r p o r a t i o n 3
Cuatro	u a t r o
Customer	u s t o m e r
Dance	5 u k a e
Davelaar	E b e l a r
Defensie	e f e ns~ i e
Deposit	a p o s i t
Dimas	i m a s
DirecTV	i r e k
Dunado	u n a d o
Elizabeth	l i r o t
Energia	n e r g i a
Enfermeria	n f s a y m 3 r i a
Enid	n i d
Entretanto	t r e t a n t o
Eseynan	s e y n a n
Facultad	a k u l t a d
Family	a m i l
Farro	a r o
Fatum	a t u m
Fijo	c o
Financiën	s a m i a n
Full	u l o
Fund	u n d
Gasoline	a s o l i n e
Generalmente	e n e r a l m e n t e
Gino	i n o
Gloria	l o r i a
Gold	o l
Gouverneur	o u e r S u r
Hand	a n d
Harms	a r m
Hassell	n i e l o
Hepple	a p p l e
Hofi	o f i
Hoge	o g e
Holiday	o l i d a y
Hot	o t
Hugo	u g o
Incluso	n u X a l u s o
Innovation	a n n o w a t i o n 3
Integrity	t e g r i t u s
Israel	s u r u
Jean	e
Jimenez	i m E n e z
Justicia	u s t i i a
Kamay	a m a
Katholiek	a th~ o l i e k
Kaya	a y a
Kayak	a y a k
Kooyman	o i m a n
Lantamento	a nt~ a e n t o
Leoncita	e o n C i w a
Loves	o p e
Luanne	u a n e
Luenne	u n e
Malesanan	a l e s a n a n
Maris	a r i s
Maritimo	a r i t i m o
Mavo	a b o
Meneer	i n i e r
Mesa	e s a
Millennials	i l l 3 n a d
Milo	i l o
MiniMega	i n i e g a
Mobile	o b i l e
Monica	q o n i k a
Monuments	n u m e n c
Nacion	a c i o n
Negoshi	e g o S
Newark	e w a r
Organisacionnan	r g a n i s a i o* n a n
Oriente	r i e n t e
Pan	a n
Papaya	a p a y a
Party	i t
Pashent	a S o
Passions	n i i o* s
Pier	i e r
Pieters	i e t e r
Pietersz	i e t e r
Poder	o d e r
Principalmente	r i n k i p a l m e n t e
Productonan	r o C u k t o n a n
Públiko	u b l i k o
Ranger	a N e r
Reglanan	g l a n a n
Representante	a p r e s e n t a n t e
Rescate	e s k a t e
Restaurantnan	e s t a u r a nt~ n a n
Retiro	e t i r o
Rina	i n a
Riu	i u
Roma	o m a
Roza	o y a 7
Samsung	a m s u N
Sanchez	5 u k u n C i
Sasaki	a s a k i
Seco	e k o
Shanayah	h a n a 8 a x a
Shariska	h a r i s k a
Softball	o f t b o l
Spearfishing	p e a r f i S i N
Sportsubsidie	p o r c u b i d i e
Star	t a r
Strategico	tr~ a t e g i k o
Suites	k i t e
Texas	" 3 s
Thornton	h o r n t o n
Timeshare	i S a r e
Utrecht	t r e t
Vallejo	a l j o
Virma	i r m a
Visitor	i s i t o r
Vivienda	i v i e n d a
Voetbal	o e t b a l
Welcome	e l k o m e
Wheels	h e l
William	i ly~ i a m
Wilmer	i l a m e
Wim	i m
Wingo	i Ng~ o
Yen	e n
Zeeland	e l a n d
aanwijzing	a n w i j 5
abierto	a b i e r t o
abusadornan	a b u s a d o r n a n
accionan	a k i o n a n
acomodacionnan	a k o m o d a i o* n a n
acontecimento	a k o n t e k i m e n t o
acostumbrado	a k o s t u mb~ r a d o
actornan	a k t o r n a n
adress	a d r e s
advertencianan	a d e r i a n a n
afilia	a f i l i a
afortuna	a h t u n a
afspraaknan	a f s p r a k n a n
alinea	a l i n e a
amante	a m a n t e
amargo	a m a r g o
amputacion	a m p u t a i o n
ana	a n a
anos	a n o s
aportando	a p o r t a n d o
appel	a p p e l
as	a s
aspira	a s p i r a
atraconan	a t r a k o n a n
aunque	a u n kw~ i
ausente	a u s e n t e
automatisacion	a u t o m a t i s a k i o n
aveo	E b e o
avioneta	a b i o n e t a
away	a w a y
ba	b a
bachi	b a C i
background	b a k k g r o u nd~
banana	b a n a n a
banki	b a n k i
bankinan	b a n u ly~ o
bilingual	b i l i N u a l
bocht	b o t
bondad	b o n d a d
bora	b o r a
boroto	b o r o t o
boton	b o t o n
brainstorming	b r a s t o r m i N
brake	b r a k e
briyante	b r i y a n t e
cabesantenan	k a b e s a n t e n a n
cadaver	k a d a v e r i
canasta	k a n a s t a
caotico	k a o t  o
caracteristica	k a r a k t E r i s t i k a
carnet	k a r n
cashier	k a s i e r
casinonan	k a s i n o n a n
cea	C E a
chikitonan	c " i k i t o n a n
circo	l r o
clarificacion	k l a r i f i k a i o n
clausula	k l a u s u l a
climatico	k l i m a t  o
codering	k o d i n i N
colaboradornan	k o l 3 b u a o r a d o r n a n
compacto	k o mp~ a k t o
comprendible	k o m p r e n d i b l e
condenabel	r o n d e n a b e l
conociendo	r o n o k i e n d o
conscientemente	r o n S e e n t E m E n t e
consehabel	r o n c e h a b e l
consequencianan	r o n s k i n C i w a n a n
contrincante	r o n t r i n k a n t e
convivencia	r o n v i v i n C i w a
cordial	k o r dy~ a l
coreccion	k o r e k i o n
corrupcion	k o r k i n i o n
costumbra	k o s t u mb~ r a
crypto	k cy~ p t o
cubico	k u b i k o
cuminzamento	k u m i n z a m e n t o
cumprado	k u m p r a d o
debilidad	d e b i l i d a d
decepciona	d e 7 e p i o n a
deliberando	d e l i b e r a n d o
desafionan	d e s a f i o n a n
desagradable	d e s a g r a d a b l e
desaprobacion	d e s a p r o b a i o n
desconocinan	d e s k o n o C i w
descubrimento	d e s k u b l i m e n t o
descuido	d e s k u i d o
desicionnan	d e s i i o* n a n
desk	d e s k
destructivo	d e s t r u k t i b o
deteriora	d e t e r i o r a
deterioro	d e t e r i o r o
dictadura	d i k t a d u r a
direcion	d i r E c i o n
distancing	d i s t a n C i i N
dobla	d o b l a k
du	d u
ecologico	e k o l o g i k o
emailadres	l e m a l i l a d r e
encuestion	e n kw~ e s t i o n 3
enfermera	e n f e r *
entiteit	e n t i t a i
essencial	e s  i n C i w a l
excepto	" u p t o
exepcion	" e p i o n
exihi	" i 7 i
experiencianan	" p e r i n C i w a n a n
expertisio	" p e r t i s i o
explicitamente	" p l i k i t a m e n t e
eyriba	e y r i b a
factibel	f a k t i b e l
fenomenal	f e n o m E n a l
flaco	f l a  o
frecuenta	f r e kw~ e nt~ a
fumiga	l i m i g a
furioso	f u r i o s o
fuseer	f u s E r e
grandioso	g r a nd~ i o s o
ham	h a m
hanchi	h a n C i
hardware	h a r d w a r e
holoshi	h o l o S
horcannan	h o r k a* n a n
hortamento	h o r t a m e n t o
hortando	h o r t a n d o
humamento	h u m a m e n t o
hungador	h u N a d o r
huramento	h u r a m e n t o
husga	h u s g a
hygiene	h i i e n e
ijs	g i y
impulsa	i m p u l s a
inaugural	i n a u g u r a l
incidental	m a i d e n t a l
insecticida	s e k 7 o t i k i d a
insistencia	s i s t i n C i w a
iregularidad	i r e g u l a r i d a d
jingle	h i N l e
judicial	x u d i k i a l
juf	x u f
juffrouwnan	x u f r o u w n a n
kabel	k a b e l
kantidat	k a n t i d a t
kens	k e n
kual	k u a l
lantando	l a n t a n d o
lapso	l a p s o
lastima	l a s t i m a
lease	l E s d e
leiding	L e i d i N
lesion	l e s i o n
libra	b r a
limpia	l i m p i a
links	l i n k
luchador	l u C a d o r
lunch	l u n C i
maligno	m a l i g n o
manehador	m a n e h a d o r
manifestante	n i f i S t a n t e
mano	n o
mantenimento	m a n t e n i m e n t o
marina	m a r i n a
masalmente	m a s a l m e n t e
mastanto	s t a n t o
materianan	m a t e r i a n a n
mediacion	m e dy~ a i o n
mediconan	m e d i k o n a n
mehorando	m e h o r a n d o
men	m e n
menasando	m E n a s a n d o
mescla	m e s k l a
misanan	m i s a n a n
molinanan	o l i n a n a n
mondkapjes	m o n d a  ph~ i
muestranan	m u e s t r a n a n
murayanan	m u r a y a n a n
new	n i a
news	n e 3
niester	n i e s t e r e n
nominado	n o m i n a d o
nucleo	n u k l e o
numeroso	n u m e r o s o
nutricion	n u i cy~ i o n
ocupantenan	o k u p a n t e n a n
ook	o k
open	o p e n
oponente	o p o n e n t e
oradornan	o r a d o r n a n
organisadornan	u r g a n i s a d o r n a n
pabo	p a b o
paradero	p a r a d e r o
payaso	p a y a s o
pedagogico	p E d a g o g i k o
peligernan	p e l i g E a n a n
penetracion	p e n e t r a i o n
pertenencia	p e r t e n i n C i w a
pesei	p e 7 e s
piscador	p i s k i s  o r
piscina	p i s k i s  i n a
planeando	p l a y i S a n d o
planning	p a nz~ n i N
ploeg	p l a l i o g
plussers	p l u s e r
pomp	p o m p
pornada	p o r n a d a
postkantoor	p o s t k a n t o o r
precis	p r E c i s
preocupacionan	p r e o k u p a k i o n a n
presonan	p r e s o n a n
privilegio	p r i v i l e g i o
probabilidad	p l o b a b i l i d a d
profesor	p r o f i S o r
professional	p r o f e s s i o n a l
program	p r o g r a m
protega	p r o t e g a
provincia	p r o v i n C i w a
rasonnan	r a s o n n a n
ratifica	r a ty~  k a
rebiba	r e  b a
recept	r E C E p E
refuerso	r E pw~ e r s o
refugiadonan	r e f u g w a d o n a n
rehabilitacion	r e h a b i l i t a i o n
republica	r e p u b l i k a
resistente	r e s i s t e n t e
respiracion	r e s p i r a i o n
respuesta	r e s p u e s t a
reunionan	r e u n i o n a n
ridiculo	r i d i k u l o
riesga	e s g a
rifnan	r i b u Ng~ n a n
rijnan	r u t i
risibí	s i b i
roga	r o g a
romantico	r o m a n t i k o
ronda	r o n d a
rondo	r o n d o
rumornan	r u m o r n a n
salarial	s a l a r i a l
salon	s a l o n
satisfactorio	s a t i s f a k t o r i o
scuchando	s k u C a n d o
secrecia	s e k r E c i a
secura	s e k u r a
seguramente	s e g u r a m e n t e
servisio	s e r i s i o
shift	S i f
siguramente	s i g u r a m e n t e
simbolonan	s i m b o l o n a n
simultaneamente	S i m u l t a n e a m e n t e
sinceramente	s i n u r a m e n t e
site	s i t e
situation	s i t u a t i o n 3
sobrepeso	s o b r e p e s o
solicitante	s o l i k i t a n t e
sostenedornan	s o s t e n e d o r n a n
soña	s w a
spiritual	s p i r i t u s a l
sport	s p o r
spula	s p u l a
stacion	s t a k i o n
sterilisa	S t E r i l i s a
store	s t o r e
strategianan	s t r a t e g i a n a n
structuralmente	s t r u k t u r a l m e n t e
substancianan	s u b s t a n C i w a n a n
talves	t a l e
tardanza	t a r d a n c a
tembla	t e mb~ l a
timeshare	t i S a r e
tombola	t o mb~ o l a
traicion	tr~ a w C i w r o n
tratamentonan	tr~ a t a m e n t o n a n
triage	t r i a g e
tumba	t u* b E
tume	t u
unidat	u n i d a t
upgrade	u p b o ch~ d e
ventilacion	f e n t i l a i o n
verboden	e r b o d e n
versus	e r u s
vet	f e d
vice	v i k e
voucher	v o u C e r
werksternan	w e r k S t E r n a n
wèpsait	wa  p s a i t
ziek	z i e k
zundra	z u n d r a
