a da mek	a d a m e k
a farin	a f a r i n
a hen ina iself	m a h e n i n a a s l 3 f
a konchri	a k o n C r i
a wa mek	a w a m e k
a yaad	a y a
aaba	a b a
aad	k i m a t o
aad fi	k i m a t o f i
aad iez	a d i e z
aadiens	k i m a t o
aaf	a f
aafwe chrii	a i f e th~ C r i
aagan	a g a n
aaganizieshan	a g a n i  e S a n
aaganizm	a g a n i z m
aagas	a G a s
aagiment	a s i k e h
aajentiina	a x e n t i ly~ o
aakid	a k i d
aal	a l
aal a dem	u l i  b
aal di taim	a l d i t a 7 i
aalmuos	a l o s
aalwiez	a l w i e z
aarait	a r a i t
aaredi	a r e d i
aas	a
aas-riesin	a s o 7 e s i n
aat	a t
aata	a t a
aatagrafi	a t a g r a f i
aatiek	a t i e k
aatis	a t i s
aawez	a e z i
aazwiez	a l % e z
ab	a b "
abee	a b " a
abraad	a b " r a
achrakshan	a C r a k S a n
achribyut	a C b y u t
ada	a d a
adaels	a d a e l
adaels ieria	a d a e l s i e r i a
adawaiz	a d a w a i z
adminischrietiv	a d m i n i S r i e t i
advokiet	a d v o k i e t
afrika	a f r i k a
afta	a f t a
agen	a g 3 n
agrikolcha	y r i k o l C a
agrikolcharal	y r i k o l C a r a l
agyu	y 3 u
agyu se	y u s e
ahn	a h n
ai	a i
ai skuul	a s k u r  u l
aida	a i d a
aidentifai	a i d e n t i f a i
aidentifai az	a i d e n t i f a a z
aidentifai wid	a i d e n t i f a w i d
aidentiti	a i d e n t i t i
aidie	a i d i e
aigl	i g
aijrosfier	i j r o s f i e r
ail	i t
ailan	i l a n
ailant	i l a n t i
airilan	a i r i l a n
airish	a i r i S
airish pitieta	a i r i S p i t i e t a
ais	i s
aiskriim	a i s k r i m
aisoliet	a i s o l i e t
ait	a i t
aiyan	a 7 i a n
aizak	i z a k
ajres	e r e
aki	a k i
aki ahn saalfish	a k i a h sh~ 3 a l f i S
akliem	a k l i e m
aknalij	a k n a l i
akraas	a k r a e i 7 i
aktivis	a k t v i s
aktuoba	a k t u o b a
ala	a l a
alaiv	a l a i
alayans	a l a y a n
alduo	a l d u o
aligeta	a l i g e t a
aligeta pier	a l i g 3 t a p i e r
aligzanda	a l i g u k a n d a
aliv	a l i
amfisbiinyan	a m a  i 5 a n
amtan	a m d a n
an	a n
ana	a n a
anarebl	a n a r e b l
anda	a n d a
andastan	a n s t a n
aneda	a n e d a
anju	a n j u
anlain	a n l a i n
anles	a n l e
anmigl	a n m i g
ansa	s a
ansofistikietid	a n  i s t i k i e t i d
antiiga ahn baabyuuda	a n t i t u hn~ b a b y u d a
anuova	a n u o v a
anuova parish	a n u o w a d a n i S
apaat	a p a t
apaint	a p a i nt~
api	a p i
apier	a p i e r
apl	a p
aplai	a p l a y i n
apm	a p m
aprishiet	a p r i S i e t
apruoch	a p r u o
apruuv	a p r u
ar	a r
ar els	a r e l
aredi	a r e d i
arinj	a r i
asaalt	a s a a l t a s
aschranami	a s C r a n a m i
aschranomi	a s C r a n o m i
aschrielia	a s C r i e l i a
askaadn	a s k a d n
askaadn tu	a s k a d nt~ u
aspital	a s p i t a l
atlantik uoshan	a t l a n t i k u o S a n
atletix	a t l e t iT
atmosfier	a t n o S f i e r
aul	a u l
avielobl	a g o y e l o b l
ax	a X
axep	a x 3 p
axtiel	a x
aya	a y a
azwel	a z w e l
baaba	b a b a
baabiedoz	b a b i e d o
baagin	b a g i n
baal	b a l
baan	b a n
baara	b a r a
baas	b a
baaskitbaal	b a s k a m b a l
baat	b a t
baazli	b a r L i
bad	b a d
bada	b a d a
badarieshan	b a d a r i e S a n
badi	b a d i
badman	b a d m a n
bai	b a i
baik	b a i k
bailoji	b a i l o h i
bait	b a i t
baka bush	b a k a S
bakbuon	b a k o n
bakl	b a q
bami	b a m i
ban	b a n
banaana	b a n a a n a
baptis	b a p t i s
batam	b a t a m
batn	b a t n
baul	b a u l
bax	b a r
baxin	b a x i n
baya	b a y a
bayagrafi	b a y a g r a f i
bayosfier	b a y o s f i e r
beg yu	b e x y a u
bekaa	b e k a
bel	b e l
beli	b e l i
ben	b e n
bex	b E 7
bie	b i e
biebi	b i e b i
bied	b i e d
biefies	b i e f i e
biej	b i e h
biek	b i e k
bier	b i e r
bies	s o s
bies pahn	b i e s p a h n
biesik	b i e k u
biesin	b i e s i n
biev	b i e v
bifuo	b i f u o
bifuor	b i f u o r i
bifuotaim	b i f w o t a i m
bifuotaim piipl	b i f w o t a i m p i i p
bigop	b i g o p
biif	b i i f i
biini	b i i n i
bikaazn	b i k a l n
bil	b i l
bil pahn	b i l p a h n
bilang	b i l a N
biyain	b i y a i n
bizniz	b i z n i z
blai	b l a i
blak	b l a k
blak pepa	b l o k e t e p a
blak riva	b l a k r e
blingki	b l i N k i
bluu	b l u
bod	b o d
bokl	b o k
bon	b o n
bongjri	b o N r i
bongx	b o N 7
bot	b o t
bota	b o t a
botn	b o t u n
bou	b o u
bout	b o u t
braad	b r a
braatopsi	b r a a t o p s i
brazil	b r a z i l
bred	o*
breda	b r e d a
bredfruut	o*  f r u r e t
brejrin	o*  r i n
briekop	b r i e k o p
briev	b r i
bring tigeda	b r i N t i g 3 d a 7
bringgl	b r i N u
britn	b r e n
brok	b r o k
broun	b r o u n
bruus	b r u u s
buk	b u k
bulfraag	l f r a a g
buod	b u o d
buod a chostii	b u o d a C o s t i
buodn skuul	b u b i r  u l
buot	b u o t o
buut	b u r e t
bwai	a i
bwai pikni	a i p i k n i
bwail	a i l
byuuti	b z u t i
chaaj	C a
chaaklit	C a k l i t
chaaklit chrii	C a k l i C r i
chaali	C a l i
chaina	C a i n a
chais	C a i s
chaka-chaka	a q u C a k a
chat	C a t
cheri	C e r i
ches	C e
chichi	C i C i
chienj	C i e
chiiz	C i
chikin	c " i k i n
cho	C o
chobl	C o b l
choch	C o
chokcha	C o q C a
chos	C o s
chostii	C o s t i
chrabl	C r a b l
chradishan	C r a d i S a n
chrai	T r a i
chrai fi	C r a i f i
chrajidi	C a h i d i
chrang	C r a N
chranzfaam	C r a nz~ y a m
chranzishan	C r a n z i S a n
chranzishan piiriad	C r a n a m o m a i r i a d
chranznashinal	C r a nz~ n a S i N n E a l
chrap	C r a p
chrapik	C r a
chrapikal	C r a  k a l
chrech	C r E C
chrecha	C r e C a
chrent	C r e n t
chretn	C r e t n
chried	C ry~ 3 d
chrien	C r i e n
chrienin	C r i n i n
chrienja	C r i n j a
chriet	C r i e t
chrii	C r i
chriit	C ry~ i t
chriiti	C r i t i
chrik	C i
chrikifai	C r i k i f i a i
chrilaani	C r i l a n i
chrinidad ahn tubiego	C r i n i d a d a h n t u b i e g o
chrompit	C p i t
chruu	C u k
chuocho	C o T o
chuochuo	C o o C o
chupid	C o p i d
chuu	C o u
chuu-chuu	C o a C u
chuuhout	C o u h o u t
chuun	C o n d 3
chuut	C o u t
chuuz	C o u
daa	d a
daag	d a a g
daans	d a n
daata	d a a t a
dailuut	d a i l u r e t
dainasuor	d a i N a s u o r i
dairek	d a i r e k
dala	d a l a
daminiika	d a m i n i i k a
daminikan ripoblik	d a m i n i k a r i p o b l a i k
danal	d a n a l
dangki	d a N k i
darati	d a r a t
dash	d a S
dash awie	d a S a w i e
dashiin	d a S i N i n
dat	d a t
dat a chuu	d a t a C u
dat-de	d a t 7 d e
dayalek	d a y a a r a
dayaspora	d a y a x a s p o r a
dayatishan	d a y a x a t i S a n
de	d e
debl	d e b l
ded	d e d
definishan	d e f i n i S a n
dehn	d e h n
dehn kaali	d e h Nk~ a l i
dekied	d e k i e d
dem	d E* m
dem-de	d e u S i n d e
dem-ya	d e m y a
demakrasi	d e m a k r a s i
dep	d e p
derik	d e r i k
deso	d e s o
dezat	d e z a t
di	d i
di grietis	d i g i r i e t i s
di muos	d i m u o s
di piiplz ripoblik a chaina	d i p i p l a n z r i p o b l k a C a i n a
di uol a dem	d i u o l a b
di wes indiiz	d i w e s i n d i
dibiet	d i b i e t
die	d i e
dieli	d i e l i
dievid	d i w v i d
difiit	d i f u i t
difikolti	d i f i k o l t i
difrahn	d i f r a h n
difrans	d i f p a p a
digrii	d i g i r i
diil	d i i l
diil wid	d i l w i d
diklier	d i k l i e r
diktieta	d i k t e t a
diktietaship	d i k t e t a S i N p
dimokratizieshan	d i m o k r a t i  e S a n
dipaacha	d i p a C a
dipen	d i p e n
dipen pan	d i p e n p a n
dis	d i s
dis-ya	d i s y a
disaid	d i s e i
disaya	d i s a y a
dischribyuushan	d i S b y u S a n
disemba	d i s e m b a k
disendant	d i s e z i
disepshos	d i s e p C o s
disgostid	d i s g o s t i d
diskovri bie	d i s k o p b i e
distingshan	d i s t i N S a n
ditiel	d i
divaid	d i v a i d
dizain	d i c~ 3 n
dizain fi	d i z a i N f i
dizort	d i z o r
domestikieshan	b k 3 n C i  e S a n
domplin	b p l i n
dong	d o N
dopi	d o p i
dos	d o s
doti	d o t i
doti op	d o t i o p
dout	t o u t
drop a grong	d r o p a g r o N
dukunu	d u k u n u
duo	d u o
duohn	d u o h E 5
duor	d u o r i
dwiit	d w i i t
dyuu	d y u
ebi	e b i
ebi die	e  dy~ e
ebn	e b n
ebri	e b r i
ebribadi	e b l e d a d i
ebriting	e b r i t i N
ed a stiet	e d a s t i 3
edikieshan	e d i k i e S a n
edita	e d i t a
edwad	e d w a d
ef	i f
egvaantij	g v a a n t i
egzakli	g z a k l i
egzamin	g z a m i n
egzampl	g z a m
egzis	g L
eliat	e l i a t
eliment	e l i m E n t
elivieta	e l i v i e t a
elp	e l p
elswe	e l s w e
en	e n
enaji	e n a h i
eni	e n i
enibadi	b a d i
eniebl	e b l
enitaim	e n i t a 7 i
eniwiez	w i e z
entapraiz	e n t a p r a i z
eritij	r i t i
esn	e s n
evidens	p i r i d e n
evri	p i r r i
exchienj	e S
exchriim	e S r i m
exepshan	" e p S a n
exkiep	" N 3 p
exkluudn	" k u d n
expanshan	" p a n S a n
expiriens	" p i r i n
expuot	" k o t o
extablish	e S a b l i S
extingk	e S i N
faada	f a a d a
faal	f a l
faal dong	f a l d o N
faal ina lob	f a l i n a l o b
faam	f a a m
faama	f a m a
faamat	f a m a t
faar	f a r a
faas	f a
faatifikieshan	f a b o t i f i k i e S a n
fagivnis	f a g i v n i s
faib	f a
fain	f a m
fainal	f a i n a l
faiya	f a y a
faiya bon	f E i y a b o n
faiyaman	f E i y a m a n
fak	f a k
fala	f a l a
falara	f a l a r a
falarin	f a l a r i n
falmot	f a l m o t
fambli	f a m b l i
farin	f a r i n
farina	f a r i n a
fasilitiet	f a s i l i t i e t
faya	f a y a
febiweri	f e  w e r i
feda	f e d a
feminis	f a m i n i s
feminizim	f a m i n i s i m a
fene	f e n e
fens	f e n
fi	f i
fi chuu	f i T u
fi mi	f i m i
fi paapos	f i p a a p o s
fi touzn a ier	f i t o u  n a i e r
fiemos	f i e m o s
fies	f i e
fiesti	f i e s t i
fiet	f i e t
fieva	f i e v a
fif	f i f
fiftiin	f i b u Ng~
figa	f i g a
figat	f i g a t
fiicha	f i C a
fiil	f u i l
fiimiel	f i m i e l
fiiva	f u i v a
fikshan	f i k S a n
filasafi	b i l a s a f i
filipiinz	b i l i p i N
finaminan	f i n a m i n a n
finanshal	f i n a n C a l
fingga	f i N g a
fingga-hed	f i N u u x 3 d
fiziolaji	f i L o l a h i
fizishan	f i z i S a n
fizix	f i  S
flai	f l a i
flieva	f l i e v a
flim	f l i m
flod	f l o d
flowa	f l o w a
fluor	f l u o r i
fongkshan	f o N k S a n
foris	f o r i s
form	f o r m
fos	f o s
foul	f o u l
fraag	f r a a g
frahn	f r a h n
frai	f r a i
frai domplin	f r a i d o m p l i n
frai plaan	f r a i p l a y i
fraitn	f r a i t n
frans	f p a p a
frenship	f r S i p
fruut	f r u r e t
fruut juus	f u k ty~ u s
fufu	f u w u
ful	f u l
fuo	f u o
fuokos	f w o k o s
fuos	f w o s
fuot	f w o t
fuotiin	f u a
fut	f u t
futbaal	f u t b a l
fuud	f u u d
fyuil	fy~ u i l
fyuu	f y u
galang	g a l a N
gens	g e n
get apaint	g 3 t a p a i nt~
get bex	g e t b e 7
get hextingk	g e t h e S i N
gien	g i e n
giet	g i e t
ginep	g i n 3 p
gluobal	g l u u b a l
go a farin	g o a f a r i n
gobna	g o b n a
gobna-jinaral	g o b j i n a r a l
goli	k o r i
golibl	g o l i b l
gon	g o n
govament	g o b a m E n t
graasapa	b o ch~ a s a p a
grampierans	b o ch~ f u k a p a p a
griep	g r i 3 p
griet	g r i e t
grietis	g r i e t i s
grii	g r i
grii pahn	g r i p a t o* S n
grii se	g r i s e
griin	g r i i n
griis	g r i s
grinieda	g r i e d a
grong	g r o N
gruo	g r u w o
gruot	g r u o t o
gud	g u d
gudz	g u d
gunggu	g u N g u
gunggu piiz	g u N u p i
guol	g u o l
guot	g u o t o
guzu	g u z u
gwaava	gw~ a v a
gwan	gw~ a n
gyaad	gy~ a
gyaadn	gy~ a y n
gyaalik	gy~ a l i k
gyada	gy~ a d a
gyadarin	gy~ a d a r i n
gyal	gy~ a l
gyal pikni	gy~ a l p i k n i
gyas	gy~ 3 s
haakiek	h a k i e k
haalzwie	h a l z v i
haatagrafi	h a t a g r a f i
haatikl	h a t i k
haatis	h a t i s
habrij	h a b r i
habvios	h a b i o s
hada	x a d a
hadap	h a d a p
hadvenchara	h a Z f e n C a r a
hafi	a f i
haid	h a i d
hairish	h a i r i S
hairish pitieta	h a i r i S p i t i e t a
hambrela	h a mb~ r e l a
hanalisis	h a n a l i s i s
hanimal	h a n i m a l
harijin	h a r i j i n
hat	h a t
hatityuud	h a t i t z u d
haxent	h a
haxesobl	h a e s o b l
haxpek	h a p e k
hayan	h a y a n
hayan-mekin	h a y a n m e k i N
haz	h a z
hebini	h E b 3 n i l
hebm	b a s m
hedituoryal	h e d i t u o cy~ a l
heg	h 3
hels	h e l
hen	h e n
hen a	h e n a
heni	h e n i
heni a	h e n i a
heni a di abov	h e n i a d i u C i m
heniting	h e n i t i N
heniting hels	h e n i t i N h e l
hexpand	h e S p a n d
hexplien	h e S p l i e n
hexpreshan	h e S p r e S a n
hexten	h e S
hextingk	h e S i N
hidyam	h i d y a* b i*
hieja	hy~ e h a i
hiem	hy~ e m
hiet	hy~ e t
hietiin	hy~ e
hifek	h i f
higla	h i x l a
hiit	h i i t
hiiz	h i
hilekchranik	h i l e k C r a n i k
hilekchranik komiunikieshan	h i l e k C r a n i kw~ k o m i u n i k i e S a n
himpres	h i m p r e
hinchradokshan	h i n C r a d o k S a n
hinchrajuus	h i n C a h u u s
hinchres	h i n C r e
hinfluens	h i n f m b u g
hingglish	h i N L i S
hinishal	h i n i S a l
hinkluudn	h i n k u d n
hintanashinal	h i n t a n a S i N n E a l
hintanashinal chrabl	h i n t a n a s i n a l C r a b l
hofishal	h o f i S a l
hofishal langwij	h o f i S a ly~ a Nw~ i
honggl	h o N u
honggri	h o N g r i
honyan	h o e
hopin-en	h o p i m b a e n
horbanizieshan	h o r b a n i  e S a n
hori	h o r i
hori op	h o r i o p
horli	h o r l i
howa	h o w a
hox	h o 7
huobaluk	h u a b a l u k a 7
huol	h u a l
huol-taima	h u a l a a i m a
huoliip	h u o l i
huoral	h u a r a l
huoral langwij	h u a r a ly~ a Nw~ i
huovn	h u a v n
ie	i e
iebl	i e b l
ieda	i e d a
iej	i e h
iejobl	i e h o b l
iemi	i e m i
ienshent	S e n t
iepril	i e p r i l
ier	i e r
ieria	i e r i a
ies	i e
iet	i e t
ieti	i e t i
ietiin	i e
iez	i e z
iezha	i e Z a
ifainali	f E i n a l i
ifek	f e k
igwaana	i Nw~ a X a n a
ihn	i h n
iibm	i b m
iibn	i b n
iihn	i n
iijip	i d i j p
iikwal	i k w a l
iip	i
iir	u i a
iis	i s
iistan	i s t a n
iit	i
iit aaf	i t a f
iivn	i Ng~ e n
iivnin	i Ng~ e n i n
ikanami	i k a n a m i
ikanamik	i k a n a m i k
ikanamix	i k a n a m i S
ilek	i l a
iloschrieshan	i l o S r i S a n
im	i m
impak	i m p a k
impruuv	i m p r u
impuotant	i m p u a k i
imuoshan	i m u o S a n
in fak	i n f a k
ina	i n a
ina di faam a	i n a d i f a b o m a
ina di wol	i n a d i w o l
inaamos	i n a m o s
inabit	i n a b i t
indipendans	i n d i p e n d a
indischroktebl	i n d i S r o k t e b l
indoschri	i d o S r i
indoschrial	i d o S ry~ a l
indoschrializieshan	i d o S ry~ a l i  e S a n
infamieshan	i n f a m i a S a n
influens	i n f m b u g
inggiej	i N g i e h
ingglan	i N u c
ingkluudn	i N k u d n
ingkorij	i N k o r i
iniebl	i n i e b l
injai	y i n j a i
injinierin	y i n j i i n i n
inkluud	m  u d
inkriis	m ry~ i s
inruol	i n r u o l
insaiklopiidya	s e i k o p i  a
inspaya	s p a y a
intaikl	i n t a i k
intanashinal	i n t a n a S i N n E a l
intanet	i n t a n e t
intatiena	i n t a t i e n a
invalv	i n v a l v
inviejan	i n v i e y a n
ischri	i S r i
ishu	i S u k
istuorian	i s t u o r i a n
it	i t
itali	i t a l i
ivalv	i v a l v
ivenchuali	i v e n ch~ u a l i
ivent	Ng~ e r e a 5 a
jaagrafi	y a a g r a f i
jaagrofi	y a a g r o f i
jaaj	y a
jaaloji	y a l o h i
jain	y a i n
jainop	y a i n o p
jakfruut	k f r u r e t
jaloji	y a l o h i
jan	y a n
jangkro	y a Ng~ k r o
janiweri	h a n i w e r i
japan	y a p a n
jeli	j e l i
jeliduo	j e l i d u o
jiel	x e l
jiemz	h i e m
jien	h i e n
jinaral	j i n a r a l
jinarasiti	j i n a d a C e
jinarieshan	j i n a r i e S a n
jinja	j i n j a
joj	j o x
jomp	j o m p
jomp-up	j o m p 7 u p
jonjo	j o n c o
jork	c u k u
jork chikin	c u k u k C i k i n
jork puok	c u k u kp~ w o k i
jork siiznin	c u k u k s i z n i n
jork spais	c u k u k s p a i s
jormani	j o r m a n i
jornal	c u k u n a l
jostis	j o s t i s
jraa	h r a
jraadong	h r a a d o N
jraaf	h r a a f
jraafut	h r a a f u t
jraaz	h r a
jragan	h r a g a n
jrai	h r a i
jramatik	h r a m a t i k
jrap	h r a p
jred	r e d
jres	r e
jresbak	r e s b a k
jresdong	r e s d o N
jriepop	h r i e p o p
jringk	h r i N
jrog	h u
jrom	h l o m
juk	x u k
juki-juki	y u k i 7 h u k i
julai	x u l a i
jumieka	x u m i e k a
jumieka lieba paati	x u m i e k a l i e b a p a t i
jumieka taak	x u m i e k a t a k
junjo	C i x u n c o
juo	x u o
juok	w o k i
juu tu	x u u t u
juun	x u n
juun plom	x u n p l o m
juurin	x u r i n
juus	x u u s
kaa	k a
kaal	k a l
kaan	k a n
kaanful	k a f u l
kaanwal kounti	k a a l k o u n t i
kaaz	k a z
kaazn	k a z n
kach banit pepa	k a C b a n i t p e p a
kain	a s
kait	k a i t
kak	m a k o u
kala	k a l a
kalalu	k a l a l u
kalani	k a l a n i
kalanis	k a l a n i s
kalek	k a r a
kalekshan	k a l e k S a n
kalij	k a l i
kaman	k a m a n
kaman yuusij	k a m a n y u s i
kamedi	k a m E d i
kanchosnis	k a n C o s n i s
kanchrak	k a n C r a
kanchuol	k a n ch~ u o l
kanekshan	k a n i k u S a n
kanschrokshan	k a S r o k S a n
kansda	k a s d a 7
kantent	k a n t e n t
kantinyu	k a n t i n y u
kanvasieshan	k a n b E s i b e S a n
karambuola	k a r a m b u o l a
kasaada	k a s e a d a
kasaava	k a s a v a
kasta riika	k a s t a r i i k a
katn	k a t n
katn chrii	k a t n C r i
kazmopalitan	k a Z m o p a l i t a n
kech	k e 5
kech di riek	k e 5 d i r i k
kechop	k e C o p
kelyan	k E l y a n
kenet	k e n e t
kianada	k i a n a d a
kiaribiyan	k i a r i b i a n
kidni biin	k i d n i b i i n
kiedens	k i e d e n
kieful	k i e f u l
kiek	k i e k
kien	k i e n
kies	k i e
kiet	k i e t
kilomita	k i l o m i t a
kimischri	k i m i S r i
kin	k i n
kindom	k i d o m
kinston	k i n a t o*
kisaada	k i s a y a
klaat	k l a t
klaax tong	k l o a x t o N
klarindan	k l a r i d a n
klasikal	k l o i k a l
klie	k l i e
klie pat	k l i e p
kliem	k l i e m
klier	k l i e r
kliermont	k l i e r m o n t a 5 a
klifod	k l i f o d
kliin	k l i i n
kola	k o l a n e
kolcha	k o l C a
kom	k o m
kom iin laka	k o m e N w E n d l a k a
kom ya	m i y a
komiunikieshan	k o m i u n i k i e S a n
kompail	m i p a i l
kompyuuta	m i p z u t a
kompyuuta manita	m i p z u t a m a n i t a
konchri	q o n i k C r i
kongk	k o N
koni	q l o l
korant	k o r a nt~
kori guot	k o r i g u o t o
koril	k o r i l
korl	k o r
kos	k o s
koskos	k o s Z i
kostad apl	k o s t a d a p
kot	k o t
kot patwa	k o t p a t w a
kot yai	k o T a i
kotlis	k o L i s
kou	k o u
kounti	k o u n t i
kowich	k o w i C
kozn	7 o y n
kraani	k r a n i
kraitiirya	k r a i t i r y a
krap	k r a p
krichoul	k r i C o u l
kriebn	k r i e b n
kriep	k r i 3 p
kriet	k r i e t
krietiv	k r i e t i
krietiv raitn	k r i e t i b r a i t n
kriim	k r i m
krikit	k r i k i t
kris	k r i s
kritikal akliem	k r i t i k a l a k l i e m
ku	k u
kudn	k u d n
kuk	k u k
kukumba	k u sw~ i
kunu	k u n u
kuoknat	k u o k n a t
kuoknat chrii	k u o k n a t C r i
kuoknat milk	k u o k n a t m a l k
kuoknat waata	k u o k n a t w a a t a
kuoko	k u o k o
kuol	k u o l
kuos	k u o s
kuot	k u o t o
kuul	k u
kwaadinet	k w a i w
kwaat	k w
kwait	k w a i t
kwaiyat	k w a i y a t
kwestiyan	kw~ e s t i a n
kwiin	kw~ i i n
kwik	kw~ i k
kwik-taim	kw~ i a a i m
kwint	kw~ i nt~
kyaa	ky~ a
kyaahn	ky~ a h n
kyaar	ky~ a r
kyaarat	ky~ a r a t
kyabij	ky~ a b i
kyahn	ky~ a h n
kyaklik	ky~ a k l i k
kyamil	t ky~ a m i l
kyanal	ky~ a n a l
kyanggl	ky~ a N u
kyangkro	ky~ a N k r o
kyapasiti	ky~ a p a s i t i
kyapcha	ky~ a p C a
kyapital	ky~ a p i t a l
kyapitalis	ky~ a p i t a l i s
kyaptin	ky~ a p t i n
kyar	ky~ a r
kyarakta	ky~ a r a k t a
kyari	ky~ a r i
kyash	ky~ a S
kyash krap	ky~ a S i k r a p
kyashu	ky~ a s u
kyata	ky~ a t a
kyatalis	ky~ a t a l i s
kyatigari	ky~ a t i g a r i
kyuuba	k z u b a
laa	l a
laaf	l a a f
laaj	l a
laan	l a N
labsta	l a b s t a
lai	l a i
laibri	l a i b r i
laif	l a i f
laifstail	l a i f s t a i l
laik	l a i k
lait	l a i t
laitous	l a i t o u s
laiyad	l a i y a d
laiyan	l a i a n
laka	l a k a
laka se	l a k a s e
lam	l a m
lan	l a n
landan	l a n d a n
lang	l a N
langwij	l a N w i
larans	l a p a p a
layad	l a y a d
lebl	l e b l
lebm	l e b m
leda	l e d a
lef	l E f
lego	l E g o
lego biis	l E g o b i s
lejislieta	j i w i e t a
lent	l E n t
leta	l e t a
lib a farin	b a f a r i n
libn	b n
libn langwij	b nz~ i Nw~ i
lichicha	l i T i T a
lieba	l i e b a
liedi	l i e d i
liet	l i e t
lieta	l i e t a
lieya	l i e y a
lifop	l i f o p
liida	l i n d a y
liig	l i g
liin	l i i n
lik	l i k
likl	l i k
likl muos	l i k l o s
lili	l i l i
lingguistik	l i N g i s t i k
linggwis	l i N gw~ i s
lis	l i s
lis a	l i s a
lisn	l i s n
litosfier	t o s f i e r
lizad	l i z a d
lob	l o b
long	l o N
lorn	l o r n
lou	l o u
luk	l u k
luo	l u o
luokal	l u r a
luokalaiz	l u r a  i z
luokiet	l u o k i e t
luokiet ina	l u o k i e t i n a
luokiet nier	l u o k i e t n i e r
luusi	l u s i
luwi	l u 3 s
luwiiz	l u 3 s  i z
maach	m a
maaga	m a g a
maak	m a k
maakit	m a k i t
maakos	m a k o s
maanin	m a n i n
mada	m a d a
mada-tong	d a a o N
madan	d a n
madifai	m a d i f a i
madifikieshan	m a d i f i k i e S a n
magaziin	a z i n
magij	m a g i j e
magl	m a h
maigrieshan	m a i g r i S a n
maikal	m a i k a l
main	m a i n
mait	m a i t
maitbi	m a i t b i
majariti	C i i t i
man	m a n t a
manatii	m a n a t i
manazebl	m a n a z e b l
manchesta	n C i h e s t a
mandivl	m a n d i v
manggo	m a N g o
mangguus	m a N u u s
manita	n i t a
mantiga bie	m a n t i g a b i e
manyufakcha	m a n y u f a k C a
manyufakcharin	m a n y u f a k C a r i n
maruun tong	m a r u n t o N
mas	m a s
mas komiunikieshan	s k o m i u n i k i e S a n
mashet	m a S o
mashiin	S i i n
mashiin tuul	S i i t u
mashiinri	S i r i
matiirialis	m a t i i r i a l i s
matimatix	m a t i m a t iT
matyu	m a t u s
medisn	m e d i s n
meditieshan	m e d i t i e S a n
meja	m e h a i
mejament	m e c e n t
mek	k
mekop	m e k o p
memba	m e m b a k
mexiko	m e S i k o
mi	m i
midiom	d i o m
midya	d y a
mie	m i e
mie pen	m i e p e n
miebi	m i e b i
mieja	m i e h a i
mien	m i e n
mienli	l i
mieri	m i e r i
migl	m i g
migl iis	m i g l i s
migl-klaas	m i L k l a
miglsex kounti	m i L s " k o u n t i
miin	m e N w E n d
miinin	m e N w E n d i n
miit	m e N w E
miita	m e N w E t a
miizolek	m e N w E z o r a
milichri	m i l i C r i
miliyan	m i l i a n
mimuorial	m i m u o r i a l
minista	m i n i S th~ a
mishaneri	m a S a S a n e r i
misnuoma	m i s n u o m a
mixcha	m i S a
mixcho	m i S o
mobie	m o b i e
mongx	o Ng~ 7
moni	m o n i
morant bie	m o r a nt~ b i e
mountn	m o N t n
mout	% m a u t
muo	mw~ a
muo dahn	m u o d a h n
muobail	m u o b a i l
muor	m u o r i
muos	m u o s
muosli	mw~ a s l i
muotaim	l u N mw~ a n t a i m
muuv	m u
muuv frahn	m u  f r a h n
muuv gaa	m u  g a
myuuzik	m z u z i k
myuziom	m  5 o m
na	n a
na fi	n a f i
na kech di riek	n a k e 5 d i r i k
na onggl	n a o N u
naamali	n a m a l i
naaman	n a m a n
naasi	n a s i
naasti	n a s t i
naat	n a t
naat afrika	n a t a f r i k a
naat amerika	n a t a m e r i k a
naatiis	n a t i s
naatwes	n a t w e
nadan	n a d a n
naijiiria	n a i j i i r i a
nain	i k a m
naint	n a i n t
naintiin	n a i n t i n
nais	n a i s
nait	n a i t
naiz	n a i z
nalij	n a l i
nanfikshan	n a n f i k S a n
nansi	n a s i
naritiv	n a r i t i
navl	n a b
neba	n e b a
nedalanz	n e d a a nz~ i
nex	n i 7
nex ier	n " i e r
niecha	n i e C a
niel	n i
niem	n i e m
niernis	n i E a n i s
nieshan	n i e S a n
nieshan stiet	n i e S a s t i 3
nietib	n i e t i
nietib langwij	n i e t i b nz~ i Nw~ i
nigril	n i g r i l
niigl	n i g
niyilis	n i y i l i s
no kja	n o k j a
no kja umoch	n o k j a u m o
no kwait	n a k w a i t
no kya	n o k a
no kya ou	n o k a o u
no riili	n o r i i l i
nof	n o p
nof piipl	n o p k i p
nof tangx	n o p d a N 7
nof-nof	n o p n
noftaim	n o p t a i m
nomba	n o m b a
non	n o n
nondiles	n d i l e
notn	n o t o r n
notn na go so	n o t t n n a g o s o
novemba	n o p e m u i
nuo	n u o
nuot	n u o t o
nuotobl	n u a t o b l
nuoz	n u o n s
nyaamps	5 a m p
nyam	5 a m
nyam aaf	5 a m a a f
nyami-nyami	5 a m i n a m i
nyuu	y u
nyuu yaak	y u y a k
nyuu yaak siti	y u y a k s i t i
nyuuz	5 u
nyuuzpiepa	5 u z k a p a
ogli	o g i l i
okor	o k o r
okro	o k r o
olo	o l o
ombl	d o mb~
onggl	o N u
onggl wan	o N L w a n
onjrid	n j r i d
ont	n t a 5 a
ontalaji	o* t a l a h i
ontin	n t i n
ontruut	o t r u r e t
op	o p
op tu	a t u
opdiet	o p d i e t
opinyan	o p i 5 a n
opsaid dong	o p s e i d a i s
orbort	u r g a b
ort	u r
ortkwiek	u r t k E w k
ou	o u
oun	o u n
ous	u
ousomeba	o u s o m e b a
owad	o w a d
ozban	o z b a n
paadn	p a y n
paal	p a l
paaliment	p a l i m E n t
paarat	p a n a
paas	p a
paas dong	p a s o d o N
paas ischri	p a s i S r i
paasl	p a s
paasn	p a s o n
paasteriti	p a s t E r i t i
paat	p a t
paat a	p a a t a
paati	p a t i
pachrik	p a C i
pahn	p a h n
pain	p a i n
paint	p a i nt~
paip	p a i p
pakistan	k i s t a n
pakit	p a k i t
paliis	p a l i s
palisi	p a l i s i
palitikal	p a l i t i k a l
palitishan	p a l i t i S a n
palitix	p a l i t iT
panish	p a n i S
panish tong	p a n i S t i m a o N
papila	p a p i l a
papilieshan	p a p i l i e S a n
papishuo	p a p i S u o
papyulieshan	p a py~ l i e S a n
pashan fruut	p a S a f r u r e t
pat	p a t
pati	p a t i
patwa	p a t w a
pel	p e l
pelin	p e l i n
pepa	p e p a
picha	p i c a
picha buk	p i c a b u k
pie	p i e
pie fa	p i e n i
piej	p i e h
piepa	p i e p a
pier	p i e r
pierans	p i e r a n
pieschri	p i e S  r i
pieshans	p y E S a
piich patan	p i C p a t a n
piik	p i
piika	p i i k a
piiki-puoki	p i T i i n th~ e u o k i
piil	p i i l
piini	p i i n i
piini-waali	p i i n i 7 w a l i
piipl	p i i p
piipl nashinal paati	p i p l a n n a s i n a l p a t i
piiriad	p i i r i a d
piis	p i s
piita	p i n e n
piiz	p i
pikni	p i k n i
pilikin	p i l i k i n
pimenta	p i m e nt~ a
pio	p i o i
pit	p i t
pitieta	p i t i e t a
pitni	p i t n i
plaan	p l a y i
plaant	p l a y i i
plaantin	p l a y i a n t i n
pleja	p j a
plie	p l i e
plies	p l i e
pliet	p l i e t
plit	p l i t
plom	p l o m
poblik	p o b l a i k
poblikieshan	p o b l a T i e S a n
poblish	p o b l a i S
poblisha	p o b l a i S a
pofaam	p o f a r a m
poliis	p o l i s
poliisman	p o l i s m a n
politikal paati	p o l i t i k a l p a t i
pongkin	p o N k i n
ponish	p o n i S
ponishment	p o n i S m E n t
por-kiapita	p o r k i a p i t a
porl	p o r
pormanent	p o r m a
posnal	p o s n a l
posnal infamieshan	p o s n a l i l f a m i a S a n
pospektiv	p o 8 p e n e k t
potenshal	p o t S a l
potienin	p o t i E n i n
potikila	p o t 3 k i l a
potikyula	p o t i k u l a
powa	p o w a
prablem	p r a b l 3 m
praim	p r a i m
praim minista	p r a i m i n i S th~ a
prais	p r a i s
praivisi	p r a i i s i
prajek	p a h e k
pramis	p r a m i s a
pravins	p r a v i n
pred	p r e d
preke	p r e k e
priivos	p ry~ i v o s
primenta	p l i m e nt~ a
prizaab	p ry~ a y e m
prizn	p r i z n
prodok	p r o d o k
prodokshan	p r o d o k S a n
profeshanal chrienin	p r o f e S k a n a l C r i n i n
pronongx	p r o n o N 7
protek	p r o t e k
protekshan	p r o t e k S a n
prumuot	p r u m u o t o
pruogram	p r u a k r a m
pruoses	p r u o e
pudn	p u r n
pumuot	p u m u o t o
puo	p u o
puohim	p u u h i m
puok	p u o k
puos	p u o s
puosha	p u o s a
puosi	p u o n o 8 i
puot	p u o t o
puot antuoni	p u o t a n t u o n i
puot maraya	p u l r a y a
puotlan	p u o L a n
puotmuor	p u l o r
pupaa	p u p a
pus	p u s
pwail	pw~ a i l
pyaa-pyaa	py~ a u p y a
pyuuriti	py~ u r i t i
raa	r a
raatid	r a t i d
raip	r a i p
rais	r a i s
rais ahn piiz	r a i s a h m a i z
rait	r a i t
raita	r a i t a
raitn	r a i t n
raki paint	r a k i p a i nt~
raktuon	r a k t u o n
rang	r a N
rang-said	r a N  s e i
raya byuuno	r a y a b z u n o
reda	r e d a
redi	r E d i
refa	r e n i
refa tu	r e f a t u
refa tu az	r e f a t u a z
refarans	r e f a r a n
refarans buk	r e f a r i s b u k
refrans	r e f p a p a
rekaad	r e k a d
rekanaiz	r e k a n a i z
rekanaiz se	r e k a n a i z s e
rekanishan	r e k a n i S a n
respirieshan	r e s p i r i S a n
revaluushan	b e b E  u S a n
revarii	b e b a r i
revinyuu	r E f i n y u
riba	b a
ribelyan	r i v E l y a n
ridim	r i d i m a
ried	r i e d
riedio	r i e d i o
riek	k
rielwie	r i e l w i e
rielwie stieshan	r i e l w e s t i 3 S a n
rien	r i e n
ries	r i
riesin	e s i n
riesizim	e s i s i m a
rieza	r i E z E
riezn	r i e z d n
rifaam	r i f a r a m
rifain	r i f a m
rigl	x
riid	r i
riida	r i n d a y
riijan	r i u j y a n
riijanal	r i i j a n a l
riili	r i i l i
riisant	r i i s a n t
riizn	r i z n
rijais	r i  i s
rilaxieshan	r i l a x i e S a n
rilieshanship	r i l i e s a n C i p
rilietid	r i l i e t i d
riliis	r i l i s
rilijan	r i l i j a n
rimien	l i m i e n
ripoblik	r i p o b l a i k
ripoblik a airilan	r i p o b l k a i r i l a n
ripoblik a chaina	r i p o b l k a C a i n a
riprizent	r i p ry~ 8 a 5 a
ris	r i s
rispek	r i s p e k
ritorn	r i t o r n
rivazdiel	r i v a z d a
rivuolt	r i v u o r t a s
rizaat	r i z a t
rizolt	r i z o l
romantik	r o m a n t i k
ron	r o n
ronawe bie	r o n a w e b i e
rosha	r o s a
ruod	r u o d
ruoman kyaklik	r u e ky~ ky~ a q b u C o
ruoman kyaklik choch	r u e ky~ ky~ a q l i k C o
ruos	r u o s
ruudnis	r u d n i s
ruul	r u
ruut	r u r e t
saab	s a a b "
saabis	s a a b i s
saach	s a
saadi ariebia	s a dy~ a r i e b i a
saaf	s a a f
saalfish	s a l f i S
saaya saas	s a y a s a
sai	s e i
saiman	s e i m a n
sait	s a i t
saiyans	s e i y a n
sakrifais	s a q ry~ y i s
salaman	s a l a m a n
samyuel	s a m
san	s a n
sang	s a*
sanja	s a n j a
santa kruuz	s a n t a k r a u
santapii	s a n t a p i
sar	s a r
saril	s a r i l
sasayati	s a s a y a t i
sataya	s a t a y a
savlamaar	s a b l a m a r
sayans	s a y a n
sayantis	s a y a n t i s
schraip	S r a i p
schuu	S u
se	s e
sebm	s e b m
sebmt	s e b r o u
sebmtiin	s e b m
sebn	s e b n
sebnt	s e b a 5 a
sebntiin	s e b
sebral	s e b r a l
sef	s e f
sekan	s e k a n
sekl	s a q
seklment	s e k l m E n t
sekshan	s a q S a n
sela	s e l a
senchral hieja	s e n C r a L i e h a i
senchri	s e n C r i
senit	s e n i t
senita	s e n i t a
sens	s e n
sensobl	s e Th~ o b l
sensos	s e Th~ o s
sentans	s e n t a n y
sentri	s e n t r i
separieshan	s e p a r i e S a n
septemba	s e p t e m b a k
set a ruul	s e t a r u
sexizim	s " i s i m a
sfier	s f i e r
shaachij	S a k u C i
shaat	S a t
shap	S a p
shap-maasa	S a p m a a s a
sheda	S e d a
shiem	S i e m
shier	S i e r
shob	S o b
shot	S o t
shout	S o u t
shudn	S u d n
shuga	S u g a
shuga kien	S u g a k i e n
shuo	S u o
shuor	S u o r i
shuut	S u r e t
si	s i
sib	s i
sidong	s i d o N
sief	s i e f
sieka	s i e k a
siel	s i
siem	s i e m
siem wie	s i e m v i
siem wie laka ef	s i e m w k u k a e f
siera	s i e r a
siev	s i e v
sii	s i
sii kyaptin	s i o a p t i n
siikuel	s i
siim	s i m
siim fi	s i m f i
siin	s i i n
siis	s i s
siitorkl	s i i t u r q
siizn	s i z n
siiznin	s i z n i n
sik	s i k
silekshan	s i l 3 k S a n
silvia	s i l a i a
sin jiemz	s i n j i e m
sin kiachrin	s i n k i a C n i n
sin kits ahn niivis	s i n k i s e hn~ n i i v i s
sin luusha	s i n l u a
sin mieri	s i n m i e r i
sin tamas	s i t o m o s
sin vinsn ahn di grenidiinz	s i n v i s n a h nd~ i g r e n i d i N
sing	s i N
singa	s i Ng~ a
singgapuor	s i N x a p u o r i
siniek	a h i
sinieli	s i n i e l i
sint an	s i n t a n a
sint anju	s i n t a n y~ a u
sint anz bie	s i n t a nz~ b i e
sint ilizibet	s i n t i l i  b e t
sinting	s i N t i N
sipl	s i p i
sista	s i s t a
sistim	s i s t i m
siti	s i t i
sitieshan	s i t i e S a n
sitiet	s i t i e t
sitizn	s i t i z n
sitn	s i t n
six	s i S
sixt	s i S
sixtiin	s i S
skai	s k a i
skelyan	s k E l y a n
skuul	s k u
skwier	s k w i e r
skwier kilomita	s k E w k r k i l o m i t a
slait	s l a i t
slieb	s l i e
sliip	s l i
sluo	s l u o
smaal	s a l
smadi	s d i
smadi els	s l
smadi uu	s m a d i u
smuok	s o k
so langx az	s o r a n g a z
sobjek	s o by~ E k
sodan	s o d a n
sofa	 a
sofarieshan	s o f a r i e S a n
sohn	s o h E 5
sojes	s o q
som	s o m
soma	s o m a
somwe	s o m w e
sopm	s o p m
sopraizn	s o p r a i z n
sopres	s o p r e
sori kounti	s o r i k o u n t i
sorkl	s o r q
sorniem	s o r n i e m
sorosi	s o r o s i
soroun	s o r o u n
soroun bai	s o r o u nb~ a i
sostien	s o s t i 3 n
soua	s o u a
soun	s o u n
sout	s o u t
sout afrika	s o u t a f r i k a
sout koria	s o u t k o r i a
soutiis	s o u t i s
soutiis ieja	s o u t i s i e h a i
soutwes	s o u t w e
spais	s p a i s
spekchrom	s p e k C l o m
spien	s p i e n
spies	s p i e
spiishiz	s p i s i z
spring	s p r i N
spring rien	s p r i N X i q e n
spring waata	s p r i Nw~ a X a t a
spuoxman	s p u o* m a n
staach	s t a
staam	s t a m
staar	s t a r
staar apl	t a  a p
staarfruut	t a  f r u r e t
staat	s t a t
stail	s t a i l
stie	s t i e
stiebl	s t i e b l
stiej	s t i 3
stieshan	s t i 3 S a n
stiet	s t i 3
stietos	s t i 3 t o s
stiibm	s t i b m
stiim	s t i m
stiim powa	s t i i m p o w a
stodi	s t o d i
stuon	t u o n
suhn	s o k n
suimz	s u i m
suitsalan	s u i s a l a n
sumaal	s u m a l
sumuud	s u m u d
suoja	s u o h a
suop	s u o p
suos	s u o s
suoshal	s u o S a l
suoshal woka	s u o S a l u o k a
suoviet yuunian	s u o v i e t z u n i a n
susu	s u s u
suucha	s u C a
suun	s u n
suup	s u p
swiidn	sw~ i  n
swiit	sw~ i i t
swiit pepa	sw~ i t p e p a
swiit pitieta	sw~ i t p i t i e t a
swiit-swiit	sw~ i t 7 fs~ i i t
swimin	sw~ i m i n
taak	t a k
taakin	t a k i n
taat	t a t
taat frahn	t a t f r a h n
taikl	t a i k
tailan	t a i l a n
taim	t a i m
talawa	t a l a w a
tamas	t o m o s
tambrik	t a mb~ r i k
tambrin	t a mb~ r i n
tan	t a n
tan op	t a n o p
tandad	t a nd~ a d
tangx	t a N 7
tap	t a p
tapik	t a p i k
taya	t a y a
tayad	d a t a y a d
tek	t e k
tek iin	t a k i i n
tek kier a	t a k i e r a
tek plies	t e kp~ l i e
tek uoba	t 3 k u o b a
tekniik	t a k n i
tel	t e l
tel nou	t E l n u
ten	t e n
tenis	t e n i s
tent	t e n t
tenya	t e n y a
terichri	t e r i C r i
tertiin	t E r
textail	t e S i t
tide	t i d e
tiebl	t i e b l
tiel	t i e l
ties	t i e
tieta	t i e t a
tigeda	t i g 3 d a 7
tii	t i
tiich	t i i C
tiif	t i i f i
tiit	t i i t
tik	t i k
tingk	t i N
tingz	t i N
tiori	t i o r i
tisyu	t i S k u
tix	t iT
toch	t o X
tod	t o d o s
todi	t o d i
tof	t o f
ton	t o n
tong	t o N
torkl	t u r q
torm	t o r m
tormal	t o r m a l
tornin paint	t o r n i n p a i nt~
torpmtaim	t o r p m t a i m
toti	t o t i
toun	t o u n
touzn	t o u  n
towa	t o w a
towil	t o w i l
tros	t r o s
tu	t u
tumatis	t u m a t i s
tuo	t u o
tuofuu	t u o f u
tuon	t u o n
tuonaliti	t u o n a l i t i
tuori	t u o r i
tuu	t u
tuul	t u
twelb	t w e l
twenti	t w e n t i
ud	u d
uman	u m a n
umoch	m o
unu	u n u
uoba	u o b a
uoba taim	u o b a t a i m
uobasior	u o b a s i o r
uochi rayas	u o C i r a y a s
uol	u o l
uoli	u o l i
uoliip	u o l i
uom	u o m
uon	u o n
uona	u o n a
uonaship	u o n a s i p
uonyan	5 a n
uopm	u L m
uopm op	u a m o p
uoshan	u o S a n
uovn	u o w n
uu	u
vais	v a i s
van	v a n
varayati	v a r a y a t i
vejitebl	e j i t e b l
vieri	v i e r i
vietnam	v i e t n a m
vijan	v i y a n
vik	v i k
viniga	v i n i g a
volkieno	v o l k i E n o
vorjan	v o r a d " a
vowil	v o w i l
vuokal	r a
vuokalis	v u o r k a l i s
vuot	v u o r
wa	w a
wa dehn kaal	w a d e h Nk~ a l
waak	w a k
waal	w a l o
waam	w a a m
waapm	w a s u m
waar	w a r
waata	w a a t a
wahn	w a 7 n
waidpred	w a i d p r e d
waif	w a i f
wail	w a i l
wails	w a i l
wait	w a i t
wala	w a l a
wan	w a n
wan nex	w a n i 7
wan wie	w a l a n u i e
wapn-bapn	w a p o m b a b a p n
was	w a s
wat-lef	w a t 7 l e f
wat-liiv	w a t 7 l i i
we miin se	w e m a t sy~ s e
weda	w e d a
wehn	w e h n
wes	w e
wes afrika	w e s a f r i k a
wesmolan	w e s m o l a n i
westan yuurop	w e s t a n y u r o p
wi	w i
wid	w i d
widout	w i d o u t
widoutn	w i d o u t n
wie	v i
wiej	w i e h
wiet	v i
wiik	w i
wiil	w i i l
winta	w i t a
wod	w o d
wod-a-mout	w o d a m o u t
wok	w o k
wok fuos	w o k pw~ o s
woka	w o k a
woklis	w o k l i s
wol	w o l
wori	w o r i
worom	w o r o m
wot	w o t
wotlis	w o L i s
wud	w u d
wuol	w u o l
ya	y a
yaad	y a
yaadi	y a a d i
yai	y a i
yam	y a m
yampi	y a m p i
yaso	y a s o
yaxep	y a x 3 p
yeside	y e s i d e
yong	y o N
yu	y u
yumaniti	y u m a n i t i
yunaitid kindom	y u n a i t i d k i d o m
yunaitid stiet	y u n a i t i d s t i 3
yunivorsiti	y u n i v o r s i t i
yuu	y u
yuukrien	z u k r i e n
yuuman	z u m a n
yuuna	z u n a
yuuniiknis	y u n i i k n i s
yuunyan	z u 5 a n
yuurop	y u r o p
yuus	z u s
yuusful	y u s f u l
yuusij	y u s i
yuut	y u r e t
yuuz	z u
zela	z e l a
zuu	z u
