te	t e
i	i
o	o
ki	k i
ngā	N
e	e
ka	r o x
a	a
me	m i
ana	a n a
he	e
nga	N a
Te	e
ko	k o
mai	m a i
Ko	o
atu	a t u
Ka	a
He	e
ai	a i
hei	h e
mō	m o
Māori	a o r i
kia	k i a
ia	i a
mahi	m a h i
hoki	h o k i
nei	n e i
tau	m a
tēnei	t a N n e i
tētahi	t a N t a h i
roto	r o t o
mea	m e a
ake	a k e
kei	k e i
kua	k u a
kōrero	k o r e r o
anō	a n o
nui	n u i
reo	r E o
haere	h a e r e
tangata	t a N a t a
ētahi	a N t a h i
tonu	t o n u
mo	m o
katoa	k a t o a
mā	m
rātou	r a t o u
whai	wh~ E a i
iwi	i w i
noho	n o h o
koe	k o e
runga	r u N a
Kei	e i
tō	a
rānei	r nj~ 3 e i
whenua	f e n u a
to	t o
noa	n o a
ākonga	a k o N a
wā	a
kaupapa	k a u p a p a
whare	wh~ E a r e
tana	t a n a
tino	t i n o
pai	p a i
Aotearoa	o t e a r o a
rā	r
take	t a k e
Ngā	g
tenei	t e n e i
aha	a h a
ra	r a
taua	t a w a
toa	t o a
taea	t a e a
tōna	t r 3 n a
kura	k u r a
kai	k a i
tae	t a e
rawa	r a w a
rua	r u a
Kua	u a
kore	k o r e
whakaaro	wh~ E a k a d o
mate	m a t e
puta	p u t a
tamariki	t a m a r i k i
tikanga	t i k a n g a
ēnei	a N n e i
reira	r e i r a
wāhi	a
taku	t a k u
wai	w a i
iho	i h o
pukapuka	p u k a p u k a
ano	a n o
au	a u
ao	a o
waka	w a k a
tā	m a
kitea	k i t e a
tetahi	t e t a h i
kupu	k u p u
momo	m o m o
muri	m u r i
Me	e
ako	a k o
mua	m u a
taha	t a h a
whakaatu	wh~ E k a a t u
whānau	wh~ E nj~ 3 a u
tika	t i k a
korero	k o r e r o
tahi	t a h i
nā	n
tauira	t a w i r a
nō	n o
kaha	k a h a
tohu	t o h u
pā	p
matua	m a t u a
āhua	a w a
Kia	i a
ratou	r a t o u
kāore	l o r e
pea	p e a
engari	g a r i
ōna	r 3 n a
tuatahi	t u a t a h i
kē	q e
wāhanga	a  a Ng~ a
the	th~ e
Hei	e i
hua	w a
ingoa	i N o a
maha	m a h a
nama	n a m a
hou	h o u
raro	r a r o
hunga	h u N a
ō	o
mana	m a n a
roa	r o a
tēnā	t e n
Mātauranga	a t a u r a Ng~ a
āhuatanga	a w a t a n g a
Ki	i
kaiwhakahaere	S i r k a h a e r e
mōhio	m o i o
tū	t u
hanga	h a n g a
rōpū	r o p u
ahau	a h a u
koutou	k o u t o u
wa	w a
waiata	w a i a t a
tuku	t i k i
tērā	t e r
tona	t o n a
kotahi	k o t a h i
taki	t a k i
mau	m a u
mātou	m a t o u
Ngati	g a t i
na	n a
utu	u t u
hiahia	h i a h i a
rārangi	r a r a N i
tautoko	t a u t o k o
arā	a r
rauemi	r a u e m i
hāngai	h a N a i
tāngata	m a N a t a
wahine	w a h i n e
Kete	e t e
ara	a r a
Nō	o
Rauemi	a u e m i
kōwhiringa	k o wh~ E i r i Ng~ a
kaore	k a o r e
huarahi	w a r a h i
Ipurangi	p u r a N i
whakamahi	wh~ E k a m a h i
toru	t o r u
Reo	e o
Kāore	a o r e
kite	k i t e
tekau	t a k a u
ma	m a
Ngāti	g a t i
Kohinga	h i n g a
aua	a u a
Maori	a o r i
whakaahua	wh~ E k a h i
iti	i t i
hoa	h o a
rāua	r a i
ta	t a
rangatira	r a N a t i r a
taonga	t a o n g a
tātou	m a t o u
rohe	r o h e
Iwi	w i
New	e w a
whakahaere	wh~ E k a h a e r e
rere	r e r e
marama	m a r a m a
āta	a t a
Kura	u r a
etahi	e t a h i
Na	a
moana	m o a n a
ture	t u r e
ora	o r a
nuinga	n u i Ng~ a
konei	k o n e i
rite	r i t e
matou	m a t o u
tata	t a t a
no	n o
Makino	a k i n o
rau	r a u
Tiriti	i r i t i
rātau	r a t a u
pānui	p a n u i
tini	t i n i
whakamārama	wh~ E k a m a r a m a
taumata	t a u m a t a
mutu	m u t u
papa	p a p a
pērā	l u a N r
whānui	w h a n u i
tuhi	i
kāinga	l i Ng~ a
Pākehā	a k e h a
tamaiti	t a m a i t i
or	o r
anake	a N k e
tuhinga	i Ng~ a
tipu	t e p u
manu	m a n u
raua	r a u a
hapori	h a p o r i
titiro	t i t i r o
ika	i k a
pa	p a
Ehara	h a r a
Kōrero	o r e r o
huri	h u r i
hui	h u y i
āwhina	a w h i n a
Kātahi	a t a h i
Nau	a u
marae	r a e
mātauranga	m a t a u r a Ng~ a
kino	k i n a t
rapu	r a p u
whakarite	wh~ E k a r i t e
rongo	r o n g o
kī	k i
āna	nj~ 3
Hoki	o k i
motu	m o t u
pouako	p o u a k o
rangi	r a n g i
tono	t o n o
pātai	p a t a i
rerekē	r e r e k a N
kainga	k a i Ng~ a
kaiako	k a i a k o
whakamahia	wh~ E k a m a h i a
Engari	ng~ a d i
waho	w a h o
heke	h e k e
uru	u r u
wahi	w a 7 i
rahi	r a h i
tatou	m a t o u
pēhea	l u a N h e a
tinana	t i n a n a
Tai	a i
oti	o t i
whakatau	wh~ E k a t a u
ngaro	N a r o
pōti	p o t i
ahakoa	a h a k a
hau	h a u
rangahau	r a N a h a u
tukuna	m o v a s a
piki	p i k i
kaimahi	k a i m a h i
pae	p a e
tohunga	t o h u N a
Whare	h a r e
rākau	r a k a u
tuarua	t u a r u a
tīmata	t i m a t a
ranei	r a n e i
putanga	p u t a Ng~ a
whiwhi	wh~ E i w
moni	m o n i
ahi	a h i
tera	t E r a
tāna	m a n a
ata	a t a
wātea	w a t e a
akoranga	a k o r a Ng~ a
tere	t e r e
Ahakoa	h a k a
wiki	w i k i
pēnei	l u a N n e i
awa	a w a
kāwanatanga	l w a n a t a n g a
waenganui	gw~ a 3 N a n u i
Waitangi	i t a n g i
enei	e n e i
mohio	o* h i o
ērā	a N r
mihi	m i 7 i
tu	t u
whārangi	w h a r a N i
Heoi	e o i
hoko	h o k o
pakeke	p a k e k e
ona	o n a
toi	t o i
rima	l i m a
hononga	h o n o n g a
riro	r i r o
pānga	p a Ng~ a
pakanga	p a k a n g a
ōrau	o r a u
motuhake	m o t u h a k e
whā	w h a
eke	e k e
kau	k a u
kātahi	k a a t a h i
ōrite	o r i t e
tiaki	t i a k i
hia	h i a
taiao	t a i a o
whāinga	w h a i Ng~ a
mārama	m a r a m a
ringa	r i Ng~ a
aroha	a r o h a
neke	n e k e
whakaae	wh~ E k a e m a
Mēnā	a N n
waahi	w a a h i
Koia	o i a
raruraru	r a r u r a r u
haka	h a k a
oranga	o r a Ng~ a
hauora	h a w o r a
mahere	w i*
karakia	k a r a k i a
pūrākau	p u r a k a u
tirohia	t u r o h i a
uri	u r i
tena	t e n a
ngä	N
rautaki	r a u t a k i
whanau	wh~ E a n a u
kawe	k a w e
Kaore	a o r e
tuhia	i a
koia	k o i a
Tuhia	a i a
Katahi	a t a h i
māmā	m a m
patu	p a t u
whakautu	wh~ E k a u t u
whakarongo	wh~ E k a r o n g o
mutunga	m u t u N a
aku	a k u
aro	a r o
kapa	k a p a
huanga	w a n g a
mēnā	m a N n *
Tokerau	o k e r a u
Waikato	a i n a 7 a t o
Week	e k "
pirihimana	p i r i h i m a n a
tirotiro	t u r o t i r o
Mākino	a k i n o
akomanga	a k o m a n g a
tangi	t a n g i
ina	i n a
rerenga	r e r e n g a
ahua	a w a
tohutohu	t o h u t o h u
waahanga	w a a h a Ng~ a
whakataetae	wh~ E k a t a e t a e
hōtaka	h o t a k a
No	o
pūrongo	p u r o n g o
whakauru	wh~ E k a u r u
ratonga	r a t o n g a
mātua	m a t u a
wairua	w a i r u a
kīia	k i i a
tētehi	t a N t e h i
Kaupapa	a u p a p a
uaua	u a u a
hea	h e a
tama	t a m a
Tau	a u
whakaputa	wh~ E k a p u t a
waihanga	w a i h a Ng~ a
kaua	k a u a
pū	p u
whakaako	wh~ E k a k o
kimi	k i m i
karanga	k a r a Ng~ a
rakau	r a k a u
Mai	a i
tango	t a n g o
Niu	i u
riri	r i r i
waenga	gw~ a 3 N a
mahinga	m a h i n g a
Ao	o
raupapa	r a u p a p a
ke	k e
hangaia	h a N a i a
maunga	m a u N a
āhei	a h e i
Ture	u r e
whakawhiti	wh~ E k a wh~ E i t i
Matua	a t u a
whakaritea	wh~ E k a r i t e a
Whenua	h e n u a
ope	o p e
pepa	p e p a
painga	p a i Ng~ a
atua	a t u a
tirohanga	t u r o h a Ng~ a
whawhai	wh~ E a l a i
whakanui	wh~ E k a n u i
whakaaturanga	wh~ E k a a t u r a Ng~ a
To	o
takoto	t a k o t o
tukutuku	n k u t u k u
takiwā	t a k i a
poto	p o t o
whakaaturia	wh~ E k a a t u r i a
haerenga	h a e r e n g a
wānanga	w nj~ 3 n g a
moe	m o e
whiriwhiri	wh~ E i r i wh~ E i r i
Mō	o
po	p o
mata	m a t a
mema	m e m a
Tari	a r i
whakapono	wh~ E k a p o n o
kanohi	k a n o h i
huinga	w i Ng~ a
waiho	w a i h o
whakamutunga	wh~ E k a m u t u N a
Marautanga	a r a u t a Ng~ a
raraunga	r a r a u N a
Nga	g a
awhina	a w h i n a
whakaari	wh~ E a k a d i
pou	p o u
pupuri	p u p u r i
mahia	m a i a
mehemea	m e h e m i a
ono	o n o
The	e
pikitia	p i k i t i a
pūkenga	p u k e n g a
tupu	t u p u
whakaoti	wh~ E k a o t i
Arā	r
tua	t u a
tatau	t a t a u
tawhiti	t a wh~ E i t i
whakaritenga	wh~ E k a r i r e n g a
here	h e r e
kii	k i
tukua	t i k i a
Haere	a e r e
in	i n
tūtohu	t u t o h u
Karauna	a r a u n a
hono	h o n o
Kāwanatanga	a w a n a t a n g a
taitara	t a i t a r a
Ingarangi	N a r a N i
mātau	m a t a u
hoatu	h o a t u
tai	t a i
ahu	a h u
hangarau	h a N a r a u
ipurangi	C u r a N i
kā	l
tukanga	n a a Ng~ a
whakatakoto	wh~ E k a t a k o t o
Tautoko	a u t o k o
mano	n o
hapū	h a p u
marautanga	r a u t a Ng~ a
Tirohia	i r o h i a
ataata	a t a t a
aromatawai	a r o m a t a w a i
ārahi	a r a h i
kōwae	k o w a e
haumaru	h a u m a r u
ahiahi	nt~ a h i
Kaunihera	a u n i h e r a
pakihi	k i 7 i
tuhituhi	t u h i t u h i
Tireni	i r e n i
ehara	e h a r a
whakaata	wh~ E k a a t a
Ara	r a
Koinei	o i n e i
Tuatahi	u a t a h i
pūtea	p u t e a
waewae	gw~ a 3 a e
tapu	t a p u
toku	t o k u
āu	a u
pō	p o
Papa	a p a
kauwhata	k a u w a t a
Tauranga	a u r a Ng~ a
taputapu	t a p u t a p u
mōhiotia	m o u h a o t i a
tangohia	t a N o h i a
tīmatanga	t i m a t a n g a
ahurea	a h u r e a
hinga	h i n g a
whakapapa	wh~ E a k u t " u t " u
matau	m a t a u
ii	i
taone	t a o n e
Wānanga	nj~ 3 n g a
uta	u t a
Taumata	a u m a t a
rīpene	r o e n e
waea	w a e a
Taki	a k i
whakairo	wh~ E k a i r o
waru	w a r u
taka	t a k a
tapaina	t a p a i n a
tāpiri	m a p i r i
tōku	h  u
ārai	a r a i
Rangi	a n g i
koa	k o
timata	t i m a t a
tūranga	t u r a Ng~ a
katahi	k a t a h i
Ina	n a
Māui	a u i
Rōpū	o p u
Anei	n e i
tutuki	t u t u k i
ratau	r a t a u
tawhito	t a wh~ E i t o
Mehemea	e h e m i a
tākaro	m a k a r o
Tērā	a N r
arotake	a r o t a k e
mōhiohio	m o u h a o h i o
whakaaetia	wh~ E k a e t i a
Ngāi	g a i
horopaki	h o r o p a k i
pūnaha	p u n a h a
whakamahinga	wh~ E k a m a h i n g a
Pāremata	a r e m a t a
kararehe	k a r a r e e
kāri	k a r i
Kotahi	o t a h i
Matariki	a t a r i k i
niho	n i h o
uara	u a r a
hiahiatia	h i nt~ a t i a
kiri	k i r i
pouaka	p o o a k a
wehe	w e h e
Ma	a
ngahere	N a h e r e
pito	p i t o
tokomaha	t o k o m a h a
tūturu	t u t u r u
Rau	a u
Taranaki	a r a n a k i
Toi	o i
taenga	t a e n g a
whakatūria	wh~ E k a t u r i a
Tohu	o h u
kawea	k a w e a
mahara	m a h a r a
kohinga	k o h i n g a
tūhura	t u u r a
Manu	a n u
Tahu	a h u
miriona	m i r i o n a
tapawhā	t a p a w h a
Rauparaha	a u p a r a h a
taketake	t a k e  k e
tohua	t o w a
paetukutuku	p a e t u k u t u k u
Pūtaiao	u t a i a o
tūmatanui	t u m a t a n u i
ua	u a
Pirihimana	i r i h i m a n a
hokohoko	h o k o h o k o
rorohiko	r o r o h i k o
hāpai	h a p a i
ngākau	N a k a u
whakatutuki	wh~ E k a t u n k i
pūtake	p u k e
tātai	m a t a i
puna	p u n a
whakawhanake	wh~ E a b o r u f 3 n k e
nana	n a n a
tāne	m a n e
Pakeha	a k e h a
kiia	k i a
whakapakari	wh~ E k a p a k a r i
whakatū	wh~ E k a t u
tari	t a r i
whiti	wh~ E i t i
tokorua	t o k o r u a
Kōhanga	o a Ng~ a
tonga	t o n g a
aronga	a r o n g a
Mr	r
hinengaro	h i n e N a r o
nāna	n nj~ 3
Tuarua	u a r u a
anga	a N a
pārongo	p a r o n g o
Ahitereiria	h i t e r a i r i a
aho	a h o
whitu	wh~ E i t u
kōhanga	k o a Ng~ a
poari	p o a r i
tipuna	t e p u n a
kaitiaki	k a i t i a k i
waha	w a h a
whakarato	wh~ E k a r a t o
Rua	u a
wera	w e r a
hōia	h o i a
parekura	p a r e k u r a
teitei	t e i t e i t o
hoahoa	h o a h o a
Toa	o a
pau	p a u
tiki	t i k i
kamupene	k a m u p e n e
mokopuna	m o k o p u n a
pokapū	p o k a p u
Mahi	a h i
putea	p u t e a
hapu	x a p u
ngohe	N o h e
tuatoru	t u a t o r u
Ingarihi	N a r i 7 i
ngakau	N a k a u
Atua	t u a
whakamua	wh~ E k a m u a
whāia	w h a i a
Minita	i n i t a
puoro	p u o r o
Waiata	a y a t a
kaitohutohu	k a i t o h u t o h u
māori	m a o r i
pakari	p a k a r i
pāngarau	p a ng~ a d a u
rapanga	r a p a n g a
takitahi	t a k i t a h i
tuakana	t u a k a n a
ui	u i
katoatia	k a t o a t i a
manaaki	m a n a k i
puka	p u k a
takirua	t a k i r u a
otinga	o t i Ng~ a
hara	h a r a
pūtaiao	p u t a i a o
tahuri	t a h u r i
tāone	m a o n e
ngaru	N a r u
rongonui	r o N o n u i
Kāinga	a i Ng~ a
Kupu	u p u
ināianei	i n a e n u
mita	m i t a
whakatairanga	wh~ E k a t a i r a Ng~ a
hokona	h o k o n a
kuia	k u i a
tūmomo	t u m o m o
whakangungu	wh~ E k a n g u N u
Karaiti	a r a i t i
whakatika	wh~ E k a t i k a
Kawanatanga	a w a n a t a n g a
Wharekura	h a r e k u r a
tapa	t a p a
kaunihera	k a u n i h e r a
whaea	wh~ E a e a
Poari	o a r i
arotahi	a r o t a h i
manuhiri	m a n u h i r i
patua	p a t u a
pupuhi	p u p u h i
waa	w a
māna	m nj~ 3
oro	o r o
Takiuru	a k i u r u
harakeke	h a r a k e k e
rēhita	r a N h i t a
whakahoki	wh~ E k a h o k i
Rotorua	k o t o r u a
ngaa	N a
whakataunga	wh~ E k a t a u N a
whenu	f e n u
Arawa	r a w a
pakeha	p a k e h a
upoko	u p o k o
mahue	m a w e
ngātahi	N a t a h i
tane	t a n e
Kaua	a u a
hopu	h o p u
hītori	h i t o r i
whetū	wh~ e t u
Pukapuka	t u k a p u k a
huhua	h u w a
matatau	m a t a t a u
pakaru	p a k a t u
toro	t o r o
ariā	a ry~
mōhiotanga	m o u h a o t a Ng~ a
toka	t o k a
heoi	h e o i
whakawhitinga	wh~ E k a wh~ E i t i Ng~ a
kawenga	k a w e n g a
whakapae	wh~ E k a p a e
whakawhitiwhiti	wh~ E k a wh~ E i t i wh~ E i t i
māramatanga	m a r a m a t a n g a
kākahu	k a a k a u
tūponotanga	t u p o n o t a Ng~ a
whakaora	wh~ E k a o r a
whakaputaina	wh~ E k a p u t a i n a
kaipupuri	k a i p u p u r i
hai	h a i
hiko	h i k o
nāianei	n a e n u
paki	p a k i
tapatoru	t a p a t o r u
Whakamahia	h a k a m a h i a
kete	k e t e
moutere	% m a u t e r e
tāu	m a u
wāhine	a  h i n e
Moana	o a n a
Pāwhiria	a wh~ E i r i a
paku	p a k u
otirā	o t i r
ētehi	a N t e h i
penei	p e n e i
reta	r e t a
haurua	h a u r u a
ira	i r a
mahana	m a h a n a
roanga	r o a Ng~ a
rerekētanga	r e r e k a N t a Ng~ a
kahore	k a h o r e
rangona	r a N o n a
whakamātau	wh~ E k a m a t a u
Kai	a i
haora	h a o r a
piri	p i r i
wero	w e r o
hoe	h o e
kitenga	k i t e n g a
whakaaetanga	wh~ E k a e t a Ng~ a
hanganga	h a N a Ng~ a
tetehi	t e t e h i
aratohu	a r a t o h u
kaihoko	k a i h o k o
takiwa	t a k i w a
whakatipu	wh~ E k a t i p u
ine	i n e
koki	k o k i
whakatikatika	wh~ E k a t i k a t i k a
Makaurau	a k a u r a u
Tāhuhu	a u h u
nunui	n u n u i
raru	r a r u
toto	t o t o
tīpuna	t i p u n a
tūmanako	t u m a n a k o
wehenga	w e h e n g a
whakahau	wh~ E k a h a u
whakawhiwhia	wh~ E k a l i wh~ E i a
rangatahi	r a N a t a h i
whara	wh~ E a r a
Waipounamu	i p o u n a m u
pono	p o n o
whakapā	wh~ E k a p
Kuini	k i n i
Kōti	o t i
pahure	p a h u r e
whakahokia	wh~ E k a h o k i a
Tangata	a N a t a
taipitopito	t a i p i y t o p i y t o
whakapai	wh~ E k a p a i
kaitono	k a i t o n o
taiohi	t a i o h i
taumaha	t a u m a h a
Kooti	o t i
Ngunguru	g u N u r u
ipu	i p u
Tawhaki	r u f 3 k i
kuhu	k u h u
wha	wh~ E a
Take	a k e
kaituhi	k a i t u h i
pūmau	p u m a u
taupori	t a u p o r i
Whanaketanga	h a n a k e t a Ng~ a
ihu	i h u
tupuna	t u p u n a
miraka	m i r a k a
raatau	r a t a u
era	e r a
huihuinga	w i w i Ng~ a
rumaki	r u m a k i
tātau	m a t a u
Kaiwhakahaere	i r k a h a e r e
Porou	o r o u
paetae	p a e t a e
taringa	t a r i Ng~ a
taura	t a u r a
Kapa	a p a
Whai	h a i
Ngata	g a t a
ngāwari	N a w a r i
uhi	a i
hāora	h a o r a
kohi	k o h i
taunga	t a u N a
kaipuke	k a i p u k e
kōpae	k o p a e
kati	k a t i
kaumātua	k a u m a t u a
tēhea	t a N h e a
wheako	wh~ e a k o
hinu	h i n u
tonoa	t o n o a
whakaarohia	wh~ E a k a d o h i a
whakaputanga	wh~ E k a p u t a Ng~ a
angitu	a N i t u
manawa	m a n a w a
meneti	m E n e t i
taurangi	t a u r a N i
tou	t u
whakaheke	wh~ E k a h e k e
Pakanga	a k a n g a
Taonga	a o n g a
akiaki	a k i a k i
kihai	k i a i
nekehanga	n e k e h a Ng~ a
oneone	o i o n e
roopu	r o o p u
tatari	t a t a r i
urupare	u r u p a r e
Marae	a r a e
Reanga	e a Ng~ a
Tēnā	a N n
tūtohi	t u t o h i
Ika	r o x
Kōkiri	 i r i
TMOAHe	e
Taura	a u r a
Tāmaki	a m a k i
Waka	a k a
tito	t i t o
whārite	w h a r i t e
huringa	h u r i Ng~ a
kāhui	l w i
mamae	m a m a e
kēmu	q e m u
pounamu	p o u n a m u
taraiwa	t a r a i w a
whakapuaki	wh~ E k a p o a k i
ōku	 u
Whakaaturia	h a k a t u r i a
Maui	a u
karaka	k a r a k a
matenga	m a t e n g a
pēke	l u a N k e
pepeke	p e p e k e
kiriata	k i r i a t a
kōhungahunga	k o u N a h u N a
tonutia	t o n u t i a
whakamarama	wh~ E k a m a r a m a
Mana	a n a
Putumōhio	u t u o i o
Whanganui	h a N a n u i
ahuatanga	a w a t a n g a
iwa	i w o
pukapukaNgā	p u k a p u k a g
tumuaki	o r o u a k i
wawata	w a w a t a
whaiaro	wh~ E a i 7 r o
whea	wh~ e a
aroaro	a r o a r o
whakahirahira	wh~ E k a h i r a h i r a
whero	wh~ e r o
īmēra	i m a N r a
Tainui	a i n u i
kounga	k o u N a
Tangaroa	a N a r o a
karu	k a t u
maatau	m a t a u
whakaeke	wh~ E k a e k e
whakaminea	wh~ E k a m i n e a
Akarana	k a r a n a
Rautaki	a u t a k i
hokinga	h o k i Ng~ a
kakahu	k a k a u
karaipi	k a r a i p i
huka	h u k a
pānuitanga	p nj~ 3 i t a Ng~ a
Rumaki	u m a k i
hākinakina	h a k i n a k i n a
kuri	k u r u
pu	p u
Whiri	h i r i
kanikani	k a n i k a n i
pūmanawa	p u m a n a w a
Hauora	a u o r a
Tr	r
akonga	a k o N a
inu	i n u
puku	p u k u
pūngao	p u n g a o
whakamahere	wh~ E a  h e r e
Arotake	r o t a k e
Puni	u n i
Rangatira	a N a t i r a
paerewa	p a e r e w a
tūpuna	t u p u n a
wehi	w e h i
Tikanga	i k a n g a
mōna	m r 3 n a
whakahē	wh~ E k a
whanaunga	wh~ E a n a u N a
Tekau	e k a u
maroke	m a* r o k e
Whānau	h a n a u
kākano	k a a k a
ringaringa	r i N a r i Ng~ a
teina	t e i n a
tōrangapū	a r a N a p u
Awa	w a
Pou	o u
Tena	e n a
pakiwaitara	k i w a i t a r a
pēpi	l u a N p i
Tenei	e n e i
inā	i n
kerēme	k e r a N nd~ e e
Kahungunu	a h u N u n u
Kupe	u p e
irirangi	i r i r a N i
kaitautoko	k a i t a u t o k o
utua	u t u a
inaianei	i n a i a n e i
pouri	p o u r i
raki	r a k i
whakatere	wh~ E k a t e r e
whanga	wh~ E a Ng~ a
takutai	t a k u t a i
Kāti	a t i
Papatūānuku	a p a t u nj~ 3 u k u
Tonoa	n o a
ahumahi	a h u m a h i
hīkoi	h i k o i
porotiti	p o r o t i t i
rongoā	r o N o
whāiti	w h a i t i
māu	m a u
whakarahinga	wh~ E k a r a h i n g a
whatu	wh~ E a t u
whāngai	w h a N a i
ahunga	a h u N a
mātakitaki	m a t a k i t a k i
tōtika	t o t i k a
whanaketanga	u f 3 n k e t a Ng~ a
Pi	i
Tonga	o n g a
Wiremu	i r e m u
kohikohi	k o h i k o h i
pātata	p a t a t a
raumati	r a u m a t i
Hoatu	o a t u
mauri	m a u r u
on	o n
toharite	t o h a r i t e
uiui	k i u i
whakataukī	wh~ E k a t a u k i
Hou	o u
mātāpono	m a t a p o n o
out	o u t
pūrere	p u r e r e
huruhuru	h u r u h u r u
matū	m a t u
whakapau	wh~ E k a p a u
Nui	u i
koroua	k o r o u a
kūmara	k u m a r a
reka	r e k a
whānuitanga	wh~ E nj~ 3 i t a Ng~ a
Tūhoe	u o e
hari	h a r i
matihiko	m a t i i k o
tāpiritanga	m a p i r i t a Ng~ a
whakakore	wh~ E k a k o r e
Amerika	m e r i k a
Haka	a k a
hī	h i
karere	k a r e r e
rō	r o
tapeke	t a p e k e
tāwāhi	m a a
whanaungatanga	wh~ E a n a u N a t a n g a
Puna	u n a
rawe	r a w e
whanake	u f 3 n k e
whiua	wh~ E i u a
Whakamāramatia	h a k a m a r a m a t i a
kōtiro	k o t i r o
tumanako	t u m a n a k o
tuwhera	t u w h e r a
whakaiti	wh~ E k a i t i
Kohikohinga	o i k o h i n g a
Tera	e r a
koinei	k o i n e i
koiora	k o i o r a
print	p r i nt~
rautau	r a u t a u
rereke	r e r e k e
taniwha	t a n i w a
tautuhi	t a w hy~ a
whakahaerehia	wh~ E k a h a e r e h i a
whakamōhio	wh~ E k a m o i o
with	w i c
Hawaiki	a w a i k i
Ora	r a
tuakiri	t u a k i r i
tāke	m a k e
Pēhea	a N h e a
haina	h a i n a
nuku	n u k u
peke	p e k e
whakatinana	wh~ E k a t i n a n a
Mo	o
huna	h u n a
pāpā	p a p
tiro	t i r o
tuna	t u n a
hourua	h o a
kōhatu	k o h a t u
tōu	a u
ōu	o u
Kāwana	a w a n a
Titiro	i t i r o
marau	r a u
ngana	N a n a
pango	p a n g o
tūāpapa	t u a t " u t " u
whakamana	wh~ E k a m a n a
Raukawa	a u k a w a
pāpori	p a p o r i
urunga	u r u N a
Kīngitanga	i N g i t a Ng~ a
Whakawhitiwhiti	h a k a wh~ E i t i wh~ E i t i
poraka	p o r a k a
tunu	t u n u
maori	m a o r i
whakaurua	wh~ E k a u r u a
Paraire	a r a i r
moenga	m o e n g a
wawe	w a w e
Henare	e n a r e
Waihoki	i h o k i
hiki	h i k i
horo	h o r o
kape	k a p e
nuitia	n u i  a
puritia	p u r i t i a
pāmu	p a m u
pōtitanga	p o t i t a Ng~ a
waitohu	w a i t o h u
whakatauira	wh~ E k a t a u i r a
Kahore	a h o r e
Whanake	h a n a k e
horoi	h o r o i
kaikōrero	k a i k k i o r e r o
kawanatanga	k a w a n a t a n g a
māra	m a r a
rori	r o r i
whakamatautau	wh~ E k a m a t a u t a u
whiwhinga	wh~ E i wh~ E i Ng~ a
Kīngi	i N g i
Pōti	o t i
kahu	k a h u
kaiwhakaako	S i r k a k o
matapaki	m a t a p a k i
oma	o m a
poti	p o t i
äkonga	3 k o N a
Pāngarau	a ng~ a d a u
one	o 7
rererangi	r e r a i n a N i
hoariri	h o a r i r i
kawa	k a w a
kōrerohia	k o r e r o h i a
maua	m a u a
mātanga	m a t a Ng~ a
tiakina	t i a k i n a
whakapiki	wh~ E k a p i k i
ū	u
herehere	h e r e h e r e
huihui	w i w i
komiti	k o m i t i
kōura	k o u r a
porowhita	p o r o wh~ E i t a
whakahua	wh~ E k a u l a
ātaahua	a t a h i
kaiārahi	k a i k k a r a h i
takahi	t a k a h i
tiriti	t i r i t i
whakangahau	wh~ E k a N a h a u
Āta	t a
Mäori	3 o r i
Taea	a e a
Tuku	u k u
Tumuaki	u m u a k i
Tāne	nj~ 3
Whakarongo	h a k a r o n g o
aromātai	a r o m a t a i
matauranga	m a t a u r a Ng~ a
ngutu	N u t u
poi	p o i
pūtau	p u t a u
toki	t o k i
Kihai	i a i
Ranginui	a N i n u i
Tae	a e
ahuwhenua	a w wh~ e n u a
koirā	k o i r
pitopito	p i t o p i t o
rauropi	r a u r o p i
tatauranga	t a t a u r a Ng~ a
tāutu	m a u t u
waipuke	w a i p u k e
whakareatanga	wh~ E k a r e a t a n g a
Kaitiaki	i t i a k i
Rūnanga	u n a Ng~ a
kano	k a n o
kare	k a r e
kōrua	k o r u a
pera	p e r a
pukupuku	p u k u p u k u
tōmua	a a
PouakoHe	o u a k o e
Rāwhiti	a wh~ E i t i
ea	e a
haki	h a k i
kiore	k i o r e
tīma	t i m a
wahanga	w a h a Ng~ a
hurihia	h u r i 7 i a
otaota	o t a o t a
tautohu	t a u t o h u
pehea	p e h e a
Hine	i n e
Pipiri	p i r i
Taku	a k u
kaipānui	k a i p a n u i
moko	m o k o
tahuna	t a h u n a
whati	wh~ E a t i
Tama	a m a
Wiki	i k i
māngai	m a N a i
patai	p a t a i
hautau	h a u t a u
horahanga	h o r a h a Ng~ a
kāhore	l h o r e
whakatakotoria	wh~ E k a t a k a t o r i a
ēngari	a N ng~ a d i
Pirimia	i r i m i a
Wai	a i
homai	h o m a i
kupenga	k u p e n g a
timatanga	t i m a t a n g a
ahurei	a h u r e i
kōkiri	k  i r i
kōrerotia	k o r e r o t i a
minita	m i n i t a
papakupu	p a p a k u p u
rama	r a m a
whakahou	wh~ E k a u
mauī	m a u i
rangatiratanga	r a N a t i r a t a n g a
kiko	k i k o
mauria	m a u r i a
tira	t i r a
tūhono	t u h o n o
Iho	h o
Nāna	nj~ 3
Ope	p e
kumara	k u m a r a
ritenga	r e g a
tātari	m a t a r i
tūnga	t u Ng~ a
waipiro	w a i p i r o
wāhitanga	a  h i t a Ng~ a
Otira	t i r a
auaha	a u a h a
haria	h a r i a
kaukau	k a u k a u
oku	o k u
rūma	r u m a
taunakitanga	t a u n a k i t a Ng~ a
tūru	t u r u
whakatō	wh~ E k a a
Pōneke	r 3 n e k e
atawhai	a t a l a i
aukati	a u k a t i
kirimana	l i m a n a
paenga	p u i Ng~ a
waeine	w a e i n e
whanonga	wh~ E a n o n g a
Aho	h o
mohiotia	o* h i o t i a
mona	m o n a
rata	r a t a
takoha	t a k o h a
Tamaki	a m a k i
Whakamana	h a k a m a n a
awatea	a w a t e a
kānga	k a nj~ 3 Ng ~ a
ohorere	h o r e r e
pīrangi	p i r a N i
takea	t a k e a
tuahine	t u a h i n e
wareware	w a r e w a r e
Huanga	u a Ng~ a
Maniapoto	a n i a p o t o
kohia	k o h i a
kōwhiri	k o wh~ E i r i
peka	p e k a
taitamariki	t a i t a m a r i k i
Kaupae	a u p a e
Kawana	a w a n a
Rohe	o h e
hōu	h o u
parirau	p e r a u
poaka	p o a k a
puke	p u k e
tauiwi	t a w i w i
tānga	m a Ng~ a
tūtaki	t u t a k i
Kirihimete	i r i h i m e t e
hekenga	h e k e n g a
hipa	h i p a
panoni	p a n o n i
tahua	h i
tapahi	t a p a h i
tāpirihia	m a p i r i h i a
Hāhi	a
Rāhoroi	a h o r o i
atahanga	a t a h a Ng~ a
koha	k o h a
kīanga	k i a Ng~ a
kōrerorero	k o r e r o r e r o
tohatoha	t o h a t o h a
Mahuru	a h u r u
Pouako	o u a k o
kapua	k a p u a
korerotia	k o r e r o t i a
mataku	m a t a k u
ngahuru	N a h u r u
para	p a r a
pāngia	p a N i
tihi	t i 7 i
toenga	t o e n g a
toko	t o k o m o
tōpana	a p a n a
whakawhānui	wh~ E k a w h a n u i
Mei	e i
Takawaenga	a k a w a i Ng~ a
iii	i i
koi	k o i
mara	m a r a
nekeneke	n e k 3 n 3 q k e
pahi	p a h i
pene	p e n e
pire	p i r
tangohanga	t a N o h a Ng~ a
tara	t a r a
tupapaku	t u p a p a k u
whakamuri	wh~ E k a m u r i
Ako	k o
Hui	u i
Kamupene	a m u p e n e
arataki	a r a t a k i
haramai	h a r a m a i
puhuruhurutanga	p u h u r u h u r u t a Ng~ a
puia	p u i a
rewa	r e w a
whakamātautau	wh~ E k a m a t a u t a u
āwangawanga	a w a N a w a Ng~ a
Kara	a r a
herea	h e r e a
hurihanga	h u r i 7 a Ng~ a
kaumatua	k a u m a t u a
main	m a i n
maru	m a* r u
pari	p a r i
umanga	u m a n g a
wehewehe	w e h e w e h e
whakaū	wh~ E k a u
Inā	n
Kotahitanga	o t a h i t a Ng~ a
Manatū	a n a t u
Whakahaere	h a k a h a e r e
hōhonu	h o h o n u
pōuri	p o u r i
raina	r a i n a
tākuta	m a k u t a
whaihua	wh~ E a i w a
whakanuia	wh~ E k a n u i a
Aroha	r o h a
Ia	a
Tapu	a p u
Waitaha	i t a h a
Whakatane	h a k a t a n e
hāhi	h a
karangatia	k a r a N a t i a
nohoanga	n o h o a Ng~ a
oho	h o
rāngai	r a N a i
tautohetohe	t a u t o h e t o h e
tomo	t o m o
Wairarapa	a i r a r a p a
Whakamārama	h a k a m a r a m a
aa	a
amuamu	a m u a m u
hū	h u
poro	p o r o
tapahia	t a p a h i a
wehea	w e h e a
whakaakoranga	wh~ E k a k o r a Ng~ a
Paoa	a o a
hoiho	h o i h o
paepae	p a e p a e
pua	p u a
reanga	r e a Ng~ a
tamāhine	t a m a h i n e
whakahaeretia	wh~ E k a h a e r e t i a
whakapiri	wh~ E k a p i r i
Ahorangi	h o r a N i
Kiwi	i w i
Wāhanga	a a Ng~ a
ama	a m a
awhi	r u f i
hapa	h a p a
kahurangi	k a h u r a N i
muka	m u k a
māua	m a i
ngaio	N a i o
ripoata	r i p o a t a
whakarea	wh~ E k a r e a
ōwehenga	o w e h e n g a
North	u r
Pai	a i
Pānui	a n u i
Tukuna	o v a s a
inenga	g a
kāre	k a r e
pārekareka	p a r e k a r e k a
tukunga	m o v a s a b i
tāku	m a k u
tūāhua	t u a w a
whakatupato	wh~ E k a t u p a t o
whiu	wh~ E i u
Ana	n a
Ariki	r i k i
Tū	u
Whānui	h a n u i
hokonga	h o k o n g a
kaiwhakawā	S i r k a a
konā	q o n i k
puninga	p u n i Ng~ a
takaro	t a k a r o
tautokona	t a u t o k o n a
tikina	t i k i n a
tohe	t o h e
āpiha	a o z g a
Kingi	b i N i
auraki	a u r a k i
hainatia	h a i n a t i a
hoia	h o i a
kapu	k a p u
kurī	k u r i
toe	t o e
tohungatanga	t o h u N a t a n g a
torotoro	t o r o t o r o
waimarie	w a i m a r i e
whakakotahi	wh~ E k a k o t a h i
whakawhanaketanga	wh~ E a b o r u f 3 n k e t a Ng~ a
whānuitia	wh~ E nj~ 3 i t i a
Kaiako	a y a k o
Tūroa	u r o a
kara	k a r a
ngāi	N a i
tuākana	t u a k a n a
Henrietta	e n r i e t t a
Kimihia	i m i h i a
Oketopa	k e t o p a
Tauira	a u i r a
Turi	u r i
hiranga	h i r a Ng~ a
hopukina	h o p u k i n a
kōnae	k o n a e
mataono	m a t a o n o
mati	m a C i
ngahau	N a h a u
pepeha	p e p e h a
riu	r i u
takahia	t a k a h i a
hohoro	h o h o r o
pere	p e r e
āheinga	a  i Ng~ a
Reipa	e i p a
noatia	n o a t i a
rongoa	r o N o a
tarai	t a r a i
u	u
Hoani	o a n i
Tahi	a h i
Tūwharetoa	u wh~ a r e t o a
Whakatau	h a k a t a u
hauwhā	h a u w h a
karangahia	k a r a N a h i a
kata	k a t a
kiwi	k i w i
kōti	k o t i
maimai	m a i m a i
maumahara	m a u m a h a r a
peita	p e i t a
ruarua	r u a r u a
tūpono	t u p o n o
whakahuatia	wh~ E k a w a t i a
whiringa	wh~ E i r i Ng~ a
ōkawa	 w e d a
Taua	a u a
Waiho	i h o
hora	h o r a
kotiro	k o t i r o
māia	m a i a
taia	t a i a
waihangatia	w a i h a N a t i a
whakataki	wh~ E k a t a k i
whetu	f e t u
Hauraki	a u r a k i
Maehe	a e e
Marama	a r a m a
Motu	o t u
Neke	e k e
Tu	u
Uenuku	e n u k u
hainatanga	h a i n a t a n g a
papai	p a p a i
putu	p u t u
raupatu	r a u p a t u
ruri	r u r i
tahu	t a h u
tohungia	t o h o N i
tē	t a N
whakarunga	wh~ E k a r u N a
Hauhau	a u h a u
Kahu	a h u
Mātāpunenga	a t a p u n i Ng~ a
Rongo	o n g o
Rātana	a t a n a
Tino	i n o
Whakaraparapatia	h a k a r a p a r a p a t i a
kaipōti	k a i p o t i
karo	k a r o
kauhoe	k a u h o e
tuihono	t u i h o n o
whakaturia	wh~ E k a t u r i a
Kāhore	a h o r e
Noho	h o
Whakaahua	h a k a h i
akoako	a k o a k o
harikoa	h a r i k a
kapi	k a p i
kāta	k a a t a
matapae	m a t a p a e
ngota	N o t a
poipoi	p o p o i p o i
roro	r o r o
tokotoru	t o k o  r u
tīpako	t o a k o
whanui	wh~ E a n u i
Papakupu	a p a k u p u
mīharo	m i e n a
mōrearea	m o r e a r e a
putiputi	p u t i m a p u t i 7
pūngāwerewere	p u n g a w e r a w e r e
whakakī	wh~ E k a k i
whakawakia	wh~ E k a w a k i a
ōhanga	o a Ng~ a
Pire	i r
ataahua	a t a h i
mārō	m a r o
nōna	n r 3 n a
pāpāho	p a p a h o
raranga	r a r a Ng~ a
tiketike	t i k e t i k e
turanga	t u r a Ng~ a
Hokianga	o k i a Ng~ a
Homai	t a i
Karere	a r e r e
Kerei	e r e i
ariki	a r i k i
kaiwhakatere	S i r k a t e r e
maro	m a* r o
pōwhiri	p o wh~ E i r i
tauhokohoko	t a u h o k o h o k o
whiriwhiria	wh~ E i r i wh~ E i r i a
Whiti	h i t i
hautoru	h a u t o r u
kaikorero	k a i k k i o r e r o
makariri	m a k a r i r i
taurite	t a u r i t e
whakapaunga	wh~ E k a p a u N a
Koirā	o i r
Takiwa	a k i w a
Tāpiritia	a p i r i t i a
Tīreni	i r e n i
aruhe	a r u e
hao	h a o
kōiwi	k o w i
matea	m a t e a
tuawhenua	m a r u f e n u a
whakakapi	wh~ E k a k a p i
whakatipuranga	wh~ E k a t i p u r a Ng~ a
whakatupu	wh~ E k a t u p u
wāwāhi	a  a
Apirana	p i r a n a
Kore	u r e
Maunga	a u N a
Otirā	t i r
Pae	a e
Poneke	n e k e
matapihi	m a t a p i 7 i
ngoikore	N o i k o r e
pirau	p i r a u
puehu	p u e h u
tamahine	t a m a h i n e
tāia	m a i a
whakamāori	wh~ E k a m a o r i
Heretaunga	e r e t a u N a
Mahere	i*
Noema	o e m a
Pānuitia	nj~ 3 i t i a
Whāriki	h a r i k i
iahiko	i a i k o
kairangahau	k a i r a N a h a u
kētia	q e t i a
pata	p a t a
pukenga	p u k 3 N a
tīkina	t i k i n a
whakaharahara	wh~ E k a h a r a h a r e y
whakamau	wh~ E k a m a u
whakawhirinaki	wh~ E k a l i r i n a k i
īngoa	i N g o a
Hepetema	e p e t e m a
Nei	e i
Puhi	a i
Tamariki	a m a r i k i
kimihia	k i m i h i a
korua	k o r u a
kōpaki	k o l o
maramara	r a m a r a
motokā	t o  l
takenga	t a k e n g a
tuturu	t u t u r u
whaikōrero	wh~ E a i k o r e r o
whakahaeretanga	wh~ E k a h a e r e t a Ng~ a
Ētahi	t a h i
rū	r u
tahae	t a h a e
teihana	t e i h a n a
tima	t i m a
tokoiti	t o k o i t i
whaitake	wh~ E a i t a k e
whakahāngai	wh~ E k a h a N a i
whakarōpū	wh~ E k a r o p u
Anō	n o
Komiti	o m i t i
Mau	a u
Tara	a r a
aroturuki	a r o t u r u k i
hurihuri	h u r i 7 u r i
kaituku	k a i t u k u
kirihou	k i r i h o u
kona	q o n a
kukume	k u k u
maimoatanga	m a i y a t a n g a
mitarau	m i t a r a u
paanga	p a n g a
parāoa	p i a o a
ripanga	r i p a n g a
tuawhā	t u a w h a
tutu	t u t u
uira	k i r a
whakapaipai	wh~ E k a p a i p a i
whakatinanatanga	wh~ E k a t i n a n a t a n g a
Aratohu	r a t o h u
Hangaia	a N a i a
Hiku	i k u
Kupenga	u p e n g a
Mema	3 m a
Teina	e i n a
kaihautū	k a i h a u t u
kaute	k a u t e
more	m o r e
reti	r e t i
tēpu	t a N p u
whakatakotoranga	wh~ E k a t a k a t o r a Ng~ a
whatitiri	wh~ E a t i t i r i
āwhata	a wh~ E a t a
Atu	t u
Hakihea	a k i h e a
Koiora	o i o r a
Mahara	a h a r a
Upoko	p o k o
Whāia	h a i a
awe	a w e
hautanga	h a u t a Ng~ a
kaupae	k a u p a e
koro	k o r o
kō	k o
māpere	m a p e r e
ou	o u
raihana	r a i h a n a
torutoru	t o r u t o r u
uwha	u w a
Āe	e
ēhea	a N h e a
Heke	e k e
Kaikohe	i k o h e
Rata	a t a
herenga	h e r e n g a
hiwi	h i w i
kāwai	l w a i
makawe	m a k a w e
ngawari	N a w a r i
pana	p a n a
puni	p u n i
raatou	r a a t o u
ruru	r u r u
taiapa	t a i a p a
Kāi	a i
Manaia	a n a i a
Tāhei	a h e i
Tākuta	a k u t a
auau	a u a u
kaihanga	k a i h a Ng~ a
kauae	k a u a e
kokonga	k o k o n g a
pakitara	p a k i t a r a
raweke	r a w e k e
taiaha	t a i a h a
tangihanga	t a N i h a Ng~ a
tuhituhinga	t u h i t i Ng~ a
Ngake	g a k e
Waiariki	a y a r i k i
eetahi	e th~ a h i
karapu	k a r a p u
maia	m a i a
mihinare	m i h i n a r e
motika	m o t i k a
mōu	m o u
otira	o t i r a
ropu	r o p u
uiuinga	k i u i Ng~ a
whakararo	wh~ E k a r a r o
whakarerekē	wh~ E k a r e r e k a N
Mena	e n a
Nana	a n a
Ngai	g a i
Ranga	a N a
Tane	a n e
Whakarea	h a k a r e a
aitua	i t u a
hōhipera	h o i p e r a
meka	m e k a
neherā	n e h e r
pena	p e n a
pikinga	p i k i Ng~ a
rahinga	r a h i n g a
rōrahi	r o r a h i
tauhou	t a w u
whakakaha	wh~ E k a k a h a
whakatupuranga	wh~ E k a t u p u r a Ng~ a
Ākonga	q o n g a
Kōeke	o e k e
Porirua	o r i r u a
Rarotonga	a r o t o n g a
Ratonga	a t o n g a
Rēhia	a N i a
Tata	a t a
Tatauranga	a t a u r a Ng~ a
hira	h i r a
hāunga	h a u N a
kaumoana	k a u m o a n a
kohatu	k o h a t u
maku	m a k u
motukā	m o t u l
mura	m u r a
mātai	m a t a i
paraoa	p a r a o a
paru	p a r u
tahataha	t a h a t a h a
tohorā	t o h o r
utaina	u t a i n a
werohia	w e r o h i a
whakatairite	wh~ E k a t a i r i t e
whakatenatena	wh~ E k a t e n a t e n a
Ōtautahi	t a u t a h i
Mutu	u t u
Rangitāne	a N i t a n e
Tika	i k a
Tukua	u k u a
Turanga	u r a N g a
Tutanekai	u t a n e k h a i
Waiapu	a y a p u
harore	h a r o r e
kaihokohoko	k a i h o k o h o k o
kaitākaro	k a i t a k a r o
kakara	k a k a r a
kītanga	k i t a Ng~ a
manawanui	m a n a w a n u i
miharo	m i e n a
moea	m o e a
motuka	m o t u k a
nehe	n e h e
panui	p a n u i
taina	t a i n a
taraka	t a r a k a
tautohe	t a u t o h e
tumu	t u m u
whakarauora	wh~ E k a r a w o r a
whakariterite	wh~ E k a r i t E r i t e
Haina	a i n a
Kiwa	i w o
Matatini	m a t a t i n i
akona	a k o n a
haurehu	h a u r e h u
hue	h u e
kaka	k a k a
koroni	k o r o n i
mīhini	m i h i n i
ngau	N a u
papanga	p a p a n g a
tāpiria	m a p i r i a
whakanoho	wh~ E k a n o h o
whakarewa	wh~ E k a r e w a
whakataurite	wh~ E k a t a u r i t e
Hangarau	a N a r a u
Hāunga	a u N a
Mihi	i 7 i
Parihaka	a r i h a k a
Pita	i t a
Puea	u e a
Pēwhairangi	a N wh~ a i r a N i
Waititi	i t i t i
atamira	a t a m i r a
auahi	a u a h i
kake	k a k e
maa	m a 7 a
mahunga	m a u N a
mātāmua	m a t a a
ngako	N a k o
oriori	u r i o r i
pahikara	p a i k a r a
pepe	p E p E 7
tao	t a o
taro	t a r o
taru	t a r u
taunaki	t a u n a k i
tina	t i n a
wh	w
whakatā	wh~ E k a t a
Kaha	a h a
Tohua	o w a
Tēnei	a N n e i
Whakaritea	h a k a r i t e a
Whina	h i n a
hararei	h a r a r e i
manaakitanga	m a n a k i t a Ng~ a
maoa	m a o a
mōteatea	m o t e a t e a
nau	n a u
ngākaunui	N a k a u n u i
paunga	p a u N a
pēnā	l u a N n
taangata	t a N a t a
taatau	t a t a u
teenei	% t e n e i
tü	t u*
wao	w a o
whakaingoatia	wh~ E k a i N o a t i a
whakamihi	wh~ E k a m i 7 i
whakamāramatanga	wh~ E k a m a r a m a t a n g a
whakapūmau	wh~ E k a p u m a u
wharenui	wh~ E a r e n u i
ātete	a t e t e
Kāhui	a w i
Ngapuhi	g a p o
Runanga	u n a Ng~ a
Timi	i m i
Whakataunga	h a k a t a u N a
apopo	a p o p o
hika	h i k a
hiku	h i k u
honoa	h o n o a
kumea	k u m e a
kīhai	k i a i
marea	m a r e a
ngārara	N a r a r a
puhi	p u h i
rawatia	r a w a t i a
rūnanga	r u n a Ng~ a
tohaina	t o h a i n a
whaia	wh~ E a i a
whakarere	wh~ E k a r e r e
wheke	wh~ e k e
Hirini	i r i n i
Kōmihana	k o j i h a n a
Mate	a t e
Ngohe	g o h e
Rātapu	a t a p u
eka	e k a
haumi	h a u m i
huaina	w a i n a
hākari	h a k a r i
kapo	k a p o
punga	p u N a
punua	p u n u a
ruku	r u k u
rōia	r o i a
tuara	t u a r a
whakaekea	wh~ E k a e k e a
whakahoutanga	wh~ E k a h o u t a Ng~ a
whiriwhiringa	wh~ E i r i wh~ E i r i Ng~ a
āe	a e
Ahupūngao	h u p u n g a o
Koro	o r o
Nāwai	a w a i
Peter	e t e r
Puketeraki	u k e t e r a k i
Pēpuere	a N p u e r e
Rūnaka	u n a k a
Taiao	i a o
Whakaata	h a k a a t a
Whātaitai	h a t a i t a i
aka	a k a
anoo	a n o
hipi	h i p i
iri	i r i
pononga	p o n o n g a
pāwhiri	p a wh~ E i r i
pūtohu	p u t o h u
raakau	r a k a u
roimata	r o i m a t a
tāpaetanga	m a p a e t a Ng~ a
tāua	m a i
tōkeke	h  e k e
uku	u k u
waiaro	w a i 7 r o
whakaahuatia	wh~ E k a a w a t i a
whakaatuhia	wh~ E k a t i a
whakamaharatanga	wh~ E k a m a h a r a t a n g a
whakaratohia	wh~ E k a r a t o h i a
whakarārangi	wh~ E k a r a r a N i
whakatutukitanga	wh~ E k a t u t u n u N  n g a
Harakeke	a r a k e k e
Heuheu	u u
Huirapa	k i r a p a
Hōngongoi	r 3 n m a  i
Mere	e r e
Mihinare	i h i n a r e
Ngaheu	g a h a u
Taupo	a u p o
Tiaki	i a k i
ahei	m a h e i
hangarite	h a N a r i t e
hine	h i n e
huānga	a Ng~ a
karangatanga	k a r a N a t a n g a
mātao	m a t a o
pakupaku	p a k u p a k u
pia	p i a
pōturi	p o t u r i
repo	r e p o
rāwhiti	r a wh~ E i t i
titoa	t i t o a
toroa	t o r o a
Āti	t i
Kairangi	a i r a N i
Mahia	a h i a
Mahuta	a h u t a
Pouaka	o o a k a
Puanga	u a Ng~ a
Raki	a k i
Rangahau	a N a h a u
Rere	e r e
Tangi	a n g i
Tihema	i h e m a
Waitara	i t a r a
ate	a t e
huarere	w a r e r e
hā	h a
kaitirotiro	k a i t i r o t i r o
kaiwhiwhi	S i r i w
karahipi	k a r a h i p i
kauhau	k a u h a u
kiritaki	k i r i t a k i
korowai	k o r o w a i
kowhatu	k o w h a t u
kōaro	k o a r o
kōwhai	k o wh~ E a i
kōwhiria	k o wh~ E i r i a
moemoeā	m o e m o e
piriona	p i r i o n a
rae	r a e
tāhuhu	m a u h u
tārua	m a r u a
whakatangi	wh~ E k a t a n g i
whakatata	wh~ E k a t a t a
whakatauranga	wh~ E k a t a u r a Ng~ a
āwhinatia	a wh~ E i n a t i a
Apanui	p a n u i
Mane	a n e
Taupō	a u p o
Tongarewa	o N a r e w a
Tūranga	u r a Ng~ a
an	a n
ekenga	e k e n g a
horahia	h o r a h i a
huia	w i a
kaainga	k a i Ng~ a
kaitito	k a i t i t o
korokoro	k o r o k o r o
manene	m a n e n e
matawaka	m a t a w a k a
mö	m o
paemahana	p a e m a h a n a
pūwāhi	p u a
raanei	r a n e i
turi	t u r i
uhia	a i a
whakaakona	wh~ E k a k o n a
whakaara	wh~ E a k a d a
whakakitenga	wh~ E k a k i r e n g a
whiri	wh~ E i r i
ëtahi	3 a h i
ākona	a k o n a
īnanga	i N a Ng~ a
Aurere	u r e r e
Kawekawe	a w e k a w e
Kirikiriroa	i r i k i r i r o a
Kāre	a r e
Maketu	a k e t u
Ngāpuhi	g a k
Tūmatauenga	u m a t a u e n g a
hihi	h i 7 i
kohuru	k o h u r u
kori	k o r i
miro	m i r o
māharahara	m a h a r a h a r e y
mōkai	m o k a i
paheko	p a h e k o
paparanga	p a p a r a Ng~ a
puru	p u r u
pānuitia	p nj~ 3 i t i a
pātaka	p a t a k a
rahui	y a w a i
rāhui	r a w i
taatai	t a t a i
tūmataiti	t u m a t a i t i
whakarahi	wh~ E k a r a h i
whakaraupapa	wh~ E k a r a u p a p a
whutupōro	wh~ E u t u p o r o
Hopihona	o p i h o n a
Kuki	u k i
Kāwhia	a wh~ E i a
Mohi	h i
Oranga	r a n g a
Tuhoe	a h o e
Wairoa	a i r o a
Whaea	h a e a
korenga	k o r e n g a
meatia	m e a t i a
mihingare	m i h i N a r e
mē	m a N
pūkete	p u k e t e
rapa	r a p a
rapua	r a p u a
tahumaero	t a h u m a e r o
taupatupatu	t a u p a t u p a t u
toitū	t o i t u
umu	u m u
whakawa	wh~ E k a w a
wharekura	wh~ E a r e k u r a
whutupaoro	wh~ E u t u p a o r o
wāriu	w a r i u
Ano	n o
Atawhai	t a l a i
Hune	u n e
Katoa	a t o a
Taitokerau	i t o k e r a u
Taurangi	a u r a N i
arahi	a r a h i
ena	e n a
hemo	h e m o
kaihauturu	k a i h a u t u r u
kainoho	k a i n o h o
kaki	k a k i
karekau	k a r e k a u
kui	k u i
kuku	k u k u
pitihana	p i t i e n a n a
purapura	p u r a p i r a
pātara	p a t a r a
pōhēhē	p o
rarangi	r a r a N i
tukinga	t u k i Ng~ a
tūmahi	t u m a h i
tūrangawaewae	t u r a N a w a e w a e
waikano	w a i k a
waikawa	w a i k a w a
whakamāramatia	wh~ E k a m a r a m a t i a
ūpoko	u p o k o
Ihaka	h a k a
Kākano	a k a
Manawatū	a n a w a t u
Mark	a r
Motuhake	o t u h a k e
Rārangi	a r a N i
Unit	n i t
Whakamāramahia	h a k a m a r h i a
kairangi	k a i r a N i
karaehe	k a r a e e
kauri	k a u r u
kiihia	k i i a
manako	m a n a k o
pirangi	p i r a N i
poho	p o h o
puare	p u a r e
pūoro	p u o r o
ruma	r u m a
takanga	t a k a n g a
tatū	t a t u
tuaka	t u a k a
tūhonohono	t u h o n o h o n o
waihoki	w a i h o k i
wananga	w a n a Ng~ a
whakakorea	wh~ E k a k o r e a
whakakorehia	wh~ E k a k o r e h i a
ārainga	a r a i Ng~ a
Komihana	o m i h a n a
Korero	o r e r o
Ta	a
Toko	o k o
Whakaaro	h a k a d o
ahuareka	a w a r e k a
are	a r e
honohono	h o n o h o n o
kaiwhakamahi	S i r k a m a h i
koko	k o k o
marangai	r a N a i
mataara	m a t a r a
matakitaki	m a t a k i t a k i
memeha	m e m  a
mihini	m i h i n i
omaoma	t a o m a
oo	o
paearu	p u i a r u
panga	p a n g a
parauri	p a r a u r u
pirepire	p i r e p i r
pēwhea	l u a N wh~ e a
pūkoro	p u k o r o
rawhiti	n a l i t i
rotarota	r o t a r o t a
tuitui	t u i t u i
turoro	t u r o r o
tāpui	m a p u i
waia	w a i a
wetewete	w e t e w e t e
Ae	e
Awarua	w a r u a
Kōwhiri	o wh~ E i r i
Matiu	a t i u
Opotiki	p o t i k i
Pounamu	o u n a m u
Tinirau	i n i r a u
Tongariro	o N a r i r o
Wairua	a i r u a
arai	a r a i
arero	a r e r o
ihirangi	i h i r a N i
kamo	k a m o
makere	k e r e
mautohe	m a u t o h e
pakirehua	p a k i r e w a
poka	p o k a
poroporoaki	p o r o p o r o a k i
pungarehu	p u a r e h u
pupū	p u p u
puāwai	p u a w a i
reorua	r E o r u a
rokohanga	r o k o h a Ng~ a
tauanga	t a w a Ng~ a
tirotirohia	t u r o t i r o h i a
titi	t i
tāhei	m a h e i
tāroaroa	m a r o a r o a
tūpato	t u p a t o
whaiwhai	wh~ E i r a i
whakaarotia	wh~ E a k a d o t i a
whakahaerenga	wh~ E k a h a e r e n g a
whakatu	wh~ E k a t u
whakatūpato	wh~ E k a t u p a t o
whana	wh~ E a n a
Ināianei	n a e n u
Kati	a t i
Taka	a k a
hāpori	h a p o r i
hōnore	h r 3 n o r e
ihi	i 7 i
inoi	i n o i
kanae	k a n a e
kiripuaki	k i r i p o a k i
koura	k o u r a
kīnaki	k i N k i
kīwaha	k i w a h a
matatini	m a t a t i n i
mokai	m o k a i
nawe	n a w e
nūpepa	n u p e p a
pani	p a n i
pāremata	p a r e m a t a
pōtae	p o t a e
rironga	r i r o n g a
tauranga	t a u r a Ng~ a
tokowhā	t o k o w h a
tāpae	m a p a e
tūroro	t u ph~ u
whakaingoa	wh~ E k a i N o a
whakairi	wh~ E k a i r i
whakama	wh~ E k a m a
whakamahana	wh~ E k a m a h a n a
whakamanahia	wh~ E k a m a n a h i a
whakatauhia	wh~ E k a t a u h i a
whiore	wh~ E i o r e
wātaka	w a t a k a
Ākarana	k a r a n a
ākau	a k a u
Hongoeka	o N o e k a
Kōwhiringa	o wh~ E i r i Ng~ a
Otiia	t i a
Poutini	o u t i n i
Rehua	e w a
Tairāwhiti	a i r a wh~ E i t i
Tētahi	a N t a h i
aahua	a h i
huaki	w a k i
hūnuku	h u n u k u
kaikawe	k a i k k i a w e
kirikiri	k i r i k i r i
kooti	o t i
kuraina	k u r a i n a
kāwana	l w a n a
mokemoke	m o k e m o k e
nohoia	n o h o i a
pātuhi	p a t i
pīni	p i n i
pūtoru	p u t o r u
tahitia	t a h i t i a
taiepa	t a i e p a
takere	t a k e r e
tiwhikete	t i wh~ E i k e t e
tutaki	t u t a k i
wahie	w a h i e
waiatatia	w a i a t a t i a
whaimana	wh~ E a i m a n a
whakawakanga	wh~ E k a w a k a n g a
Āniwaniwa	n i r 3 w a
ātea	a t e a
Hanuere	a n u e r e
Hauauru	a u a u r u
Hiko	i k o
Hone	o 7
Kapiti	a p i t i
Maru	a r u
Mua	u a
Paerewa	a e r e w a
Wenerei	e n e r e i
Whāinga	h a i Ng~ a
aituā	i t u
heketea	h e k e t e a
kaihoe	k a i h o e
karihi	k a r i 7 i
keke	k e k e
kereru	k e r a i n u
korikori	k o r i k o r i
manaakitia	m a n a k i t i a
mimiti	m i m i t i
mōkihi	m  i 7 i
ngaki	N a k i
ngarara	N a r a r a
paura	p a u r a
putake	p u t a k e
rereketanga	r e r e k e t a Ng~ a
rita	r i t a
rokiroki	r o k i r o k i
rīpoata	r o o a t a
tahaki	t a h a k i
teka	t e k a
that	th~ a t
tukino	t u k i n o
tupato	t u p a t o
tëtahi	t 3 a h i
tūhuratanga	t u u r a t a n g a
whainga	wh~ E a i Ng~ a
whakahoahoa	wh~ E k a h o a h o a
whakamutu	wh~ E k a m u t u
whakaongaonga	wh~ E k a o N a o n g a
whakawehe	wh~ E k a w e h e
whangai	wh~ E a N a i
Āpiha	p i h a
Āwhina	wh~ E i n a
Kahurangi	a h u r a N i
Matū	a t u
Park	a r
Poutama	o u t a m a
Pērā	a N r
Pū	u
Tauiwi	a u i w i
Tokomaru	o k o m a r u
Whanau	h a n a u
ahatia	a h a t u i a
anuhe	a n u e
etehi	e t e h i
hi	h i
hokowhitu	h o k o w h i t u
manga	m a n g a
papaki	p a p a k i
poua	p o u a
rare	r a r e
rourou	r o u r o u
rāwaho	r a w a h o
tatauria	t a t a u r i a
tautokohia	t a u t o k o h i a
tawahi	t a w a h i
tereina	t e r a i n a
tia	t i a
tonutanga	t o n u t a Ng~ a
tuatahitia	t u a t a h i t i a
waituhi	w a i t u h i
waro	w a
whaitua	wh~ E a i t u a
whakatauki	wh~ E k a t a u k i
whakautua	wh~ E k a u t u a
whakawātea	wh~ E k a w a t e a
whānautanga	wh~ E nj~ 3 a u t a Ng~ a
whētui	w  t u i
Ōtaki	t a k i
Heoti	e o t i
Huia	k i a
Iti	t i
Karaitiana	a r a i t i a n a
Kitea	i t e a
Kāpiti	a
Mea	e a
Rangahautia	a N a h a u t i a
Urewera	r e w e r a
aronui	a r o n u i
keehi	k e e h i
motopaika	m u t u p a i k a
ngâ	N a
nona	n o n a
nēhi	n a N
ohotata	h o t a t a
okioki	o k i o k i
pona	p o n a
pooti	p o t i
rino	r i n o
ruia	r u i a
takahanga	t a k a h a Ng~ a
torotika	t o r o t i k a
tāngia	m a N i
tārai	m a r a i
uauatanga	u a u a t a n g a
whakamarumaru	wh~ E k a m a r u m a r u
whakamaua	wh~ E k a m a u a
whakaminenga	wh~ E k a m i n i Ng~ a
whakamoemiti	wh~ E k a m o r e p e
whakarawe	wh~ E k a r a w e
whakarerea	wh~ E k a r e r e a
whakarērea	wh~ E k a r a N r e a
whakawā	wh~ E k a a
Ōtākou	m a k o u
Hāmoa	a m o a
Hōne	r 3 n e
Hūrae	u r a e
Irirangi	r a N i
Katorika	a t u r i k a
Kawerau	a w e r a u
Korimako	u r i m a k o
Kāreti	a r e t i
Rāwhitiroa	a wh~ E i t i r o a
Rāwiri	a w i r i
Tangohia	a N o h i a
Tumu	u m u
Whiro	h i r o
Whātua	h a t u a
aitanga	i t a Ng~ a
haepapa	h a e p a p a
hakari	h a k a r i
hihiri	h i h i r i
huakita	w a k i t a
kaimoana	k a i k k y a n a
kari	k a r i
mangai	m a N a i
manuka	m a n u k a
matawhānui	m a t a w h a n u i
maui	m a u
mena	m e n a
moku	m o k u
māku	m a k u
nanakia	n a n a k i a
ngata	g a t a
pane	p a n e
penapena	p e n a p e n a
pōro	p o r o
rätou	r 3 t o u
their	th~ e r
tote	t o t e
tuanui	t u a n u i
tāra	m a r a
tī	t i
tītī	t i t i
waiwai	w a i w a i
whakaaroaro	wh~ E a k a d o a r o
whakamataku	wh~ E k a m a t a k u
whakaoranga	wh~ E k a o r a Ng~ a
whakawhanakehia	wh~ E a b o r u f 3 n k e h i a
Āpirana	p i r a n a
Ahuriri	h u r i r i
Paremata	a r e m a t a
Puta	u t a
Raumati	a u m a t i
Tāwhirimātea	a wh~ E i r i m a t e a
arahina	a r a h i n a
arohaehae	a r o h a e h a e
heihei	h e i h e i
henemita	h e n i m i t a
it	i t
kanga	k a n g a
kingi	k i N i
kohikohinga	k o h i k o h i n g a
maranga	r a Ng~ a
mirumiru	m i r u m i r u
morehu	m o r e h u
mātaitai	m a t a i t a i
mātaki	m a t a k i
ngaarara	g a r a r a
pakiaka	p a k i a k a
papatipu	p a p a t i p u
paremata	p a r e m a t a
poropiti	p o r o p i t i
pītara	p i t a r a
pūrua	p u r u a
tauākī	t a w a k i
tio	t i o
totoka	t a t o k a
unahi	u n a 7 i
whakaarahia	wh~ E a k a d a h i a
whakahe	wh~ E k a e
whakamahara	wh~ E k a m a h a r a
whitinga	wh~ E i t i Ng~ a
Kawiti	a w i t i
Pakihi	a k i 7 i
Piki	i k i
Roopu	o p u
Tamanuiterā	a m a n u i t E r
Tiamana	i a m a n a
Tūhuratia	u u r a t i a
Uru	r u
Whakapā	h a k a p u
aranga	a r a Ng~ a
hitori	h i t o r i
huakina	w a k i n a
hāereere	h a e r a e r e
kererū	k e r a i n u
kākāriki	k a a k a r i k i
motoka	m o t o k a
mätauranga	m a g a  n g a
pangia	p a N i
pauna	p a u n a
pānuihia	p nj~ 3 i h i a
taimaha	t a i m a h a
toronga	t o r o n g a
tupeka	t u p e k a
tāpiritia	m a p i r i t i a
tātaki	m a t a k i
tāutuhia	m a u t u X i a
tēra	t a N r a
whakamanaia	wh~ E k a m a n a i a
whakamatau	wh~ E k a m a t a u
whakamāoritanga	wh~ E k a m a o r i t a Ng~ a
whakararu	wh~ E k a r a r u
whakareatia	wh~ E k a r e a t i a
whakatauria	wh~ E k a t a u r i a
whakatūnga	wh~ E k a t u Ng~ a
whakaurunga	wh~ E k a u r u N a
whakawhitia	wh~ E k a wh~ E i t i a
āporo	a p o r o
Hana	a n a
Hononga	n o n g a
Hānuere	nj~ 3 a e r e
Moriori	u r i o r i
Māngai	a N a i
Ngoi	g o i
Pakiwaitara	a k i w a i t a r a
Rangatiratanga	a N a t i r a t a n g a
Ropu	o p u
Tahiti	a h i t i
Tautake	a u t a k e
Toku	o k u
Waru	a r u
Whakaputanga	h a k a p u t a Ng~ a
Wikitōria	i k i a r i a
haruru	h a r u r u
hawhe	h a l e
kawenata	k a w e n a t a
keri	k e r i
maakete	m a k e t e
maatou	m a a t o u
mārika	m a r i k a
patunga	p a t u N a
pihikete	p i t i k e t e
piko	p i k o
poupou	p o u p o u
rapunga	r a p u N a
rōpu	r o p u
takotoranga	t a k a t o r a Ng~ a
tokorima	t o k o r i m a
tunua	t u n u a
tōraro	a r a r o
whakamanatia	wh~ E k a m a n a t i a
whakaoho	wh~ E k a o h o
whakapuakina	wh~ E k a p o a k i n a
whakawehi	wh~ E k a w e h i
whata	wh~ E a t a
whāriki	w h a r i k i
Ūpoko	p o k o
ūngeri	u n g e r i
Hēmi	a N nd~ e i
Ihipa	h i p a
Manawa	a n a w a
Naku	a k u
Nama	a m a
One	n e
Pari	a r i
Pewhairangi	e w a i r a N i
Pātai	a t a i
What	h a t
angitū	a N i t u
hiakai	h i a k a i
kaingākau	k a i N a k a u
kaipatu	k a i p a t u
karaihe	k a r a i e
kīrehe	k i r e e
matakite	m a t a k i t e
meinga	m e i Ng~ a
muru	m u r u
mä	m a g
naianei	n a i a n e i
naku	n a k u
niupepa	n i u p e p a
paipa	p a i p a
piriti	p i r i t i
piro	p i r o
pātītī	p a t i t i
taihoa	t a i h o a
taokete	t a k e t e
waatea	w a a t e a
whakamāoritia	wh~ E k a m a o r i t i a
whakaruruhau	wh~ E k a r u r u h a u
whakawhetai	wh~ E k a wh~ e t a i
wheua	wh~ e i
wē	w a N
Ahu	h u
Aotea	o t e a
Kae	a e
Kawenata	a w e n a t a
Koroni	o r o n i
Mahuika	a w i k a
Mārama	a r a m a
Peretānia	e r e t nj~ 3
Pūtea	u t e a
Tāpiripiri	a p i r i p i r i
Tāpiritanga	a p i r i t a Ng~ a
Wherowhero	h e r o wh~ e r o
anei	a n e i
anōtia	a n o t i a
hae	h a e
hangai	h a N a i
hapai	h a p a i
hauota	h a w o t a
kiromita	l o m i t a
kuhuna	k u h u n a
kīngi	k i N g i
kōhao	k o a o
mahanga	m a h a Ng~ a
moheni	o* h e n i
motumotu	m o t u m o t u
mārire	m a r
ohaoha	o h a o h a
pipi	p i p i
ranga	r a n g a
raupapatanga	r a u p a p a t a n g a
rongohia	r o N o h i a
rōpinepine	r o p i n e p i n e
tuarā	t u a r
tui	t u i
tukituki	t u k i t u k i
tuumomo	t u m o m o
tōpito	a p i t o
whaka	wh~ E a k a
whakahiato	wh~ E k a h i a t o
whakapaetia	wh~ E k a p a e t i a
Akoranga	k o r a Ng~ a
Hoko	o k o
Iharaira	h a r a i r a
Makaawhio	a k a u f i o
Martin	i t i n
Matau	a t a u
Paetae	a e t a e
Pei	e i
Pepuere	e p u e r e
Purapura	u r a p i r a
Pāho	a h o
Rangitukutuku	a N i t u k u t u k u
Roa	o a
Ruru	u r u
Tame	a m e
Wera	e r a
Whakatāne	h a k a t a n e
arohia	a r o h i a
awangawanga	a w a N a w a Ng~ a
haunga	h a u N a
hura	h u r a
hōiho	h o i h o
kaitakaro	k a i t a k a r o
koroheke	k o r o h e k e
kōawa	k o w e d a
kōharinga	k o a r i Ng~ a
maka	m a k a
mama	m a m a
matimati	m a t i m a t i
moemoea	m o e m o e a
paihikara	p a i i k a r a
purei	p u r e i
raukura	r a u k u r a
ririki	r i r i k i
ruihi	r u i 7 i
rōnaki	r r 3 n a k i
taitama	t a i t a m a
tapuwae	t a p u w a e
tauaromahi	t a w a r o m a h i
tinihanga	t i n i h a Ng~ a
turakina	t u r a k i n a
tātaitanga	m a t a i t a Ng~ a
whakaea	wh~ E k a e a
whakarereke	wh~ E k a r e r e k e
whitianga	wh~ E i t i a Ng~ a
āpōpō	a t E n E p o
Hami	a m i
Kahukura	a h u k u r a
Kaihauturu	i h a u t u r u
Kaipara	i p a r a
Kawakawa	a w a k a w a
Mauri	a u r u
Onehunga	n e h u N a
Pānuihia	nj~ 3 i h i a
Pūrongo	u r o n g o
Ra	a
Tāwhiao	a wh~ E i a o
Whakatū	h a k a t u
hauauru	h a u a u r u
hauhā	h a u h a
hikoi	h i k o i
inea	i n e a
kaiwhaiwhai	S i r i r a i
korekore	k o r e k o r e
mahitahi	m a h i t a 7
maramataka	r a m a t a k a
miramira	m i r a m i r a
mou	m u
nohonga	n o h o n g a
noke	n o k e
pahū	p a h u
popo	p o p o
pāhekoheko	p a h e k o h e k o
pēhi	l u a N
pēne	l u a N n e
rangimārie	r a N i m a r i e
rango	r a n g o
ruahine	r u a h i n e
rīwai	r i w a i
taparau	t a p a r a u
tarutaru	t a r u t a r u
taurekareka	t a u r e k a r e k a
tautuhia	t a u t u X i a
whakahoutia	wh~ E k a h o u t i a
whakarara	wh~ E k a r a r a
whakarāpopoto	wh~ E k a r a p o p o t o
whakawhānau	wh~ E k a w h a n a u
wharekai	wh~ E a r e k h a i
whiria	wh~ E i r i a
Ake	k e
Hori	o r i
Irawaru	r a w a r u
Moe	o e
Moutere	o u t e r e
Ngatoro	g a t o r o
Rangihaeata	a N i t a e a t a
Rewi	e w i
Rukuwai	u k u w a i
Takurua	a k u r u a
Taniwha	a n i w a
Whakaarohia	h a k a d o h i a
Wharekauri	h a r e k a u r u
White	h i t e
Wāhi	a
anahe	a n a e
haupū	h a u p u
hohou	h o h o u
hāngī	h a N i
kaiwaiata	S i r 3 a t a
kauwhau	k a u w h a u
kohu	k o h u
mare	m a r e
marie	m a r i e
matemate	m a t e m a t e
ngētehi	N a N t e h i
paheke	p a h e k e
pao	p a o
paua	p a u a
pātapa	p a t a p a
pī	p i
rangahautanga	r a N a h a u t a Ng~ a
raupatutia	r a u p a t u t i a
taona	t a o n a
tohora	t o h o r a
toia	t o i a
tātaitai	m a t a i t a i
tōnā	a n
tūtū	t u t u
uniana	u n i a n a
waiora	w a i o r a
whakaawe	wh~ E k a w e
whakangaro	wh~ E k a N a r o
whakatangitangi	wh~ E k a t a N i t a n g i
whakauruhia	wh~ E k a i a
whakawhiwhi	wh~ E k a l i w
wikitoria	w i k i t o r i a
ākina	a k i n a
Ahi	h i
Aute	u t a
Hai	a i
Hau	a u
Hurinui	u r i n u i
King	i N
Mātaiako	a t 3 a k o
Nuku	u k u
Pōmare	k o j a r e
Ringatū	i N a t u
Rānana	a n a n a
Tairawhiti	a o n a l i t i
Taraipiunara	a r a i p i u n a r a
Tukutuku	u k u t u k u
Tuwharetoa	u w h a r e t o a
Whakahoki	h a k a h o k i
awaawa	a w a w a
haeretia	h a e r e t i a
hu	h u
hātepe	h a t e p e
kaiarahi	k a i a r a h i
kao	k a o
kaupeka	k a u p e k a
koinā	k o i N
koiwi	k o w i
korerohia	k o r e r o h i a
korerorero	k o r e r o r e r o
koreutu	k o r e u t u
marire	m a r i r
murua	m u r u a
mākete	m a k e t e
pokohiwi	p o k o h i w i
pōtitia	p o t i t i a
rawakore	r a w a k o r e
tahatika	t a h a t i k a
tapanga	t a p a n g a
tipua	t e p u a
tuarima	t u a r i m a
tuhituhia	t u h i t i a
tēna	t a N n a
tūpāpaku	t u p a E k p~ E k u
waiu	w a i u
watea	w a t e a
whakairia	wh~ E k a i r i a
whakamīharo	wh~ E k a m i e n a
whakatuwheratanga	wh~ E k a t u w h e r a t a n g a
whāea	w h a e a
Ahurei	h u r e i
Akuhata	k u h a t a
Hōri	o r i
Inia	n i a
Māmā	a m
Nu	u
Our	u r
Paikea	i k e a
Paora	a o r a
Pāpāho	a p a h o
Rawa	a w a
Rawiri	a w i r i
Rēkohu	a N k o h u
Tatau	a t a u
Tomo	o m o
Tāpiri	a p i r i
Whiriwhiria	h i r i wh~ E i r i a
Whā	h a
awheawhe	r u f e a l e
hauā	h a a
heru	h e r u
hukarere	h u k a r e r e
io	i o
itiiti	i t i t i
kaiwhakaatu	S i r k a a t u
kātua	k a a t u a
mihimihi	m i h i m i 7 i
ngaua	N a u a
nāwai	n a w a i
ohanga	o h a Ng~ a
ohu	o h u
peia	p e i a
pihi	p i 7 i
puhia	p u h i a
pēpē	l u a N l u a N
rano	r o
rīhi	r i
taetae	t a e t a e
tanumia	t a n u m i a
tauparapara	t a u p a r a p a r a
taupānga	t a u p a Ng~ a
tuemi	t u e m i
tōpū	a p u
whakaemi	wh~ E k a e m i
whakamiharo	wh~ E k a m i e n a
whakaraerae	wh~ E k a r a e r a e
whakawai	wh~ E k a w a i
wāwāhitanga	a  a  h i t a Ng~ a
Āhua	w a
Anga	N a
Haratua	a r a t u a
Herewini	e r e w i n i
Ihu	h u
Ira	r a
Karahipi	a r a h i p i
Karaka	a r a k a
Māku	a k u
Papahurihia	a p a h u r i 7 i a
Patāriana	a t a r i a n a
Poihākena	o i h a k e n a
Pāpā	a p
Taketake	a k e  k e
Takoto	a k o t o
Tamaiti	a m a i t i
Tiki	i k i
Toru	u r u
Tātou	a t o u
War	a r
Wīwī	i w i
aorangi	a o r a N i
haumanu	h a u m a n u
hautekau	h a u t e k a u
hākona	h a k o n a
hāngi	h a N i
kaupapahere	k a u p a p a h e r e
kuare	k u a r e
manomano	m i a s a s a l a p
mapi	m a p i
marara	r a r a
ngaku	N a k u
panaia	p a n a i a
parakuihi	p a r a  i 7 i
pare	p a r e
pikitanga	p i k i t a Ng~ a
potiki	p o t i k i
purua	p u r u a
pāhotanga	p a h o d a N a
pātene	p a t e n e
ro	r o
rātaka	r a t a k a
tapere	t a p e r e
tatai	t a t a i
tauhohe	t a u h o h e
taunekeneke	t a u n e k 3 n 3 q k e
taurewa	t a u r e w a
titonga	t i t o n g a
tohi	t o h i
torongū	t o r o N u
tënei	t 3 n e i
tāruarua	m a r u a r u a
tēina	t a N i n a
tūkino	t u k i n o
whakaarotanga	wh~ E a k a d o t a Ng~ a
whakaekenga	wh~ E k a e k e n g a
whakarāpopototanga	wh~ E k a r a p o p o t o t a Ng~ a
whakatuwheratia	wh~ E k a t u w h e r a t i a
ārahina	a r a h i n a
Airani	i r a n i
Aratakina	r a t a k i n a
Ati	t i
Hanga	a N a
Hemi	e m i
Hikurangi	i k u r a N i
Ingarani	N a r a n i
Kaa	a
Kī	i
Manukau	a n u k a u
Maoritanga	a o r i t a Ng~ a
Maungapōhatu	a u N a p o h a t u
More	u r e
Māu	a u
Pōtae	o t a e
Pūhipi	u i p i
Pūtahi	u t a h i
Taiwhanga	i r a Ng~ a
Tarawera	a r a w e r a
Toitū	o i t u
Tokorua	o k o r u a
Whakaritenga	h a k a r i r e n g a
Whakawhiti	h a k a wh~ E i t i
Whangarei	h a N a r e i
Whatu	h a t u
autō	a u a
haurangi	h a u r a N i
heria	h e r i a
hohipera	h o h i p e r a
hohonu	h o h o n u
hokia	h o k i a
hopi	h o p i
huahua	w a w a
hēkeretari	 k e r e t a r i
irahiko	i r a i k o
itinga	i t i Ng~ a
katia	k a t i a
kohanga	k o h a Ng~ a
kohikohia	k o h i k o h i a
kotahitanga	k o t a h i t a Ng~ a
körero	k o r e r o
kōhauhau	k o a u h a u
kōmihana	k o m i h a n a
maunu	m a u n u
moa	m o a
mätou	m a g t o u
mārena	m a r e n a
nōhanga	n o a Ng~ a
orokohanga	o r o k o h a Ng~ a
porohita	p o r o a
potae	p o t a e
pupu	p u p u
pūmotu	p u m o t u
taiora	t a i o r a
takurua	t a k u r u a
taupoki	t a u p o k i
tauwhāinga	t a u w h a i Ng~ a
toetoe	t o e t o e
tuari	t u a r i
waiū	w a i u
wana	w a n a
whakamahuki	wh~ E k a m a u k i
whakapaua	wh~ E k a p a u a
whakapuakanga	wh~ E k a p o a k a n g a
whakarerekētanga	wh~ E k a r e r e k a N t a Ng~ a
whakawhanaunga	wh~ E a b o r u f 3 n u N a
whawhati	wh~ E a l a t i
whāwhā	w h a wh~
āku	a k u
Aperira	p e r i r a
Ata	t a
Hapori	a p o r i
Hongi	o N i
Horowhenua	o r o wh~ e n u a
Hēnare	a N n a r e
Kurī	u r i
Matauranga	a t a u r a Ng~ a
MāoriHe	a o r i e
Māoritanga	a o r i t a Ng~ a
Pātaka	a t a k a
Rangahaua	a N a h a u a
Rāpare	a p a r e
Tiireni	i r e n i
Tua	u a
Tōku	 u
Tūhono	u h o n o
Wahine	a h i n e
Wairau	a i r a u
Whakaari	h a k a d i
Whakaue	h a k a u e
Whenu	h e n u
amio	a m i o
heamana	h e a m a n a
honore	h o n o r e
hōhonutanga	h o h o n u t a Ng~ a
kaitohu	k a i t o h u
kaiwhakaari	S i r a k a d i
katau	k a t a u
kawau	k a w a u
kikokiko	k i k o k i k o
kuhunga	k u h u N a
manakohia	m a n a k o h i a
mākū	m a k u
mātotoru	m a t o  r u
paahitia	p a h i t i a
pakimaero	k i m a e r o
pohewa	p o h e w a
rewharewha	r E f a r e w a
takatū	t a k a t u
tutakina	t u t a k i n a
tīmatatanga	t i m a t a t a n g a
tōkena	h  e n a
tūroa	t u r o a
werawera	w e r a w e r a
whakamātauria	wh~ E k a m a t a u r i a
whakamōhiotia	wh~ E k a m o u h a o t i a
whakaranu	wh~ E k a r a n u
whakatakotohia	wh~ E k a t a k a t o h i a
whiriwhirihia	wh~ E i r i wh~ E i r i h i a
ōpaki	o l o
Ūropi	r o p i
Aromatawai	r o m a t a w a i
Eramiha	r a m i h a
Ha	a
Hua	u a
Kaikōura	i k o u r a
Kuia	k i a
Marau	a r a u
Mātenga	a t e n g a
Pahi	a h i
Paipera	i p e r a
Paraone	a r a o n e
Parata	a r a t a
Point	o i nt~
Pāora	a o r a
Rongowhakaata	o N o w k a a t a
Ruanui	u a n u i
Tamihana	a m i h a n a
Tipene	i p e n e
Tirohanga	i r o h a Ng~ a
Waea	a e a
Whakaatu	h a k a a t u
Whakamoemiti	h a k a m o r e p e
Whakarite	h a k a r i t e
Whakatohea	h a k a t o h e a
hori	h o r i
korakora	k o r a k o r a
koropupū	k o r o p u p u
kōeke	k o e k e
maero	m a e r o
mauheretia	m a u h e r e t i a
mihia	m i h i a
momoho	C e r h o
mēra	m a N r a
nakunaku	n a k u n a k u
nekehia	n e k e h i a
neketai	n e k e t a i
ngohi	N o h i
ngongo	g o mb~ a
nē	n a N
panuku	p a n u k u
porihanga	p o r i h a Ng~ a
puawai	p u a w a i
pueru	p u e r u
pukuriri	p u k u r i r i
putunga	p u t u N a
pāwhiria	p a wh~ E i r i a
rangahaua	r a N a h a u a
rohenga	r o h i Ng~ a
rāhuitia	r a w i t i a
taiwhanga	t a a k a Ng~ a
takawaenga	t a k a w a i Ng~ a
tamatāne	t a m a t a n e
tauoti	t a w o t i
toona	o
totohu	t a t o h u
tuaahu	t u a h u
tukinotia	t u k i n o t i a
tupua	t u p u a
tōtara	t o t a r a
uia	k i a
ware	w a r e
whakareri	wh~ E k a r e r i
wīra	w i r a
wīwhara	w i wh~ a r a
āpiti	a
Ēngari	ng~ a d i
ūnga	u n g a
Aka	r o x
Aua	u a
Hinemoana	i n i m o a n a
Huri	u r i
Impromptu	p r o m p t u
Karakia	a r a k i a
Maunganui	a u N a n u i
Moananui	o a n a n u i
Muri	u r i
Mātaatua	a t a t u a
Piripi	i r i p i
Rarawa	a r a w a
Roimata	o i m a t a
Ruma	u m a
Runtime	u n t i m e
Rākau	a k a u
Taihoa	i h o a
Tiati	i a t i
Tohutohu	h u t o h u
Waikano	i k a
Whakaakoranga	h a k a k o r a Ng~ a
Whakatairanga	h a k a t a i r a Ng~ a
ae	a e
hakinakina	h a k i n a k i n a
hauhake	h a u h a k e
horapa	h o r a p a
kaiwhakanoho	S i r k a n o h o
kakā	k a l
kokiri	k o k i r i
kōnei	k o n e i
maitai	m a i t a i
maringi	m a r i N i
marino	m a r i n o
matomato	m a t o m a t o
papamahi	p a p a m a h i
patapatai	p a t a p a t a i
piripono	p i r i p o n o
pūhiko	p u i k o
pūrerehua	p u r e r a w a
rekoata	r e k o a t a
runanga	r u n a Ng~ a
rūri	r a k a i
takapau	t a k a p a u
taumahi	t a u m a h i
teetahi	% t e th~ a h i
timu	t i m u
tomokanga	t o m o k a n g a
uma	u m a
ure	u r e
urupā	u r b
weropepahia	w e r o p e p a h i a
whakahokinga	wh~ E k a h o k i Ng~ a
whakaniko	wh~ E k a n i k o
whakaorangia	wh~ E k a o r a N i
whakaroa	wh~ E k a r o a
whakatuwhera	wh~ E k a t u w h e r a
whakaute	wh~ E k a u t e
whatunga	wh~ E a t u N a
āki	a k i
ārani	a r a n i
āwhā	a wh~
ēnā	a N n
Ōtepoti	t e p o t i
Au	u
Eke	k e
Harawira	a r a w i r a 7
Hurae	u r a e
Hīkoi	i k o i
Karanga	a r a Ng~ a
Kawea	a w e a
Kawhia	r u f i a
Koinā	o i N
Kāpene	a p e n e
Kōrerohia	o r e r o h i a
Matapakia	a t a p a k i a
MauHe	a u e
Papamoa	a p a m o a
Peti	e t i
Rapua	a p u a
Tapahia	a p a h i a
Tikina	i k i n a
Tohunga	h u N a
Tokohia	o k o h i a
Tuhituhi	a h i t u h i
Tūrei	u r e i
Waihi	i 7 i
Waikanae	i k a n a e
Whakatakotoria	h a k a t a k a t o r i a
Whetu	h e t u
Wikitoria	i k i t o r i a
anö	a n o
arotakenga	a r o t a k e n g a
auahatanga	a u a h a t a n g a
aue	a u e
hongi	h o N i
hōrapa	h o r a p a
kaho	k a h o
kaitiakitanga	k a i t i a k i t a Ng~ a
karauna	k a r a u n a
koraha	k o r a h a
kōanga	k o a Ng~ a
maioha	m a i o h a
maioro	m a i o r o
manatārua	m a n a t a r u a
marena	m a r e n a
muna	m u n a
māwhitiwhiti	m a wh~ E i t i wh~ E i t i
ngenge	g 3 N a
nohinohi	n o h i n o h i
oreore	o r e o r e
paingia	p a i N i
pakihiwi	k i h i w i
poihau	pw~ a h a u
puea	p u e a
pumau	p u m a u
pure	p u r e
pākete	p a k e t e
pūoho	p u h o
pūtakenga	p u k e n g a
raka	r a k a
riterite	r i t E r i t e
rēhia	r a N i a
taima	t a i m a
taipakeke	t a i p a k e k e
tapuhi	t a p u h i
tarukino	t a r u k i n o
tatu	t a t u
taukumekume	t a u k u m e k u
ti	t i
totara	t a t a r a
tāhū	m a u
tāwere	m a w e r e
tūtohinga	t u t o h i n g a
uha	a a
wae	w a e
week	w e k
whakaaehia	wh~ E k a e h i a
whakahaua	wh~ E k a h a u a
whakamāherehere	wh~ E k a m a h e r e h e r e
whakarerekētia	wh~ E k a r e r e k a N t i a
whakatauākī	wh~ E k a t a a q i
Ākuhata	k u h a t a
ānō	nj~ 3 o
ārikarika	a r i k a r i k a
Air	i r
An	n
Hautau	a u t a u
Ingoa	N o a
Kawariki	a w a r i k i
Mataatua	a t a t u a
Meiha	e i h a
Mātāwai	a t a w a i
Paerua	a e r u w a
Pihinga	i h i n g a
Rangiātea	a N i a t e a
Rauru	a u r u
Rupe	u p e
Tuatoru	u a t o r u
Tuia	k i a
Tāngia	a N i
Waharoa	a h a r o a
Wananga	a n a Ng~ a
Whakaaetanga	h a k a e t a Ng~ a
Wāhine	a h i n e
akiakihia	a k i a k i h i a
arotakengia	a r o t a k 3 N i
hangi	h a n g i
hangā	h a N
hautaka	h a u t a k a
hinonga	h i n o n g a
hore	h o r e
huarākau	w a r a k a u
kaa	k a
kahui	k a w i
kaieke	k a i e k e
kaitoi	k a i t o i
kaiwhakawa	S i r k a w a
kawana	k a w a n a
kemu	k e m u
kiriuhi	k i r i i
kēkē	q e q e
kōpū	k o p u
mamao	m a m a o
matataunga	m a t a t a u N a
mohoa	h o  a
māhunga	m a u N a
māuiui	m a u i u i
nehu	n e h u
ohia	h i a
paetuku	p a e t u k u
parenga	p a r e n g a
paruparu	p a r u p a r u
pātiki	p a t i k i
raa	r a
rāwekeweke	r a e kw~ a w e k e
taiopenga	t a i o p e n g a
tokoono	t o k o o n o
tokotoko	t o k a t o k o
too	t o
tuaina	t u a i n a
tungane	t u N a n e
tuunga	t u n g a
tōmuri	a m u r i
uiuitanga	k i i t a Ng~ a
uka	u k a
waku	w a k u
whakahaerea	wh~ E k a h a e r e a
whakahīhī	wh~ E k a h i i
whakapumautia	wh~ E k a p u m a u t i a
whakapākehātanga	wh~ E k a p a k e h a t a Ng~ a
whakatairitea	wh~ E k a t a i r i t e a
whakatinanahia	wh~ E k a t i n a n a h i a
whao	wh~ E a o
wini	w i n i
Āperira	p e r i r a
Ōrākei	r a k e i
Akuanei	k o d u
Here	e r e
Hereturikōkā	e r e t u r i k o l
Hutt	u t
Kaihautū	i h a u t u
Kaiwhakawā	i r k a a
Kare	a r e
Koianei	o e n u
Kororāreka	o r o r a r e k a
Korowaitanga	o r o w a i t a Ng~ a
Matakite	a t a k i t e
Mokopuna	o k o p u n a
Mōhio	o i o
Nohotima	h o t i m a
Pikiao	i k i a o
Puke	u k e
Tuwhakairiora	u w k a i r i o r a
Waaka	a k a
Wehea	e h e a
Whakaako	h a k a k o
Wī	i
aki	a k i
autaia	a u t a i a
ha	s i
harakoa	h a r a k a
haumarutanga	h a u m a r u t a Ng~ a
hikareti	h i k a r e t i
hoea	h o e a
hōpara	h o p a r a
kaitoro	k a i t o r o
kakama	k a k a m a
kakano	k a k a
kapahaka	k a p a h a k a
karamu	k a r a m u
karapoti	k a r a p o t i
makau	m a k a u
mei	m e i
moata	m o a t a
mīhana	m i a n a
mīti	m i t i
nehera	n e h e r a
new	n i a
nōhia	n o i a
onamata	o n a m a t a
otiia	o t i a
pupuritia	p u p u r i t i a
pāho	p a h o
pēhia	l u a N i a
pūmua	p u a
pūrama	p u r a m a
raima	r a i m a
roia	r o i a
taiwhenua	t a i wh~ e n u a
takaia	t a k a i a
takina	t a k i n a
takitini	t a k i t i n i
tuatara	t u a t a r a
tārewa	m a r e w a
tātahi	m a t a h i
urutomo	u r u t o m o
utanga	u t a Ng~ a
whakamā	wh~ E k a m
whakamāmā	wh~ E k a m a m
whakamāramahia	wh~ E k a m a r h i a
whakanohoia	wh~ E k a n o h o i a
whakapuakitanga	wh~ E k a p o a k i t a Ng~ a
whakapūmautia	wh~ E k a p u m a u t i a
whakarei	wh~ E k a r e i
whakataka	wh~ E k a t a k a
whakatutukihia	wh~ E k a t u t u n u N i a
whakatūngia	wh~ E k a t u N i
whakawhanaungatanga	wh~ E a b o r u f 3 n u N a t a n g a
whakawhāiti	wh~ E k a w h a i t i
wharepaku	wh~ E a r e p a k u
whatumanawa	wh~ E a t u m a n a w a
wä	o
Āhia	h i a
ārahitanga	a r a h i t a Ng~ a
Aoraki	o r a k i
Aronui	r o n u i
Hato	a t o
Haumaru	a u m a r u
Huinga	k i Ng~ a
Hītori	i t o r i
In	n
Kaimahi	a i m a h i
Keepa	e p a
Koi	o i
Kokiri	o k i r i
Mike	i k e
Māna	nj~ 3
Panguru	a n g u r u
Parore	a r o r e
Pīpī	o i
Rongopai	o N o p a i
Ruatapu	u a t a p u
Rāmere	a *
Tamati	a m a t i
Tiwhikete	i w i k e t e
Tupu	u p u
Tāmati	a m a t i
Tāpirihia	a p i r i h i a
Tīhema	i h e m a
Tūturu	u t u r u
Whakauru	h a k a u r u
Whangaroa	h a N a r o a
Whetū	h e t u
akuanei	a k u a n e i
haehae	h a e h a e
hopukanga	h o p u k a n g a
horoia	h o r o i a
huawhenua	w a wh~ e n u a
kaaore	k a o r e
kaiwhakarato	S i r k a r a t o
kanorau	k a n o r a u
kirikiti	k i r i g i t i
kuini	k u i n i
kīa	k i a
kōtui	k o t u i
mango	m a n g o
mangu	m a N u
mania	n i a
matikara	m a t i k a r a
mauhere	m a u h e r e
mm	m m
mōrehu	m o r e h u
oi	o i
oko	o k o
onāianei	o a e n u
ota	o t a
paetahi	p a e t a h i
paparau	p a p a r a u
pereti	p e r e t i
pohehe	p o h e e
pouaru	p o u a r u
pōkākā	p o l l
rangirua	r a N i r u a
rangitahi	r a N i t a 7
ranunga	r a n u N a
reinga	r e i Ng~ a
reri	r e r i
rïroa	r 3 r o a
tauaro	t a w a r o
tauhono	t a u h o n o
taumahatanga	t a u m a h a t a n g a
taurua	t a u r u a
tuaono	t u a o n o
tunga	t u N a
tuu	t u
tīmataria	t i m a t a r i a
tīpakohia	t o a k o h i a
tūao	t u a o
tūwhera	t u wh~ e r a
tūāhuatanga	t u a w a t a n g a
warea	w a r e a
weheruatanga	w e h e r u a t a n g a
whaa	wh~ E a
whakamohio	wh~ E k a m o h i o
whano	wh~ E a
wāwāhia	a  a  i a
āhuahanga	a w a h a Ng~ a
Aha	s i
Anau	n a u
Ani	n i
Apa	p a
Ataata	t a t a
Eruera	r u e r a
Haane	a n e
Kaitaia	i t a i a
Kaitirotiro	a y t u r o t i r o
Manahi	a n a 7 i
Mataira	a t a i r a
Mātai	a t a i
Pango	a n g o
Patupaiarehe	a t u p a i 7 r e e
Peehi	e
Pīngao	i N g a o
Pūkenga	u k e n g a
Rakiura	a k i u r a
Rāhina	a h i n a
Takitimu	a k i t i m u
Tapuika	a p o i k a
Tui	u i
Tīkina	i k i n a
Tīmoti	i m o t i
Uropi	r o p i
Wahi	a h i
Wanganui	a N a n u i
Whakangungu	h a k a n g u N u
Whakapono	h a k a p o n o
Whakareatia	h a k a r e a t i a
Whiriwhiri	h i r i wh~ E i r i
ahupūngao	a h u p u n g a o
amotai	a m o t a i
arawhata	n a l a t a
autōhiko	a u a i k o
ekore	e k o r e
hauāuru	h a a u r u
heipū	h e i p u
hihiko	h i i k o
hinaki	h i n a k i
huhu	h u h u
hukihuki	h u k i h u k i
ianei	i a n e i
ihiihi	i h i i 7 i
inanga	i n a n g a
kaitā	k a i t a
kaiwhakamāori	S i r k a m a o r i
kaiwhakatairanga	S i r k a t a i r a Ng~ a
kapohia	a h i a
kaupare	k a u p a r e
koorero	k o r e r o
kopu	k o p u
kākā	l l
kāpehu	l p e h u
kāti	k a a t i
matatapu	m a t a t a p u
mauritau	m a u r i t 3
mohiotanga	o* h i o t a Ng~ a
mokomoko	m o k o m o k o
nge	N a
nukunuku	n u k n u k u
nāku	n a k u
pukumahi	p u k u m a h i
pāhekeheke	p a h e k e h e k e
pāpāhua	p a p a w a
pāua	p a i
pōtiki	p o t i k i
pūkahukahu	p u k a u k a u
pūkeko	p u k e k o
rara	r a r a
rei	r e i
reiti	r a i
rūmaki	r u m a k i
takahuri	t a k a h u r i
takitaki	t a k i t a k i
tauria	t a u r i a
tauwhitiwhiti	t a w wh~ E i t i wh~ E i t i
tonuhia	t o n u h i a
tuohu	t u o h u
turu	t u r u
tāpaea	m a p a e a
tūhurangia	t u u r a N i
uiuia	k i h a h
ururua	a
whakapehapeha	wh~ E k a p e h a p e h a
whakapiria	wh~ E k a p i r i a
whakarauoratanga	wh~ E k a r a w o r a t a n g a
whakarōpūtanga	wh~ E k a r o p u t a Ng~ a
whakawhitihia	wh~ E k a wh~ E i t i h i a
whatitoka	wh~ E a t i t o k a
whiunga	wh~ E i u N a
whātoro	w h a t o r o
Āhuatanga	w a t a n g a
āhukahuka	a u k a u k a
Aitanga	i t a Ng~ a
Aue	u e
Hainamana	a i n a m a n a
Hoa	o a
Ian	a n
Ipukarea	p u k a r e a
Kanawa	a n a w a
Kauaka	a u a k a
Kohai	a i
Kīhai	i a i
Materoa	a t e r o a
Matihiko	a t i i k o
Moemiti	o r e p e
Māhaki	a a k i
Mākarini	a k a r i n i
Nāu	a u
Otautahi	t a u t a h i
Pīhopa	i o p a
Rahui	a w i
Raukura	a u k u r a
Riro	i r o
Roto	o t o
Ruatara	u a t a r a
Tamatea	a m a t e a
Tātaihia	a t a i h i a
Tō	o
Uri	r i
Wairaka	a i r a k a
Whaitere	h a i t e r e
Whaitiri	h a i t i r i
Whakairo	h a k a i r o
Whakapapa	h a k u t " u t " u
Wharehuia	h a r e k w i a
Whata	h a t a
Wi	i
Wāwāhi	a a
aata	a t a
angawaho	a N a w a h o
anā	a n
aratakina	a r a t a k i n a
hapainga	h a p a i Ng~ a
hotoke	h o d o k e
huamoni	w a m o n i
hāpaitia	h a p a i t i a
iraoho	i r a o h o
karetao	k a r e t a o
karoro	k a t e m e
kinaki	k i n a a k i
kēhi	q e
kīhini	k i h i n i
kōtuitui	k o t u i t u i
māhere	m a i*
mātātuhi	m a t a t i
ngari	ng~ a d i
ngāwhā	N a wh~
nuka	n u k a
p	p
pakipaki	k i p a k i
papatuhituhi	p a p a t u h i t u h i
parea	p a r e a
petihana	p e t i e n a n a
pirihi	p i r i 7 i
piringa	p i r i Ng~ a
piu	p i u
puaki	p u a k i
pukepuke	p u k e p u k e
pupuru	p u p u r u
pātaihia	p a t a i h i a
pēhanga	l u a N a Ng~ a
raorao	r a o r a o
roroa	r o r o a
rēhitatia	r a N h i t a t i a
taero	t a e r o
tahuhu	t a h u h u
tahā	t a h a
tapiri	t a p i r i
tutū	t u t u
tāima	m a i m a
tēwhea	t a N wh~ e a
tīkiti	t i N
tōiriiri	a i r i i r i
tūmau	t u m a u
unu	u n u
wairehu	w a i r e h u
wehewehenga	w e h e w e h e n g a
weu	w e u
whakaaraara	wh~ E a k a d a r a
whakairoiro	wh~ E k a i r o i r o
whakakai	wh~ E k a k a i
whakakāhore	wh~ E k a l h o r e
whakamaherehere	wh~ E k a m a h e r e h e r e
whakarewatanga	wh~ E k a r e w a t a n g a
whakaroto	wh~ E k a r o t o
whakato	wh~ E k a t o
wharangi	wh~ E a r a N i
wharau	wh~ E a r a u
whāki	w h a k i
āhea	a h e a
āputa	a p u t a
Awakairangi	w a k a i r a N i
Hinemoa	i n i m o a
Hoahoatia	o a h o a t i a
Horo	o r o
Katikati	a t i k a t i
Kumeroa	u m e r o a
Maku	a k u
Matene	a t e n e
Matt	a t
Mutunga	u t u N a
MāoriTe	a o r i e
Ngoingoi	g o i N o i
Papatuanuku	a p a t u a n u k u
Parahaki	a r a h a k i
Paratene	a r a t e n e
Pare	a r e
Pipi	i p i
Po	o
Pokapū	o k a p u
Puhiwahine	a i w a h i n e
Puketapu	u k 3 t a p u
Pēhi	a N
Rapu	a p u
Tahua	a w a
Taiwhenua	a y wh~ e n u a
Tana	a n a
Taonui	y a i
Taranga	a r a Ng~ a
Tere	e r e
Tini	i n i
Tuhinga	a i Ng~ a
Tāpiria	a p i r i a
Tōna	r 3 n a
Tūtira	u t i r a
Whakamahi	h a k a m a h i
Whakangahau	h a k a N a h a u
akau	a k a u
anamata	a n a m a t a
apataki	a p a t a k i
apu	a p u
eenei	e n e i
haerea	h a e r e a
hahi	h a h i
hangarua	h a N a r u a
hauwaru	h a u w a r u
hiringa	h i r i Ng~ a
huapae	w a p a e
huatau	w a t a u
hāngaitanga	h a N a i t a Ng~ a
hōro	h o r o
inarā	i n a r
kaiahuwhenua	k a i a w wh~ e n u a
kaimātai	k a i m u f a a t a i
kaipūtaiao	k a i p u t a i a o
kakau	k a k a u
karawhiu	k a n a l i u
kopa	k o p a
kotuku	k o t u k u
kāmera	l *
kāpia	l p i a
kōhinu	k o h i n u
kōwhaiwhai	k o wh~ i r a i
maera	m a e r a
manomita	n u m i t a
matatika	m a t a t i k a
matawai	m a t a w a i
matika	m a t i k a
matā	m a t a
moka	m o k a
muramura	m u r a m u r a
namata	n a m a t a
ngeri	g e r i
ngeru	g e r u
ngū	N u
peenei	p e n e i
punaha	p u n a h a
pōkai	p o k a i
pūoru	p u o r u
rawaka	r a w a k a
riihi	r i i 7 i
rimu	l i m u
ringatoi	r i N a t o i
riwai	r i w a i
ränei	r 3 n e i
rārangitanga	r a r a N i t a Ng~ a
rēmana	r a N nd~ e a n a
taa	t a
taau	t a u
tahitanga	t a h i t a Ng~ a
taiaki	t a i a k i
takahurihuri	t a k a h u r i 7 u r i
tanga	t a n g a
tangihia	t a N i h i a
taumāhekeheke	t a u m a h e k e h e k e
tautōhito	t a w a h i t o
tea	t e a
tohuhia	t o w i a
totika	t o t i k a
tuki	t i k i
turaki	t u r a k i
tāmi	m a m i
tāneke	m a n e k e
tāpoi	m a p o i
tātaihia	m a t a i h i a
tītaha	t i t a h a
tōrunga	a r u N a
waero	w a e r o
waihotia	w a i h o t i a
wairangi	w a i r a N i
warewaretia	w a r e w a r e t i a
wawa	w a w a
whakahōnore	wh~ E k a h r 3 n o r e
whangaia	wh~ E a N a i a
wheketere	wh~ e k e t e r e
Āperahama	p e r a h a m a
Āwherika	wh~ e r i k a
āio	a i o
ōnā	r 3 n
Araroa	r a r o a
Art	r
Hahi	a h i
Haki	a k i
Hape	a p e
Horomona	o r o m o n a
Itari	t a r i
Karekau	a r e k a u
Kawau	a w a u
Mārire	a r
Napier	a p i e r
Noa	o a
Oho	h o
Pani	a n i
Patapātai	a t a p a t a i
Pomare	t a r e
Poronihana	o r o n i h a n a
Pānga	a Ng~ a
Pōtitanga	o t i t a Ng~ a
Raihania	i h a n i a
Ratana	a t a n a
Rauropi	a u r o p i
Rerenga	e r e n g a
Rotoiti	k o t o i t i
Taake	a k e
Taite	a y t
Tangohanga	a N o h a Ng~ a
Tawhiao	r u f i a o
Tina	i n a
Tirani	i r a n i
Tāke	a k e
Waikaremoana	i k a r e y a n a
Whiringa	h i r i Ng~ a
Whiwhi	h i w
aroā	a r o
aru	a r u
hamama	h a m a m a
hoihoi	h o i h o i
hokihoki	h o k i h o k i
kaikai	k a i k a i
kaipakihi	k a i k k k i 7 i
kaiwhakangungu	S i r k a n g u N u
kakī	k a k i
kiato	k i a t o
konihi	q o n i h i
kotia	k o t 3 a
kuputuhi	k u p u t u h i
kutikuti	k u t i k u t i
kutu	k u t u
kāo	l o
kōhua	k o w a
kōkuhu	k  u h u
mako	k o
makutu	k u t u
manuwhiri	m a n u w i r i
muia	m u i a
mātātoa	m a t a t o a
paihamu	p a i h a m u
pakarutanga	p a k a r u t a Ng~ a
pakiwaituhi	k i w a i t u h i
papatahi	p a p a t a h i
paraihe	p a r a i e
peha	p e h a
pewhea	p e w h e a
pipiri	p i p i r i
piunga	p i u N a
pokanoa	p o k a n o a
poupoutanga	p o u p o u t a Ng~ a
pune	p u n e
purakau	p u r a k a u
pūtirotiro	p u t u r o t i r o
rekereke	r e k e r e k e
riringi	r i r i N i
ritamano	r i t a m a n o
rito	r i t o
rongopai	r o N o p a i
rīki	r i k i
taikaha	t a i k a h a
takiuru	t a k i u r u
tautau	t a u t a u
tautono	t a u t o n o
tohutoro	t o h u t o r o
tupono	t u p o n o
tōnga	a Ng~ a
tūhuratia	t u u r a t i a
unuhia	u n u h i a
utunga	u t u N a
wehewehea	w e h e w e h e a
whakaawhiwhi	wh~ E k a u f i w
whakaharatau	wh~ E k a h a r a t a u
whakamamae	wh~ E k a m a m a e
whakamatea	wh~ E k a m a t e a
whakamaumahara	wh~ E k a m a u m a h a r a
whakamaumaharatanga	wh~ E k a m a u m a h a r a t a n g a
whakatoko	wh~ E k a t o k o
whakatōpū	wh~ E k a a p u
whakatūhia	wh~ E k a t u i a
whariki	wh~ E a r i k i
whitiki	wh~ E i t i k i
whitiwhiti	wh~ E i t i wh~ E i t i
whānako	wh~ E nj~ 3 k o
wira	w i r a 7
wähi	w 3
wūru	w u r u
Ārai	r a i
Amorangi	m o r a N i
Aperahama	p e r a h a m a
Aranga	r a n g a
Hapū	a p u
Hera	e r a
Hika	i k a
Hinewhaitiri	i n w u f 3 i t i r i
Hokowhitu	o k o w h i t u
Hotunui	o t u n u i
Ine	n e
Kaitohutohu	i t o h u t o h u
Kao	a o
Kimi	i m i
Kopu	o p u
Korea	o r e a
Kāterina	a t E r i n a
Kōwhiria	o wh~ E i r i a
Manaaki	a n a k i
Moehau	o e h a u
Moeraki	o e r a k i
Moni	a
Muriwai	u r i w a i
Paari	a r i
Paeroa	a e r o a
Patariana	a t a r i a n a
Piri	i r i
Port	u r
Potatau	o t a t a u
Puoro	u o r o
Pō	o
Pūreta	u r e t a
Rahi	a h i
Rangihiroa	a N i h i r o a
Rāniera	nj~ 3 e r a
Rūaumoko	u a u m o k o
Tahuri	a h u r i
Takitahi	a k i t a h i
Tamatoa	a m a t o a
Tauanga	a u a Ng~ a
Tauaromahi	a u a r o m a h i
Tom	i r
Toroa	o r o a
Tuakana	u a k a n a
Tuhi	a i
Tuna	u n a
Ua	a
Union	n i o n
Waihangatia	i h a N a t i a
Whakamahinga	h a k a m a h i n g a
Whakamātauria	h a k a m a t a u r i a
ahumoana	a w y a n a
arahau	a r a h a u
haerehia	h a e r e h i a
honi	h o n i
huritau	h u r i t 3
hēoi	 o i
ihotanga	i h o d a N a
iramutu	i r a m u t u
kaitarai	k a i t a r a i
kame	k a m e
katakata	k a t a k a t a
kereme	k e r a m e
keria	k e r i a
kōpaka	k o p a k a
kōpiro	k o p i r o
kōrari	k o r a r o
matao	m a t a o
mawhiti	m a wh~ E i t i
momona	m o m o n a
moohio	h i o
moroiti	m o r o i t i
motupaika	m o t u p a i k a
moumou	% m a u m o u
mōkito	m o k i t o
mōku	m o k u
ngatahi	g a t a h i
ngira	N i r a
noaiho	n o a i h o
nohanga	n o h a Ng~ a
ohonga	h o n g a
ohooho	h o h o
onepū	n e p u
orite	u r i t e
paea	p a e a
patupaiarehe	p a t u p a i 7 r e e
poke	p o k e
poutū	p o u t u
pākeke	p a k e k e
pīrangitia	p i r a N i t i a
pōhara	p o a r a
pōhiri	p o i r i
pūkei	p u k e i
rarau	r a r a u
rea	r e a
repe	r e p e
riki	r i k i
ripa	r i p a
taapiri	t a p i r i
takai	t a k a i
tanu	t a n u
tapatahi	t a p a t a h i
taratara	t a r a t a r a
taria	t a r i a
tatahi	t a t a h i
tekoteko	t a k o t e k o
tiamana	t i a m a n a
toha	t o h a
tohia	t o h i a
tope	t o p e
tuatahitanga	t u a t a h i t a Ng~ a
tuawhitu	t u a w h i t u
tuia	t u i a
tukatuka	n a a t u k a
tungāne	t u N nj~ 3
turuki	t u r u k i
turuturu	t u n u t u r u
tākina	m a k i n a
tākupu	m a k u p u
tāruke	m a r u k e
urutau	t a u
waina	w a i n a
werohanga	w e r o h a Ng~ a
whakaaotanga	wh~ E k a o t a Ng~ a
whakahekea	wh~ E k a h e k e a
whakakao	wh~ E k a k a o
whakakāhoretia	wh~ E k a l h o r e t i a
whakamutua	wh~ E k a m u t u a
whakanikoniko	wh~ E k a n i k o n i k o
whakapainga	wh~ E k a p a i Ng~ a
whakarau	wh~ E k a r a u
whakarewahia	wh~ E k a r e nt~ a
whakarārangitia	wh~ E k a r a r a N i t i a
whakatakariri	wh~ E k a t a k a r i r i
whakatītina	wh~ E k a t i t i n a
wiri	w i r i
wānaka	w nj~ 3 a k a
wētahi	w a N t a h i
Ötautahi	t a u t a h i
ënei	3 n e i
Atiawa	t i a w a
Awherika	wh~ e r i k a
Erima	l i m a
Herenga	e r e n g a
Hiranga	i r a Ng~ a
Hunga	u N a
Hākinakina	a k i n a k i n a
Karihi	a r i 7 i
Kīia	i i a
Mata	a t a
Miro	i r o
Muturangi	u t u r a N i
Nawai	a w a i
Papaioea	a p a i o e a
Pau	a u
Pono	o n o
Prime	l i m e
Pōkiha	 a l a
Raka	a k a
Raupapahia	a u p a p a h i a
Rawinia	a w i
Rongoā	o N o
Ruawharo	a r u f 3 r o
Taha	a h a
Taro	a r o
Tatauria	a t a u r i a
Tauihu	a u i h u
Tianara	i a n a r a
Tokomaha	o k o m a h a
Toro	o r o
Tākaro	a k a r o
Tāngata	nj~ 3 g a t a
Tīmata	i m a t a
Tūhura	u u r a
Wahanga	a h a Ng~ a
Waimate	a i m a t e
Waiora	a i o r a
Whakautua	h a k a u t u a
Whatatutu	h a t a t u t u
Whatuiapiti	h a t u i a
Whitinga	h i t i Ng~ a
akohia	a k o h i a
amorangi	a m o r a N i
arotau	a r o t a u
haau	h a u
hamumu	h E m u m u
haukoti	h a u k o t i
haukāinga	h a u l i Ng~ a
hautū	h a u t u
houhia	h o i a
hīkoikoi	h i k o i k o i
hūnga	h u n g a
ioio	i o i o
kahawai	k a h a w a i
kaipāmu	k a i p a m u
kaipūrongo	k a i p u r o n g o
katinga	k a t i Ng~ a
km	k m
kokoti	k o k o t i
kuru	k u r u
käore	k a o r e
manahau	m a n a h a u
matamua	m a t a m u h a
mataora	m a t a o r a
mauhia	m a u h i a
mitamano	m i t a m a n o
moo	m o
mānuka	m nj~ 3 u k a
mārakerake	m a r a k e r a k e
māti	m a t i
mātāwaka	m a t a w a k a
nanao	n a n a o
ngutuawa	N u t o w e r a
noku	n o k u
pahemo	p a h e m o
paiheretia	p a i h e r e t i a
pakipūmeka	k i p u w i t a
patohanga	p a t o h a Ng~ a
pekanga	p e k a n g a
pekapeka	p e k h a p e k a
pereki	p e r e k i
pokea	p o k e a
purākau	p u r a k a u
pänui	p 3 7 n u i
pītau	p i t a u
pūranga	p u r a Ng~ a
pūtaketanga	p u k e t a Ng~ a
pūāhua	p u a w a
rerehua	r e r a w a
rongomau	r o n g o m a u
ru	r u
rumakina	r u m a k i n a
rērere	r a N r e r e
taatou	t a t o u
taihemahema	t a i h e m a h e m a
takiri	t a k i r i
taotū	t a o t u
tautohua	t a u t o w a
tauā	t a w
teretere	t e r e t e r e
toanga	t o a Ng~ a
tohea	t o h e a
tohetohe	t o h e t o h e
tākiri	m a k i r i
tāonga	m a o n g a
tātaritanga	m a t a r i t a Ng~ a
umere	u m e r e
wahapū	w a h a p u
wahia	w a h i a
waiariki	w a i a r i k i
weherua	w e h e r u w a
weka	w e k a
whakahaumako	wh~ E k a h a u m a k o
whakahoungia	wh~ E k a h o u N i
whakahāwea	wh~ E k a h a w e a
whakahōu	wh~ E k a h o u
whakakotahitanga	wh~ E k a k o t a h i t a Ng~ a
whakamaheretia	wh~ E k a m a h e r e t i a
whakamate	wh~ E k a m a t e
whakaohooho	wh~ E k a o h o h o
whakapaitanga	wh~ E k a p a i t a Ng~ a
whakapaparanga	wh~ E k a p a p a r a Ng~ a
whakaratoa	wh~ E k a r a t o a
whakatikaina	wh~ E k a t i k a i n a
whakatupuria	wh~ E k a t u p u r i a
whakatūturu	wh~ E k a t u t u r u
whawhaitia	wh~ E u f 3 i t i a
wherawhera	wh~ e r a w h e r a
āniwhaniwha	nj~ 3 u f 3 n i w a
īnoi	i N o i
Arapeta	r a b e t o
Area	r e a
Hakinakina	a k i n a k i n a
Hao	a o
Hawaii	a w a i
Heamana	e a m a n a
Hoi	o i
Hon	o n
Hoturoa	o t u r o a
Ihenga	h E N a
Kaiapoi	a y a p o i
Kamo	n o i
Kiekie	i e k i e
Kōhure	o u r e
Maaui	a i
Manuka	a n u k a
Matenga	a t e n g a
Matewhawhati	a t e u f 3 k a t i
Mauao	a u a o
Murihiku	u r i i k u
Network	e t w o r
Ngāruawāhia	g a r u u a  i a
Pere	e r e
Pitopito	i t o p i t o
PōtiNgāwari	o t i g a w a r i
Rangatahi	a N a t a h i
Rarohenga	a r o h i Ng~ a
Rito	i t o
Ruatepupuke	u a t e p u p u k e
Rārangihia	a r a N i h i a
Teitei	e i t e i
Tokotoru	o k a t o r u
Tāhūhū	a u u
Tāmakimakaurau	a kh~ i m a k a u r a u
Tē	a N
Tīpene	o e n e
Wehi	e h i
Whakaae	h a k a e
Whakatōhea	h a k a a h e a
Wēteriana	a N t E r i a n a
aianei	a y a n e i
arotahinga	a r o t a h i n g a
hahana	h a h a n a
hapūtanga	h a p u t a Ng~ a
haurima	h a u r i m a
hautipua	h a u t i p u a
hewa	h e w a
hinganga	h i N a Ng~ a
hukahuka	h u k a u k a
hīkaka	h i k a k a
hīkina	h i k i n a
ikeike	i k e i k e
kaihaka	k a i h a k a
kaingakau	k a i N a k a u
kaingārahu	k a i N a r a h u
kaiwhakamārama	S i r k a m a r a m a
kaiwhakaora	S i r k a o r a
kaiwhakarite	S i r k a r i t e
kariri	k a r i r i
karukaru	k a r u k a t u
kawekawe	k a w e k a w e
kohine	k o h i n e
kopae	k o p a e
kuaore	kw~ a o r e
kï	k 3
kāpene	l p e n e
kētanga	q e t a Ng~ a
kūaha	k u a h a
mahaki	m a h a k i
manawataki	m a n a w a t a k i
matarau	m a t a r a u
miihini	m e N w E h i n i
mirimiri	m i r i m i r i
mokete	m o k e t e
mānu	m nj~ 3
mātārere	m a t a r e r e
nekenekehanga	n e k 3 n 3 q k e h a Ng~ a
ngahoro	N a h o r o
ngoi	N o i
ngunguru	N u N u r u
not	n a t
oona	o n a
paerua	p a e r u w a
pania	p a n i a
paoho	p a o h o
parai	p a r a i
parepare	p a r e p a r e
patipati	p a t i p a t i
patuki	p a t u k i
piupiu	p i p i u
pokai	p o k a i
pürongo	p 3 r o n g o
pāwera	p a w e r a
pōtaka	p o t a k a
pōuriuri	p o u r i u r i
pūhia	p u i a
pūira	p u i r a
pūkana	p u k a n a
pūkohu	p u k o h u
rangimarie	r a N i m a r i e
rarauhe	r a r a u e
rerewhenua	r e r e f e n u a
taara	t a r a
takohanga	t a k o h a Ng~ a
tapahanga	t a p a h a Ng~ a
tiaho	t i a h o
tikaka	t i k a k a
tokowhitu	t o k o w h i t u
tuaiwi	t u a i w i
tuarongo	t u a r o n g o
tuke	n a e
tukia	t u k i a
tāruatia	m a r u a t i a
tūhonotanga	t u h o n o t a Ng~ a
up	u p
whakahauhau	wh~ E k a h a u h a u
whakahī	wh~ E k a h i
whakairihia	wh~ E k a i r i h i a
whakakake	wh~ E k a k a k e
whakamanatanga	wh~ E k a m a n a t a n g a
whakamoe	wh~ E k a m o e
whakamomori	wh~ E k a m o m o r i
whakanuitanga	wh~ E k a n u i t a Ng~ a
whakaputu	wh~ E k a p u t u
whakaranua	wh~ E k a r a n u a
whakaratonga	wh~ E k a r a t o n g a
whakarewaina	wh~ E k a r e w a i n a
whakarākei	wh~ E k a r a k e i
whakatahi	wh~ E k a t a h i
whakatipuria	wh~ E k a t i p i r i a
whakatōkia	wh~ E k a a i a
whakawehea	wh~ E k a w e h e a
whakawhitiwhitinga	wh~ E k a wh~ E i t i wh~ E i t i Ng~ a
whutuporo	wh~ E u t u p o r o
Ākene	k e n e
Ōpango	p a n g o
Aku	k u
Anā	n
Aorangi	o r a N i
Aromātai	r o m a t a i
Ataarangi	t a r a N i
Emma	m a
Haria	a r i a
Hatupatu	a t u p a t u
Horouta	o r o u t a
Inea	n e a
Ipu	p u
Kaipōti	i p o t i
Kaiwhakaako	i r k a k o
Kapene	a p e n e
Kauwhata	a u w a t a
Koe	o e
Kohanga	o h a Ng~ a
Kuaka	u a k a
Makau	a k a u
Mano	a n o
Maraenui	a r a e n u i
Mokoia	o k o i a
Mātua	a t u a
Nōna	r 3 n a
Paengawhāwhā	a g a w h a wh~
Paraihe	a r a i e
Pera	e r a
Ponga	o n g a
Pūnaha	u n a h a
Rangitaiki	a N i t a i k i
Rereroa	e r e r o a
Roera	o E r a
Rēhita	a N h i t a
Taiopenga	a i o p e n g a
Tangaere	a N a e r e
Tirikātene	i r i k a t e n e
Tokowhā	o k o w h a
Turei	u r e i
Tīmatanga	i m a t a n g a
Tūhurahia	u u r a h i a
Wero	e r o
Whakaminenga	h a k a m i n i Ng~ a
Whakanui	h a k a n u i
Whakataetae	h a k a t a e t a e
angaanga	a N a n g a
anuanu	a n u a n u
aria	a r i a
aute	a u t e
haehaea	h a e h a e a
haupapa	h a u p a p a
heri	h e r i
hina	h i n a
hiriwa	h i r i w a
ho	h o
huata	w a t a
hōpua	h o p u a
kahakina	k a h a k i n a
kaihautu	k a i h a u t u
kaihoahoa	k a i h o a h o a
kaitātaki	k a i t a t a k i
kaiwhakautu	S i r k a u t u
kohua	k o w a
konganuku	k o N a n u k u
konohete	q o n o h e t e
koti	k o t i
kuao	k u a o
kānapanapa	k a nj~ 3 u t " u u t " u
maharatanga	m a h a r a t a n g a
mahau	m a h a u
maheni	h e n i
manapori	m a n a p o r i
marere	m a r e r e
marika	m a r i k a
marumaru	m a r u m a r u
mere	m e r e
māhita	m a h i t a
māka	m a k a
mātāpuna	m a t a p u n a
ngēnei	N a N n e i
nohonoho	n o h o n o h o
nou	n u
oati	o a t i
our	o u r
pahua	p a w a
papā	p a p
parae	p a r a e
parera	p a r e r a
pati	p a t i
piua	p i u a
poipoia	pw~ a p o i a
potaka	p o t a k a
poutokomanawa	p o u t o k o m a n a w a
pukana	p u k a n a
punahiko	p u n a i k o
pūata	p u a t a
pūrēhua	p u r a N w a
pūtoro	p u t o r o
raiti	r a i t i
raweketia	r a w e k e t i a
rehita	r e h i t a
retireti	r e t i r e t i
takuta	t a k u t a
taraipiunara	t a r a i p i u n a r a
taumau	t a u m a u
taunaha	t a u n a h a
taurea	t a u r e a
tawai	t a w a i
tohutō	t o w a
tokowha	t o k o w a
tumanakohia	t u m a n a k o h i a
tö	t o
tāniko	m a n i k o
tāruatanga	m a r u a t a n g a
tīwhiri	t i wh~ E i r i
tōtā	t o t a
tūkinotia	t u k i n o t i a
tūtata	t u t a t a
tūī	t u i
uaratanga	u a r a t a n g a
urutā	m a
weera	w e n r a
wetekina	w e t e k i n a
whakahekenga	wh~ E k a h e k e n g a
whakamaheretanga	wh~ E k a m a h e r e t a Ng~ a
whakamaramatia	wh~ E k a m a r a m a t i a
whakamaroke	wh~ E k a m a r o k e
whakamātao	wh~ E k a m a t a o
whakataungia	wh~ E k a t a u N i
whakatinanatia	wh~ E k a t i n a n a t i a
whakatūtū	wh~ E k a t u t u
whakawera	wh~ E k a w e r a
whakawāteatia	wh~ E k a w a t e a t i a
wharepuni	wh~ E a r e p u n i
whitia	wh~ E i t i a
whārua	w h a r u a
whēnā	w  n
wāpu	a  p u
Āhuahanga	w a h a Ng~ a
Ākona	q o n a
Ōpōtiki	p o t i k i
Aotaki	o t a k i
Hakawau	a k a w a u
Hapanihi	a p a n i h i
Hauiti	a u i
Hineteiwaiwa	i n e t s a i w a
Hopa	o p a
Hurihia	u r i h i a
Hīroa	i r o a
Iāri	a r i
Kaiwhakarite	i r k a r i t e
Katerina	a t e r i n a
Kohitātea	h i t a t e a
Kōmiti	k o j i t i
Maihi	i 7 i
Manawatu	a n a w a t u
Maria	a r i a
Matahiko	a t a i k o
Matapihi	a t a p i 7 i
Mōteatea	o t e a t e a
Nene	e n e
Ngārimu	g a r i m u
Nōku	 u
Perohuka	e r o u k a
Punarua	u n a r u a
Putanga	u t a Ng~ a
Pōtiki	o t i k i
Rangitihi	a N i t i 7 i
Rehunga	e h u N a
Rite	i t e
Rokohanga	o k o h a Ng~ a
Rongomaraeroa	o N o m a r a e r o a
Roopū	o p u
Ruapehu	u a p e h u
Rāhiri	a i r i
Rōpata	o p a t a
TMoA	o
Takirua	a k i r u a
Taria	a r i a
Taumārere	a u m a r e r e
Tawhiti	a w h i t i
Team	e a m
Tetahi	e t a h i
Tiro	i r o
Tuwhakararo	u w k a r a r o
Tāmihana	a m i h a n a
Tātaki	a t a k i
Tūmanako	u m a n a k o
Tūrangawaewae	u r a N a w a e w a e
Tūrongo	u r o n g o
Tūtarawānanga	u t a r a x nj~ 3 n g a
Uia	i a
Uniana	n i a n a
Ururoa	r u r o a
Whakaora	h a k a o r a
Whakapakari	h a k a p a k a r i
Whakatūria	h a k a t u r i a
Whakawhanake	h a k r u f 3 n k e
Whiting	h i t i N
aio	a y o
araa	a r a
areare	a r e a r e
aromatawaitia	a r o m a t a w a i t i a
hauwai	h a u w a i
heeki	h e k i
hikina	h i k i n a
hoenga	h o i Ng~ a
hohonutanga	h o h o n u t a Ng~ a
houra	h o u r a
huaketo	w a k e t o
hupa	h u p a
hāngū	h a N u
hōmai	h k o j a i
imu	i m u
irāmutu	i r a m u t u
ite	i t e
kaitōrangapū	k a i k k a r a N a p u
kakari	k a k a r i
karaitiana	k a r a i t i a n a
kikī	k i k i
kitehia	k i t e h i a
koira	k o i r a
koiri	k o i r i
kokoraho	k o k o r a h o
kora	k o r a
koronga	k o r o n g a
kororia	k o r o r i a
kuaha	k u a h a
kāpō	l p o
kōtiti	k o t i t i
mahita	m a h i t a
mangere	m a n g e r e
matara	m a t a r a
matarua	m a t a r u a
mauru	m a u r u
mene	m E n E
miti	m i t i
mōmona	m o m o n a
mōrahi	m o r a h i
nehua	n e w a
ngaiotanga	N a i o t a Ng~ a
ngarahu	N a r a h u
ngaronga	N a r o n g a
ngarongaro	N a r o N a r o
nunumi	n u n u m i
onepu	n e p u
paetara	p a e t a r a
pahore	p a h o r e
paihana	p a i h a n a
paoa	p a o a
paparinga	p a p a r i Ng~ a
pm	p m
powhiri	p o w i r i
püoru	p 3 o r u
pākawa	p a k a w a
pākiki	p a k i k i
pāpaka	p a p a k a
pāpaku	p a E k p~ E k u
pāpono	p a p o n o
pātengi	p a t e N i
pātere	p a t e r e
pōwhiritia	p o wh~ E i r i t i a
pūhihi	p u i 7 i
pūkaha	p u k a h a
pūmatua	p u m a t u a
pūtahitanga	p u t a h i t a Ng~ a
raihi	r a i 7 i
rakuraku	r a k u r a k u
rarahi	r a r a h i
raupo	r a u p o
rehe	r E e
rehu	r e h u
tahitahi	t a h i t a 7
takuhe	t a k u e
taratahi	t a r a t a h i
tarau	t a r a u
tarea	t a r e a
tareka	t a r e k a
tatanga	t a t a n g a
temepara	t e m e p a r a
tepe	t e p e
tuaiwa	t u a i w a
tuatangata	t u a t a N a t a
tukitukia	t u k i t u k i a
tukurua	n a a
tutua	t u t u a
tānekaha	m a n e k a h a
tātea	m a t e a
tēneti	t a N n e t i
tūpuhi	t u k
tūtakitanga	t u k i t a Ng~ a
tūātipu	t u a t e p u
unga	u N a
ura	u r a
wairewa	w a i r e w a
wairuatanga	w a i r u a t a n g a
wewete	w e w e t e
whaikorero	wh~ E a i k o r e r o
whakaahuru	wh~ E k a r u r u
whakaawhiwhia	wh~ E k a u f i wh~ E i a
whakakite	wh~ E k a k i t e
whakakorikori	wh~ E k a k o r i k o r i
whakamoea	wh~ E k a m o e a
whakangungua	wh~ E k a n g u N u a
whakangā	wh~ E k a N
whakapaingia	wh~ E k a p a i N i
whakapānga	wh~ E k a p a Ng~ a
whakarauika	wh~ E k a r a u i k a
whakaruru	wh~ E k a r u r u
whakataua	wh~ E k a t a u a
whakatauritea	wh~ E k a t a u r i t e a
whakatikanga	wh~ E k a t i k a n g a
whakatina	wh~ E k a t i n a
whakau	wh~ E k a u
whakaupoko	wh~ E k a u p o k o
whakawahia	wh~ E k a w a h i a
whakawaho	wh~ E k a w a h o
whakawākanga	wh~ E k a w a k a n g a
whanatu	wh~ E a n a t u
wiwi	w i w i
Āpiti	p i t i
ēra	a N r a
ōritenga	o r e g a
Arikinui	r i k i n u i
Aupouri	u p o u r i
Erihana	r i h a n a
Erueti	r u e t i
Hari	a r i
Heikōkō	e i k  o
Hinetūāhōanga	i n e t u a o a Ng~ a
Hira	i r a
Hunia	u n i a
Hāre	a r e
Hēni	a N n i
Hōhepa	o h e p a
Ihoa	h o a
Inaianei	n a i a n e i
Kererū	e r a i n u
Kirihi	i r i 7 i
Kite	i t e
Kohia	h i a
Korowai	o r o w a i
Koutu	o u t u
Kui	u i
Kō	o
Mareikura	a r e i k u r a
Mauria	a u r i a
Mete	e t e
Moerewa	o e r e w a
Māhuri	a u r i
Māramatanga	a r a m a t a n g a
Ngahiwi	g a h i w i
Ngohi	g o h i
Paetahi	a e t a h i
Panui	a n u i
Papakura	a p a k u r a
Parker	a r k a r
Patu	a t u
Poroporoaki	o r o p o r o a k i
Power	o w e r
Putea	u t e a
Pākeha	a k e h a
Pātiti	a t i t i
Pīra	i r a
Pōkai	 a i
Pōkeka	 e k a
Rangitāke	a N i t a k e
Rangiwewehi	a N i w e w e h i
Rikiriki	i k i r i k i
Rīpeka	o e k a
Tahupōtiki	a h u p o t i k i
Takiwā	a k i a
Tawhiuau	r u f i u a u
Tikitiki	i k i t i k i
Topeora	o p e o r a
Totara	o t a r a
Tree	r e
Tuini	k i n i
Tāwhaki	a wh~ E a k i
Tūhourangi	u o u r a N i
Waihanga	i h a Ng~ a
Waihou	i h o u
Whakarewarewa	h a k a r e w a r e w a
Whanui	h a n u i
Whawhai	h a l a i
Whāiti	h a i t i
ahurewa	a h u r e w a
aia	a i a
arongia	a r o N i
arumoni	a r u m o n i
atamai	a t a m a i
aukatia	a u k a t i a
hapuu	h a p u
hikaka	h i k a k a
hikohiko	h i k o h i k o
hirahira	h i r a h i r a
hiraka	h i r a k a
hoahoatia	h o a h o a t i a
hope	h o p e
hukapapa	h u k u t " u t " u
humarie	h u m a r i e
huripoki	h u r i 7 p o k i
hāwhe	h a wh~ E e
hēki	 k i
hīanga	h i a Ng~ a
hōhā	h o h a
hōtoke	h o t o k e
kaati	k a t i
kahikatea	k a h i k a t e a
kaikanikani	k a i k k i a n i k a n i
kairūri	k a i r a k a i
kaitakawaenga	k a i t a k u c i Ng~ a
kaiārahitanga	k a i k k a r a h i t a Ng~ a
kaiāwhina	k a i k k a w h i n a
kapiheihana	k a pw~ i  i h a n a
kawakawa	k a w a k a w a
kee	k e
koka	k o k a
kokowai	k o k o w a i
konutai	q o n u t a i
kāreti	k a r e t i
kōhari	k o a r i
kōhine	k o h i n e
kōkiritia	k  i r i t i a
kōkopu	k  o p u
kōrerotanga	k o r e r o t a Ng~ a
maminga	m a m i Ng~ a
matawhenua	m a t a f e n u a
methamphetamine	m e t a m h e t a m i n e
mira	m i r a
motukore	m o t u k o r e
mōwhiti	m o wh~ E i t i
ngare	N a r e
ngohengohe	N o h 3 N o h e
ngātahitia	N a t a h i t i a
nohopuku	n o h o p u k u
nuitanga	n u i  n g a
paihere	p a i h e r e
panonitanga	p a n o n i t a Ng~ a
papapaki	p a p a p a k i
pararopi	p a r a r o p i
pataka	p a t a k a
pato	p a t o
pehi	p e h i
porowini	p o r o w i n i
puiaki	p u i a k i
putaputa	p u t a p u t a
pütaiao	p 3 t a i a o
pāhotia	p a h o t i a
pēneitia	l u a N n e i t i a
pūataata	p u a t a t a
pūtahi	p u t a h i
rakatira	r a k a t i r a
ramarama	r a m a r a m a
rangahautia	r a N a h a u t i a
rapuhia	r a p u h i a
rauna	r a u n a
raupua	r a u p u a
rerewē	r E r E f a N
ripi	r i p i
ruaki	r u a k i
ruinga	r u i Ng~ a
rupeke	n i n e k e
rāpoi	r a p o i
taewa	t a e w a
tare	t a r e
tataunga	t a t a u N a
tatua	t a t u a
tauārai	t a w a r a i
teenaa	% t e n a
teetehi	t e e t e h i
tete	t e t e
tiakareti	t i a k a r e t i
tikiake	t i k i a k e
tikitiki	t i k i t i k i
tipi	t e p i
tiwai	t i w a i
tuatini	t u a t i n i
tuituia	t u i t u i a
turituri	t u r i t u r i
tāhae	m a a e
tāporowhita	m a p o r o wh~ E i t a
tāraia	m a r a i a
tāroa	m a r o a
tātā	m a t a
tūmatarau	t u m a t a r a u
tūruhi	t u r u h i
urutaunga	t a u N a
waaawa	w a a w a
wahapu	w a h a p u
waihoe	w a i h o e
whakaahuatanga	wh~ E k a a w a t a n g a
whakaihiihi	wh~ E k a i h i i 7 i
whakakotahitia	wh~ E k a k o t a h i t i a
whakakīia	wh~ E k a k i i a
whakanao	wh~ E k a n a o
whakanohonoho	wh~ E k a n o h o n o h o
whakaotinga	wh~ E k a o t i Ng~ a
whakapakoko	wh~ E k a p a k o k o
whakapaoho	wh~ E k a p a o h o
whakatairangahia	wh~ E k a t a i r a N a h i a
whakatōngia	wh~ E k a a N i
whakawhanaketia	wh~ E a b o r u f 3 n k e t i a
whanako	u f 3 n k o
whatiwhati	wh~ E a t a k a t i
where	w h e r e
whirinaki	wh~ E i r i n a k i
whēnei	w  n e i
wānangahia	a  l i s nt~ a
Āpitihanga	p i t i e n a Ng~ a
āraia	a r a i a
ūhia	u i a
Ahurea	h u r e a
Emepaea	m e p a e a
Haramai	a r a m a i
Hare	a r e
Haumiatiketike	a u m i a t i k e t i k e
Hauāuru	a a u r u
Hikareia	i k a r e i a
Hikitia	i k i t i a
Hiruharama	i r u h a r a m a
Huakina	u a k i n a
Huka	u k a
Hōnore	r 3 n o r e
Intent	t e n t
Kaati	a t i
Kainga	i Ng~ a
Karen	a r e
Karuwhā	a r u w h a
Kate	a t e
Kim	i m
Koina	o i n a
Koira	o i r a
Kuri	u r i
Kōhungahunga	o u N a h u N a
Matahi	a t a h i
Matangi	a t a n g i
Mataora	a t a o r a
Maungapohatu	a u N a p o h a t u
Morehu	o r e h u
Muriwhenua	u r i wh~ e n u a
Mātakitaki	a t a k i t a k i
Mātanga	a t a Ng~ a
Mātāpono	a t a p o n o
Mōhiotanga	o u h a o t a Ng~ a
Ngawai	g a w a i
Ohu	h u
Opening	p e n i N
Pa	a
Paenga	a i Ng~ a
Paepae	a e p a e
Paki	a k i
Pitiroi	i t i r o i
Poraka	o r a k a
Poutūterangi	o u t u t E r a N i
Pūmotu	u m o t u
Rakera	a k e r a
Raraunga	a r a u N a
Rawhiti	a w h i t i
Rewa	e w a
Riki	i k i
Riri	i r i
Rāngai	a N a i
Rāpata	a p a t a
Tamure	a m u r e
Tapere	a p e r e
Tapuwae	a p u w a e
Taute	a u t e
Tawhirimatea	r u f i r i m a t e a
Tono	o n o
Torere	o r e r e
Tura	u r a
Tānerore	nj~ 3 e r o r e
Tītokowaru	i t o k o w a r u
Uiui	i u i
Waimarie	a i m a r i e
Whakaaturanga	h a k a t u r a Ng~ a
Whakahirahira	h a k a h i r a h i r a
Whakahētanga	h a k a  t a Ng~ a
Whakarawea	h a k a r a w e a
Whakarewa	h a k a r e w a
Whanga	h a n g a
Wiwi	i w i
Wātaka	a t a k a
Wātene	a t e n e
anu	a n u
arohaina	a r o h a i n a
arotakehia	a r o t a k e h i a
auē	a u a N
haea	h a e a
haeretanga	h a e r e t a Ng~ a
hanumi	h a n u m i
haurau	h a u r a u
her	h e r
hiako	h i a k o
hianga	h i a Ng~ a
hikitia	h i k i t i a
hokomaha	h o k o m a h a
horekau	h o r e k a u
horomia	h o r o m i a
horonga	h o r o n g a
hunaia	h u n a i a
huti	h u t i
hīkoitanga	h i k o i t a Ng~ a
inanahi	i n a n a 7 i
iriiri	i r i i r i
kaiaka	k a i a k a
kaiora	k a i o r a
kaioraora	k a i o r a o r a
kaiparau	k a i p a r a u
kaitaka	k a i t a k a
kaiwhakarongo	S i r k a r o n g o
kaiwhakataetae	S i r k a t a e t a e
kakaho	k a k a h o
karangaranga	k a r a N a r a Ng~ a
karawhiua	k a n a l i u a
kauneke	k a u n e k e
kautia	k a u t i a
kea	k e a
kekeno	k e k E n o
kit	k i t
kitakita	k i t a k i t a
kohukohu	k o h u k o h u
kohurutia	k o h u r u t i a
koretake	k o r e  k e
koromatua	k o r o m a t u a
kukune	k u k u n e
kāuta	l u t a
kōingo	k o i Ng~ o
kōpura	k o p i r a
kūpapa	k u t " u t " u
m	m
maatauranga	m a t a u r a Ng~ a
maipi	m a i p i
man	m a n t a
maramatanga	r a m a t a n g a
matahuhua	m a t a w w a
matewai	m a t e w a i
miniti	m i n i t i
mākutu	m a k u t u
ne	n e
ngoikoretanga	N o i k o r e t a Ng~ a
nāu	n a u
omanga	o m a n g a
paa	p a
paamu	p a m u
papare	p a p a r e
papariki	p a p a r i k i
papatono	p a p a t o n o
perana	p e r a n a
pi	p i
pirinoa	p i r i n o a
pohutukawa	p o h u n k a w a
porangi	p o r a N i
poutāpeta	p o m a p e t a
puihi	p u i 7 i
pupuhihia	p u p u h i h i a
pākehā	p a k e h a
pāpātanga	p a p a t a Ng~ a
pīrori	p i r o r i
pūhui	p u w i
raau	r a u
rekareka	r e k a r e k a
rika	r i k a
rikarika	r i k a r i k a
rimurapa	l i m u r a
ripo	r i p o
roha	r o h a
rongonga	r o n g o* g a
taane	t a n e
takitoru	t a k i t o r u
tamata	t a m a t a
tangotango	t a N o t a n g o
tapoko	t a p o k o
tapuae	t a p u a e
tarāwaho	t a l a w a h o
tauhohenga	t a u h o h i Ng~ a
tauihu	t a w i h u
tautohetia	t a u t o h e t i a
tauwhāiti	t a u w h a i t i
tawa	t a w a
tawhio	t a l i o
tepu	t e p u
tipuranga	t e p u r a Ng~ a
tirotirohanga	t u r o t i r o h a Ng~ a
titaha	t i t a h a
tokarewa	t o k a r e w a
tokowaru	t o k o w a r u
tupunga	t u p u N a
two	t w o
tä	l o
tākihi	m a k i 7 i
tāwara	m a w a r a
tīhi	t i
tīmatahia	t i m a t a h i a
tīpune	t o u n e
tōia	a i a
utauta	u t a u t a
were	w e r e
whakaatungia	wh~ E k a a t u N i
whakae	wh~ E k a e
whakahouhia	wh~ E k a h o i a
whakakitea	wh~ E k a k i t e a
whakakīa	wh~ E k a k i a
whakakīkī	wh~ E k a k i k i
whakanekeneke	wh~ E k a n e k 3 n 3 q k e
whakangau	wh~ E k a N a u
whakaotia	wh~ E k a o t i a
whakapuakihia	wh~ E k a p o a k i h i a
whakapākehātia	wh~ E k a p a k e h a t i a
whakarerenga	wh~ E k a r e r e n g a
whakarārangitanga	wh~ E k a r a r a N i t a Ng~ a
whakatairangatia	wh~ E k a t a i r a N a t i a
whakatangihia	wh~ E k a t a N i h i a
whakatetonga	wh~ E k a t e t o n g a
whakatikatikahia	wh~ E k a t i k a t i k a h i a
whakawhiwhinga	wh~ E k a l i wh~ E i Ng~ a
whakawhānuitia	wh~ E k a wh~ nj~ 3 i t i a
whatinga	wh~ E a t i Ng~ a
whia	wh~ E i a
whāngaia	w h a N a i a
whāngaihia	w h a N a i h i a
whēkau	w  l 3 m
winika	w i n i k a
Āhea	h e a
Ākina	k i n a 7
Āwhinatia	wh~ E i n a t i a
āpitihanga	a p i t i e n a Ng~ a
Apiata	p y a t r a
Apopo	p o p o
Arahura	r a h u r a
Aro	r o
Erangi	r a n g i
Himi	i m i
Himiona	i m i o n a
Hongongoi	o N o N o i
Huhuti	u h u t i
Huringa	u r i Ng~ a
Hāpai	a p a i
Hēkeretari	a N k e r e t a r i
Io	o
Itāriana	m a r i a n a
Iwikau	w i k a u
Kaihoko	i h o k o
Kaihokohoko	i h o k o h o k o
Kairēhita	a i r a N h i t a
Kani	a n i
Kararaina	a r a r a i n a
Karipori	a r i p o r i
Kawa	a w a
Kawenga	a w e n g a
Kiritaki	i r i t a k i
Komene	o m E n E
Kānata	nj~ 3 a t a
Kōhine	o h i n e
Kōkiritia	 i r i t i a
Kōpae	o p a e
Mahue	a h u e
Maia	a i a
Maioha	a i o h a
MakaawhioTe	a k a u f i o e
Maketū	a k e t u
Mango	a n g o
Manukura	a n u k u r a
Maranga	a r a Ng~ a
Meri	e r i
Mihingare	i h i N a r e
Muaūpoko	u a u p o k o
Māehe	a e e
Mīharo	i e n a
Nepia	a p i a
Ngahue	g a h u e
Ngaro	g a r o
Ngatiporou	g a t i p o r o u
Nōema	o e m a
Nōu	o u
Oro	r o
Pahiatua	nt~ a t u a
Pehea	e h e a
Penei	e n e i
Pine	i n e
Poronīhia	o r o n i i a
Porourangi	o r o u r a N i
Prominent	r o m i n e n t
Pukemiro	u k e m i r o
Punga	u N a
Puritia	u r i t i a
Pāti	a t i
Pēhia	a N i a
Pēnei	a N n e i
Pēnā	a N n
Pūkeko	u k e k o
Pūrehuroa	u r e h u r o a
Raina	a i n a
Rangihoua	a N i h o u a
Rima	i m a
Ringa	i n i n
Ruahine	u a h i n e
Ruatoki	u a t o k i
Rukupō	u k u p o
Rātou	a t o u
Rīpera	o e r a
Taane	a n e
Takuta	a k u t a
Tarahiti	a r a h i t i
Taraia	a r a i a
Tatū	a t u
Taupiri	a u p i r i
Tauwhao	a u w a o
Tiamani	i a m a n i
Timoti	i m o t i
Tomoana	o y a n a
Tuhoro	a h o r o
Tupai	u p a i
Tutekohi	u t e k o h i
Tāmanuhiri	a i r i
Tūmatanui	u m a t a n u i
Waitohi	i t o h i
Whakatika	h a k a t i k a
Whakawhitiwhitinga	h a k a wh~ E i t i wh~ E i t i Ng~ a
Whangaparaoa	h a N a p a r a o a
Wharekahika	h a r e k a i k a
Whero	h e r o
Whāingaroa	h a i N a r o a
Whārangi	h a r a N i
Women	e n
anana	a n a n a
angitūtanga	a N i t u t a Ng~ a
atarau	a t a r a u
aunoa	a u n o a
haereere	h a e r a e r e
haha	r a r a
hakahaka	h a k a h a k a
hapuku	h a p u k u
haukū	h a u k u
hoehoe	h o e h o e
hoha	h o h a
huatanga	w a t a n g a
huru	h u r u
hāpiripiri	h a p i r i p i r i
hīnau	h i N a u
inumia	i n u m i a
iro	i r o
kahupapa	k a k u p a p a
kaiao	k a i a o
kaihāpai	k a i h a p a i
kaiurungi	k a i u r u N i
kaiwhakauru	S i r k a u r u
kapukapu	k a p u k a p u
kapuni	k a p u n i
karengo	k a r e n g o
kauhanga	k a u a Ng~ a
kauruku	k a u r u k u
kauwae	k a u w a e
kurikuri	k u r i k u r i
kë	k 3
kēne	q e n e
kōmiti	k o m i t i
maharahara	m a h a r a h a r e y
maharatia	m a h a r a t i a
maihi	m a i 7 i
maire	m a i r
makuku	k u k u
mataitai	m a t a i t a i
matakuikui	m a t a k u i k u i
matapōkere	m a t a p  e r e
mauiui	m a u i u i
maungārongo	m a u N a r o n g o
mawehe	m o r o k i e
meremere	m e r a m e r e
minenga	g a
mohoao	h o  a o
mumura	m u m u r a
murunga	m u r u N a
māhanga	m a a Ng~ a
mānukanuka	m nj~ 3 u k a n u k a
mārie	m a r i e
mātinitini	m a t i n i t i n i
nahanaha	n a h a n a h a
ngakia	N a k i a
ngangahau	N a N a h a u
ngaunga	N a u N a
noti	n o t i
nukua	n u k a
nupepa	n u p e p a
other	o th~ e r
pakapaka	p a k a p a k a
panana	p a n a n a
papakāinga	p a p a l i Ng~ a
parapara	p a r a p a r a
peeke	p e e k e
pihanga	p i t a Ng~ a
pikopiko	p i k o p i k o
poapoa	p o a p o a
pohatu	p o h a t u
poitarawhiti	pw~ a n a l i t i
pokanga	p o k a n g a
puha	p u h a
punarua	p u n a r u a
puoru	p u o r u
pä	p 3 7
pāmahana	p a m a h a n a
pāti	p a t i
pīkau	p i l 3 m
pūmautanga	p u m a u t a Ng~ a
rahaki	r a h a k i
raho	r a h o
rangitaki	r a N i t a k i
rapea	r a p e a
raupapahia	r a u p a p a h i a
raupō	r a u p o
rawekehia	r a w e k e h i a
rehurehu	r e h u r e h u
riha	r i h a
rātonga	r a t o n g a
rēhitatanga	r a N h i t a t a n g a
taitapa	t a i t a p a
takahitanga	t a k a h i t a Ng~ a
takakino	t a k a k i n o
tanuku	t a n u k u
taramea	t a r a m i a
tautō	t a w a
tieki	t i e k i
titikaha	t i t i k a h a
tohenga	t o h 3 N a
tohumate	t o h u m a t e
toke	t o k e
tuahu	t u a u
tukuruatia	n a a t i a
tukutahi	n k u t a h i
tumau	t u m a u
tuuturu	t u t u r u
tāhuna	m a u n a
tāpaetia	m a p a e t i a
tēneki	t a N n e k i
tīni	t i n i
tōmuatanga	a m u a t a n g a
uriuri	u r i u r i
urungi	u r u N i
wahangote	w a h a N o t e
wahangū	w a h a N u
waireka	w a i r e k a
wani	w a n i
wawahi	b i nt~
weri	w e r i
weriweri	w e r i w e r i
whae	wh~ E a e
whaiti	wh~ E a i t i
whakaangi	wh~ E k a n u
whakahihi	wh~ E k a h i 7 i
whakahuahua	wh~ E k a w a w a
whakahuihui	wh~ E k a w i w i
whakakapinga	wh~ E k a k a p i Ng~ a
whakakaupapa	wh~ E k a k a u p a p a
whakakā	wh~ E k a l
whakamanawa	wh~ E k a m a n a w a
whakamaru	wh~ E k a m a r u
whakamihia	wh~ E k a m i h i a
whakangaromia	wh~ E k a N a r o m i a
whakaparahako	wh~ E k a p a r a h a k o
whakapokenga	wh~ E k a p o k e n g a
whakaputahia	wh~ E k a p u t a h i a
whakarereketanga	wh~ E k a r e r e k e t a Ng~ a
whakarihariha	wh~ E k a r i t a r i h a
whakatautau	wh~ E k a t a u t a u
whakatematau	wh~ E k a t e m a t a u
whakatikahia	wh~ E k a t i k a h i a
whakatoi	wh~ E k a t o i
whakatokia	wh~ E k a t o k i a
whakawaiwai	wh~ E k a w a i w a i
whakawhiu	wh~ E k a l i u
whakawhānuihia	wh~ E k a w h a n u i h i a
whiwhia	wh~ E i wh~ E i a
whänui	wh~ E 3 n u i
whāngote	w h a N o t e
wähanga	w 3 a Ng~ a
wāhitau	a  h i t 3
āhuru	a u r u
ēhara	a N a r a
ētita	a N t i t a
Īhu	h u
ōkiko	 i k o
Ama	m a
Anaru	n a r u
Arihia	r i h i a
Arowhenua	r o wh~ e n u a
Awatere	w a t e r e
Ema	m a
Europe	u r o p e
Hautanga	a u t a Ng~ a
Hea	e a
Heeni	e n i
Hekenukumai	e k 3 n u k m a i
Hemana	e m a n a
Hohepa	h e p a
Hokinga	o k i Ng~ a
Honoa	n o a
Horror	u r o r
Huarahi	u a r a h i
Huata	u a t a
Hērangi	a N r a N i
Hētana	a N t a n a
Hōtaka	o t a k a
Irihāpeti	r i h a p e t i
Itāria	m a r i a
Kahawai	a h a w a i
Kaikoura	i k o u r a
Kano	a n o
Kaporeihana	a p o r e i h a n a
Kapua	a p u a
Kaumātua	a u m a t u a
Kerikeri	e r i k e r i
Kino	i n o
Koata	o a t a
Koutou	o u t o u
Kāo	a o
Kēnana	a N n a n a
Mahinga	a h i n g a
Maiharanui	i t a r a n u i
Makere	a k e r e
Mangu	a N u
Maraea	a r a e a
Marangai	a r a N a i
Maritime	a r i t i m e
Matuku	a t u k u
Meinga	e i Ng~ a
Mokena	o k e n a
Motueka	o t u e k a
Mōmona	k o j o n a
Nainoa	a i n o a
Ngahere	g i*
Ngaiterangi	g a i t E r a N i
Niho	i h o
Nina	i n a
Nukutaurua	u k u t a u r u a
Nāhinara	a h i n a r a
Pangarau	a N a r a u
Patua	a t u a
Peihopa	e i h o p a
Pem	e m
Poroumata	o r o u m a t a
Porowini	o r o w i n i
Poutāpeta	o m a p e t a
Puka	u k a
Pāpori	a p o r i
Rapanga	a p a n g a
Rongomaurikura	o N o m a u r i k u r a
Roroa	o r o a
Ruataupare	u a t a u p a r e
Taika	i k a
Takiura	a k i u r a
Tamarau	a m a r a u
Tarakawa	a r a k a w a
Taumarere	a u m a r e r e
Tautohua	a u t o w a
Teko	e k o
Tikipunga	i k i p u N a
Tona	o n a
Two	w o
Tāhū	a u
Tūranganui	u r a N a n u i
Uawa	a w a
Uhia	h i a
Wahawaha	a h a w a h a
Waihau	i h a u
Waiomatatini	a i o m a t a t i n i
We	e
Weka	e k a
Whaanga	h a n g a
Whaia	h a i a
Whaitua	h a i t u a
Whakahau	h a k a h a u
Whakapiki	h a k a p i k i
Whakarapa	h a k a r a p a
Whakaruruhau	h a k a r u r u h a u
Whakarōpūhia	h a k a r o p u i a
Whakarōpūngia	h a k a r o p u N i
Whakatairitea	h a k a t a i r i t e a
Whakataki	h a k a t a k i
Whakatō	h a k a a
Whakawhitinga	h a k a wh~ E i t i Ng~ a
Whangamata	h a N a m a t a
Wharepukapuka	h a r e p u k a p u k a
Whatahoro	h a t a h o r o
akina	u ly~ o
am	a m
aromatawaia	a r o m a t a w a i a
arorangi	a r o r a N i
arowhai	a r o w a i
auare	a u a r e
awhikiri	r u f i k i r i
awhinatia	a w h i n a t i a
ekea	e k e a
haeata	h a e a t a
hahae	h a h a e
haratau	h a r a t a u
haua	h a u a
haumano	h a u m a n o
hauwarea	h a u w a r e a
hekaheka	h e k a h e k a
hiwa	h i w a
hoake	h o a k e
hoi	h o i
hoka	h o k a
hongere	h o N e r e
huanui	w a n u i
hukea	h u k e a
hungawai	h u N a w a i
hīmene	h i m E n E
hōanga	h o a Ng~ a
ihumanea	i h u m a n e a
inaki	i n a k i
inati	i n a t i
inihua	i n i w a
into	i n t o
kaikauwhau	k a i k k i a u w h a u
kaikerēme	k a i k k i e r a N nd~ e e
kaimātakitaki	k a i m u f a a t a k i t a k i
kaiuru	k a i u r u
kaiwhakaputa	S i r k a p u t a
kakenga	k a k e n g a
kamera	k a m E r a
karaipiture	k a r a i p i t u r e
karakiatia	k a r a k i a t i a
kaurori	k a u r o r i
ketia	k e t i a
kiki	k i k i
kirikā	k i r i k a
kirīmi	l i m i
kohuke	k o h u k e
koke	k o k e
koranehe	k o r a n e h e
koroke	k o r o k e
koroputa	k o r o p u t a
korou	k o r o u
kuhua	k u w a
kukupa	k u k u p a
kukuti	k u k u t i
kuwaha	k u w a h a
kāika	l i k a
kārangaranga	k a r a N a r a Ng~ a
kōhi	k o
kōhuru	k o u r u
kōpu	k o p u
kūare	k u a r e
kūhuka	k u u k a
maaka	m a k a
maara	m a d a
mahora	m a h o r a
maikuku	m a i k u k u
maina	m a i n a
matemateaone	m a t e m a t e y
matewhawhati	m a t e u f 3 k a t i
meake	m e a k e
mekemeke	m E k E m E t e k e
mete	m e t e
moemoehia	m o e m o e h i a
moohiotia	h i o t i a
mounu	% m a u n u
māhorahora	m a  n e h o r a
māwhaiwhai	m a wh~ i r a i
nawai	n a w a i
ngaherehere	N a h e r e h e r e
ngakinga	N a k i Ng~ a
ngawha	N a l a
ngawhere	N a w h e r e
ngāherehere	N a h e r e h e r e
ngāngara	N nj~ 3 g a r a
niu	n i u
notemea	n o t t e m i a
nōku	n  u
nōu	n o u
ohinga	h i n g a
okiokinga	o k i o k i Ng~ a
onge	o n g e
orokati	o r o k a t i
orooro	o r o o r o
pakaruhia	p a k a r u h i a
pangarau	p a N a r a u
paopao	p a o p a o
papaneke	p a p a n e k e
paraharaha	p a r a h a r a h a
parau	p a r a u
parehe	p a r e e
parekareka	p a r e k a r e k a
pikau	p i k a u
piripiri	p i r i p i r i
pitomata	p i t o m a t a
poriro	p o r i r o
poutiriao	p o u t i r i a o
pākia	p a k i a
pāorooro	p a o r o o r o
pātū	p a t u
pūare	p u a r e
pūeru	p u e r u
pūhou	p u u
rangatū	r a N a t u
rarua	r a r u a
rauawa	r a o w e r a
rimurimu	l i m u r i m u
roko	r o k o
rāpihi	r a p i 7 i
rārangitia	r a r a N i t i a
rīriri	r i r i r i
taana	t a n a
tahia	t a h i a
tahora	t a h o r a
takaroa	t a k a r o a
tamarikitanga	t a m a r i k i t a Ng~ a
tapatapahi	t a p a t a p a h i
tapawha	t a p a l a
taraute	t a r a u t e
tauaki	t a w a k i
taupua	t a u p u a
taupū	t a u p u
tautiaki	t a u t i a k i
tauwehe	t a u w e h e
tene	t e n e
three	t r e
tiakarete	t i a k a r e t e
tiima	t i i m a
titia	t i t i a
tohutao	t o h u t a o
tohutoa	t o h u t o a
topuni	t o p u n i
tuakiritanga	t u a k i r i t a Ng~ a
tuawha	t u a l a
tunutunu	t u n u t u n u
turia	t u r i a
tāea	m a e a
tāiri	m a i r i
tākai	m a k a i
tākoha	m a k o h a
tāruaruatia	m a r u a r u a t i a
tātua	m a t u a
tāwharau	m a wh~ a r a u
tēnehi	t a N n e h i
tūmanakohia	t u k o h i a
tūtohutanga	t u t o h u t a Ng~ a
tūwatawata	t u w a t a w a t a
waehere	w a e h e r e
waharoa	w a h a r o a
waimeha	w a i m e h a
waitohua	w a i t o w a
werowero	w e r o w e r o
whakaatangia	wh~ E k a t a N i
whakahawea	wh~ E k a h a t a w e a
whakahihiri	wh~ E k a h i h i r i
whakairotia	wh~ E k a i r o t i a
whakakeke	wh~ E k a k e k e
whakakorenga	wh~ E k a k o r e n g a
whakamanamana	wh~ E k a m a n a m a n a
whakamaramatanga	wh~ E k a m a r a m a t a n g a
whakamatauria	wh~ E k a m a t a u r i a
whakamohiotia	wh~ E k a m o h i o t i a
whakapaea	wh~ E k a p a e a
whakapeto	wh~ E k a p e t o
whakarangatira	wh~ E k a r a N a t i r a
whakarata	wh~ E k a r a t a
whakaraupapahia	wh~ E k a r a u p a p a h i a
whakareka	wh~ E k a r e k a
whakarua	wh~ E k a r u a
whakatūwhera	wh~ E k a t u wh~ e r a
wikitōria	w i k i a r i a
Āhitana	h i t a n a
āniwaniwa	nj~ 3 w a n i w a
ātanga	a t a Ng~ a
āteha	a t e h a
ātārangi	a t a r a N i
āwhio	a wh~ E i o
Ahau	h a u
Ahia	h i a
Ahumahi	h u m a h i
Akona	q o n a
ApiTrak	p i r a
Haimona	a i m o n a
Hapani	a p a n i
Haumia	a u m i a
Haunga	a u N a
Herangi	e r a N i
Heteroptera	e t e r o p t E r a
Hineahuone	i n e a w o n e
Hinerangi	i n e r a N i
Hinewai	i n e w a i
Hoahoa	o a h o a
Hopukina	o p u k i n a
Hurihuri	u r i h u r i
Kahui	a w i
Kaimai	a i m a i
Kaitātaki	a y t a t a k i
Kanikani	a n i k a n i
Kapu	a p u
Kaumatua	a u m a t u a
Kea	e a
Keri	e r i
Kerēme	e r a N nd~ e e
Kiki	i k i
Korokī	o r o k i
Koura	o u r a
Kuaha	u a h a
Kumara	u m a r a
Kunenga	u n i Ng~ a
Kāpehu	a p e h u
Kōrerotia	o r e r o t i a
Maimoatanga	a i m o a t a n g a
Manakotanga	a N k o t a Ng~ a
Mangakāhia	a N a l i a
Mangere	a N e r e
Maramataka	a r a m a t a k a
Matthew	a t t a o
Mina	i n a
Momo	o m o
Moteatea	o t e a t e a
Māmoe	a m o e
Mātāmua	a t a a
Nathan	a th~ a n
Ngahuru	g a h u r u
Ngaitai	g a i t a i
Ngāmotu	g a m o t u
Nihoniho	i h o n i h o
Niwa	i w o
Norman	o r m a n
Ohia	h i a
Opera	p e r a
Oreore	r E o r e
Paeko	a e k o
Panuku	a n u k u
Paraparaumu	a r a p a r a u m u
Part	a r
Pehi	e h i
Pena	e n a
Pene	e n e
Pipitea	i p i t e a
Poihana	o i h a n a
Puia	k i a
Pāwhiri	a wh~ E i r i
Pēke	a N k e
Rakaumangamanga	a k a u m a N a m a n g a
Ratapu	a t a p u
Reri	e r i
Ripoata	p o a t a
Rona	o n a
Rongomai	o N o m a i
Rongomātāne	o N o m a t a n e
Ruka	u k a
Rāapa	a a p a
Rākaipaaka	a k a i p a a k a
Taiaroa	a y a r o a
Tangihōro	a N i h o r o
Tangotango	a N o t a n g o
Tararua	a r a r u a
Tarata	a r a t a
Tatou	a t o u
Taurahere	a  i*
Tautoru	a u t o r u
Tawhito	a w h i t o
Teira	e i r a
Tiakina	i a k i n a
Tihei	i h e i
Tira	i r a
Tireiniamu	i r e i a m u
Toia	o i a
Tokaanu	o k a n u
Tokorima	o k o r i m a
Tokowhitu	o k o w h i t u
Tonu	n u
Tuahiwi	u a h i w i
Tumatauenga	u m a t a u e n g a
Tāwhai	a wh~ E a i
Tēna	a N n a
Uara	a r a
Uira	i r a
Wa	a
Waimakariri	a i m a k a r i r i
Waitematā	a y t e m a t a
Wanaka	a n a k a
Whakanoho	h a k a n o h o
Whakarae	h a k a r a e
Whakawhetai	h a k a wh~ e t a i
Whena	h e n a
Whiria	h i r i a
Whiu	h i u
Work	u r
aana	a n a
ahopae	a h o p a e
ahotakakame	a h o t a  k a m e
angiangi	a N i a N i
arapū	a r a p u
aromatawaihia	a r o m a t a w a i h i a
hahau	h a h a u
haoa	h a o a
harakore	h a r a k o r e
hoari	h o a r i
hopua	h o p u a
horu	h o r u
hotu	h o t u
huraina	h u r a i n a
hurumanu	h u r u m a n u
hängai	h 3 N a i
hāpara	h a p a r a
hēkona	 k o n a
hōngere	h r 3 n g e r e
hōtera	h o t E r a
ihupuku	i k u p u k u
ita	i t a
kahanga	k a h a Ng~ a
kaiarataki	k a i a r a t a k i
kaiuiui	k a i k k u i u i
kaiwawao	S i r 3 a o
kaiwhaiwāhi	S i r i r a
kaiwhakatakoto	S i r k a t a k o t o
kakahi	k a k a h i
kakapa	k a k a p a
kakati	k a k a t i
kaokao	k a k a o
kapakapa	k a p a k a p a
kapene	k a p e n e
kaporeihana	k a p o r e i h a n a
karakara	k a r a k a r a
kauanga	k a u a Ng~ a
kawai	k a w a i
kaweake	k a w e a k e
kina	k i n a 7
kinotia	k i n a o t i a
koanga	k o a Ng~ a
koeko	k o e k o
koikoi	k o i k o i
konumohe	q o n u m o h e
kotikoti	k o t 3 k o t i
koukou	k o u k o u
kunenga	k u n i Ng~ a
kāpā	l p
kōwhatu	k o w h a t u
mahea	h e a
mahuetanga	m a w e t a Ng~ a
mahuta	m a h u t a
maiangi	m a i a N i
makatea	m a k a t e a
manatū	m a n a t u
manukanuka	m a n u k a n u k a
mapu	m a p u
marohi	m a o 7 i
matamata	m a t a m a t a
matawā	m a t a a
mauherea	m a u h e r e a
maurea	m a u r e a
mimi	m i m i
motuhenga	m o t u X 3 N g a
māhaki	m a a k i
māraurau	m a r a u r a u
māro	m a r o
ngao	N a o
ngārahu	N a r a h u
niao	n i a o
oanahi	o a n a 7 i
oioi	o i o i
ori	o r i
oropuare	o r o p u a r e
paari	p a m i
pahūtanga	p a h u t a Ng~ a
paitia	p a i t i a
paitini	p a i t i n i
pakia	p a k i a
panuitia	p a n u i  a
paparahi	p a p a r a h i
papānga	p a p a Ng~ a
paramanawa	p a r a m a n a w a
piritahi	p i r i t a 7
poitūkohu	pw~ a t u k o h u
poutama	p o u t a m a
pukai	p u k a i
puranga	p u r a Ng~ a
purere	p u r e r e
puri	p u r i
pāhi	p a
pāuna	p a u n a
pēhitanga	l u a N h i t a Ng~ a
pīpīwai	p o i w a i
pōnānā	p o n nj~ 3
pōuritanga	p o u r i t a Ng~ a
pūhuruhurutanga	p u t a Ng~ a
pūtoi	p u t o i
raparapa	r a p a r a p a
ratarata	r a t a r a t a
raupatunga	r a u p a t u N a
remu	r E m u
rerekore	r e r e k o r e
rewena	r e e n a
ronaki	r o n a k i
ruirui	r u i r u i
rukuruku	r u k u r u k u
taaea	t a e a
tahuritanga	t a h u r i t a Ng~ a
tainga	t a i Ng~ a
takatāpui	t a k a t a p u i
takinga	t a k i Ng~ a
takune	t a k u n e
taote	t a o t e
tapae	t a p a e
tapoi	t a p o i
taupā	t a u p
tautika	t a u t i k a
tauāki	t a w a k i
tawatawa	t a w a t a w a
tawhiri	t a l i r i
teneti	t e n e t i
tineia	t i n e i a
tioro	t i o r o
tiria	t i r i a
tiu	t i u
tokohia	t o k o h i a
tongi	t o N i
tonohia	t o n o h i a
torea	t o r e a
torokaha	t o r o k a h a
totohe	t a t o h e
tuarangi	t u a r a N i
tuhipoka	i p o k a
tukupū	n a p u
tutukitanga	t u t u k i t a Ng~ a
tërä	y r
tāmia	m a m i a
tāmure	m a r e
tātarihia	m a t a r i h i a
tāwhai	m a wh~ E a i
tōpūtanga	a p u t a Ng~ a
tūemi	t u e m i
tūhāhā	t u h a h a
tūmāia	t u m a i a
tūrama	t u r a m a
tūtae	t u t a e
waikura	w a i k u r a
warowaihā	w a r o w a i h a
wawetia	w a w e t i a
whaanau	wh~ E a n a u
whaanui	wh~ E a n u i
whaikiko	wh~ E a i k i k o
whakaahuahanga	wh~ E k a a w a h a Ng~ a
whakaakongia	wh~ E k a k o N i
whakahihiko	wh~ E k a h i i k o
whakahoa	wh~ E k a h o a
whakahuatanga	wh~ E k a w a t a n g a
whakahēngia	wh~ E k a  N i
whakairohia	wh~ E k a i r o h i a
whakangao	wh~ E k a N a o
whakanoa	wh~ E k a n o a
whakanōhia	wh~ E k a n o i a
whakapiripiri	wh~ E k a p i r i p i r i
whakapotonga	wh~ E k a p o t o n g a
whakapāho	wh~ E k a p a h o
whakapākehā	wh~ E k a p a k e h a
whakarōpūtia	wh~ E k a r o p u t i a
whakatara	wh~ E k a t a r a
whakatatū	wh~ E k a t a t u
whakatenatenahia	wh~ E k a t e n a t e n a h i a
whakateraki	wh~ E k a t e r a k i
whakatupatohia	wh~ E k a t u p a t o h i a
whakatuu	wh~ E k a t u
whakawhenumi	wh~ E k a wh~ e n u m i
whawha	wh~ E a l a
whawhaitanga	wh~ E u f 3 i t a Ng~ a
whākōkī	w h a k  i
witi	w i t i
ïnanga	3 n a Ng~ a
āwhinatanga	a wh~ E i n a t a n g a
ē	a N
īpae	o a e
ōritetanga	o r i t e t a Ng~ a
Akaroa	k a r o a
Akau	k a u
Akomanga	k o m a n g a
Amohau	o h a u
Anahera	n a h r a
Anne	a n n e
Aoniwaho	q o n i w a h o
Ararau	r a r a u
Arataki	r a t a k i
Arthur	r t u r
Awanui	w a n u i
Awanuiārangi	w a n u i a r a N i
Awhina	wh~ E i n a
Haami	a m i
Harata	a r a t a
Hekeretari	e k e r e t a r i
Hema	3 m a
Hore	u r e
Horoi	o r o i
Hāpara	a p a r a
Hāpuku	a p u k u
Hāriata	a r i a t a
Hēoi	a N o i
Iron	r o n
Karu	a r u
Katia	a t i a
Kereama	e r e a m a
Kereone	e r e o n e
Kohimarama	h i m a r a m a
Konohi	o n o h i
Koohi	h i
Koroki	o r o k i
Kuhuna	u h u n a
Kākāriki	a k a r i k i
Kōwae	o w a e
Mahaki	a h a k i
Manaakitanga	a n a k i t a Ng~ a
Manawanui	a n a w a n u i
Mangōroa	a N o r o a
Mapi	a p i
Marangaranga	a r a N a r a Ng~ a
Marine	a r i n e
Matatika	m a t a t i k a
Maungatautari	a u N a t a u t a r i
Mereana	e r e a n a
Miramar	i r a m a r
Mita	i t a
Moko	o k o
Moore	o r e
Murirangawhenua	u r a N a wh~ e n u a
Māia	a i a
Ngaa	g a
Ngarimu	g a r i m u
Ngaruawahia	g a r u i nt~ a
Ngātoroirangi	g a t o r o i r a N i
Ngāwai	g a w a i
Niue	i u e
Nohinohi	h i n o h i
Nākahi	a k a h i
Orion	r i o n
Paerau	a e r a u
Panoni	a n o n i
Panuitia	a n u i  a
Para	a r a
Patea	a t e a
Pirīmia	i r i m i a
Poto	o t o
Pouherenga	o u h e r e n g a
Pourangahua	o u r a N a w a
Pumi	r u m i
Pārongo	a r o n g o
Pōwhiri	o wh~ E i r i
Rahoroi	a h o r o i
Rangihīroa	a N i h i r o a
Rangimarie	a N i m a r i e
Rangitukia	a N i t u k i a
Rangitīkei	a N i t i k e i
Rangiuru	a N i u r u
Rapa	a p a
Raukōkore	a u k  o r e
Ripeka	i p e k a
Riu	i u
Ruapekapeka	u a p e k h a p e k a
Ruatāhuna	u a t a u n a
Rukuhia	u k u h i a
Runga	u N a
Taiohi	a i o h i
Taipa	i p a
Tamehana	a m e h a n a
Tangihanga	a N i h a Ng~ a
Tatari	E t E d i t o
Tekapo	e k a p o
Temara	e m a r a
Temi	e m i
Tinana	i n a n a
Tipa	i p a
Tipu	i p u
Tirotiro	i r o t i r o
Tohaina	o h a i n a
Tohutoro	h u t o r o
Toihau	o i h a u
Tokowaru	o k o w a r u
Tomokanga	r a Ng~ a
Turanganui	u r a N a n u i
Turangawaewae	u r a N a w a e w a e
Tāia	a i a
Tōia	o i a
Waahi	a h i
Waikare	i k a r e
Waimamaku	a i m a m a k u
Waiorua	a i o r u a
Whaiaro	h a i 7 r o
Whakaingoatia	h a k a i N o a t i a
Whakairia	h a k a i r i a
Whakatauiratia	h a k a t a u i r a t i a
Whakatauritea	h a k a t a u r i t e a
Whakatu	h a k a t u
Whakaurua	h a k a u r u a
Wheke	h e k e
Whenuanui	h e n u a n u i
Whitireia	h i t i r e i a
Whitu	h i t u
Whāngārei	h a N a r e i
Whāngārā	h a N a r
Winiata	i n i a t a
akitu	a k i t u
aromatawaitanga	a r o m a t a w a i t a Ng~ a
ati	a t i
awenga	a w e n g a
awhitia	a w h i t i a
ei	e i
hainahia	h a i n a h i a
haumako	h a u m a k o
haurongo	h a u r o n g o
hauropi	h a u r o p i
hekeretari	h e k e r e t a r i
hoahoatanga	h o a h o a t a n g a
hohoko	h o h o k o
huakore	w a k o r e
hunuku	h u n u k u
hēneti	 n e t i
hūmarie	h u m a r i e
hūware	h u w a r e
iana	i a n a
iranga	i r a Ng~ a
iringa	i r i Ng~ a
iroiro	i r o i r o
ito	i t o
kaikiri	k a i k k i i r i
kaingia	k a i N i
kaipāho	k a i p a h o
kaitango	k a i t a n g o
kaitaunaki	k a i t a u n a k i
kaituhituhi	k a i t u h i t u h i
kaitukumahi	k a i k k n k u m a h i
kani	k a n i
kapia	k a pw~ i a
kapiti	k a p i t i
kapoa	k a p o a
kaponga	k a p o N a
kareti	k a r e t i
karia	k a r i a
katipoo	k a t i p o
kauaka	k a u a k a
kauta	k a u t a
kirirarau	k i r i r a r a u
koeke	k o e k e
kongakonga	k o N a k o N a
kono	q o n o
koropuku	k o r o p u k u
koropupu	k o r o p u p u
koru	k o r u
ku	k u
kōhure	k o u r e
kōkiritanga	k  i r i t a Ng~ a
kōkōwai	k  o w a i
kōnui	k o n u i
kōtahi	k o t a h i
maamaa	m a m a
mahimahi	m a i m a h i
mahingia	m a i N i
maihea	m a i h e a
manaia	m a n a i a
manomanotia	m i a s a s a l a p t i a
marathon	r a th~ u n
mariko	m a r i k o
matapakia	m a t a p a k i a
matapakihia	m a t a p a k i h i a
mataurangamaori	m a t a u r a N a m a o r i
maumaharatanga	m a u m a h a r a t a n g a
miere	m i e r e
mitia	g i v a
mohe	o h e
mokowhiti	m o k o wh~ E i t i
märama	m a g r a m a
māhana	m a a n a
ngangahu	N a N a u
ngangare	N a N a r e
ngangau	N a N a u
ngaringari	N a r i N a r i
ngeetehi	g e e t e h i
ngote	N o t e
ngoto	N o t o
ngāhau	N a h a u
ngō	N o
noo	n o
oha	h e
paiheneti	p a i h e n e t i
paina	p a i n a
pakitau	p a k i t 3
pakoko	p a k o k o
papaka	p a p a k a
papaku	p a p a k u
papatau	p a p a t a u
parakatihi	p a r a k a t i 7 i
pehia	p e h i a
pekepeke	p e k e p e k e
penihana	p e d i* 7 a n a
piana	p y a n a
pine	p i n e
pokapu	p o k a p u
pokepoke	p o k e p o k e
poroa	p o r o a
porohe	p o r o h e
porotaka	p o r o t a k a
pukohu	p u k o h u
pukuhohe	p u k u h o h e
pumanawa	p u m a n a w a
punanga	p u n a Ng~ a
pungapunga	p u a p u N a
pura	p i r a
purenga	p u r e n g a
purotu	p u r o t u
purutia	p u r u t i a
pütea	p 3 t e a
pāka	p a k a
pātahi	p a t a h i
pērātia	l u a N r a t i a
pīataata	p i a t a t a
pōraruraru	p o r a r u r a r u
pūmahara	p u m a h a r a
rangapū	r a N a p u
raumata	r a u m a t a
raurau	r a u r a u
raurēkau	r a u r a N l 3 m
rautō	r a u a
reia	r e i a
rengarenga	r a t i r e n g a
rongona	r o N o n a
rore	r o r e
rīpeka	r o e k a
rōpere	r o p e r e
taera	t a e r a
tahanga	t a h a Ng~ a
tahere	t a h e r e
tahuti	t a h u t i
taitai	t a i t a i
taituarā	t a i t u a r
takakau	t a k a k a u
takatakahi	t a k a t a k a h i
takupu	t a k u p u
taotu	t a o t u
tapiritia	t a p i r i t i a
tapā	t a p
tarewa	t a r e w a
taumanu	t a u m a n u
taumarumaru	t a u m a r u m a r u
tauraro	t a u r a r o
tautitotito	t a u t i t o t i t o
tauwhitiwhitinga	t a w wh~ E i t i wh~ E i t i Ng~ a
tewhatewha	t e w a t e w a
tiimata	t i i m a t a
tiko	t i k o
toheroa	t o h e r o a
topa	t o p a
tukupara	n a p a r a
tumeke	t u m e k e
tupuranga	t u p u r a Ng~ a
tāpiripiri	m a p i r i p i r i
tētē	t a N t a N
tūhonoa	t u h o n o a
tūtei	t u t e i
tūtuki	t u n k i
tūturutanga	t u t t a Ng~ a
ukauka	t u k a u k a
waahana	w a a h a n a
waerehe	w a e r a e
waihonga	w a i h o n g a
wairākau	w a i r a k a u
wanawana	w a n a w a n a
wawatatia	w a w a t a t i a
we	w i
weroa	w e r o a
wetereo	w e t e r a o
whaihanga	wh~ E a i h a Ng~ a
whaiāipo	wh~ E a i a i p o l a
whakahautia	wh~ E k a h a u t i a
whakahere	wh~ E k a h e r e
whakahiki	wh~ E k a i k i
whakairinga	wh~ E k a i r i Ng~ a
whakamaoritanga	wh~ E k a m a o r i t a Ng~ a
whakamauru	wh~ E k a m a u r u
whakamātūtū	wh~ E k a m a t u t u
whakamōmona	wh~ E k a m o m o n a
whakapakaritia	wh~ E k a p a k a r i t i a
whakapoke	wh~ E k a p o k e
whakapumau	wh~ E k a p u m a u
whakapāha	wh~ E k a p a a
whakapūmautanga	wh~ E k a p u m a u t a Ng~ a
whakarerekēngia	wh~ E k a r e r e k a N N i
whakarākai	wh~ E k a r a k a i
whakatapu	wh~ E k a t a p u
whakatapua	wh~ E k a t a p u a
whakatenetene	wh~ E k a t e n e t e n e
whakatepe	wh~ E k a t e p e
whakaterea	wh~ E k a t e r e a
whakatewhatewha	wh~ E k a t e w a t e w a
whakatūpatotanga	wh~ E k a t u p a t o t a Ng~ a
whakatūranga	wh~ E k a t u r a Ng~ a
whakawaia	wh~ E k a w a i a
whakawehenga	wh~ E k a w e h e n g a
whakawhāitihia	wh~ E k a w h a i t i h i a
whakawākia	wh~ E k a w a k i a
whakawāngia	wh~ E k a a  N i
whanautanga	wh~ E a n a u t a Ng~ a
wharepukapuka	wh~ E a r e p u k a p u k a
whika	wh~ E i k a
wiriwiri	w i r i w i r i
wākena	w a k e n a
wānangatia	w nj~ 3 a N a t i a
Ānō	n o
āhuarangi	a w a r a N i
ākene	a k e n e
āmati	a m a t i
āraitia	a r a i t i a
īmera	i *
Ōhinemutu	h i n e m u t u
