le	l e
de	d e
e	e
un	u n
del	d e l
in	i n
es	m 3 s
que	k E
Le	e
su	s u
a	a
pro	p r o
per	p e r
esseva	e s e v a
al	a l
ha	s i
con	k o n
se	s e
como	k o m o
plus	p l u s
non	n o n
o	o
In	n
ille	i l l e
iste	i s t e
pote	p o t e
altere	a l t e r e
illo	i l l o
esser	e s e r
Ille	l
era	e r a
isotopo	i s o t o p o
Illo	l o
annos	a n n o s
habeva	h a b e v a
Un	n
prime	p l i m e
ma	m a
inter	i n t e r
lo	l o
grande	g r a nd~ e
lor	l o r
super	s u p e r
duo	d u o
qui	k i
il	i l
Iste	s t e
Su	u
multe	l t e
lingua	l i n g u a
on	o n
durante	d u r a n t e
parte	p e r t e
tote	t o t e
multo	l t o
son	s o n
illos	i l l o s
anque	a* k E
essite	e s  t e
nove	n o v e
quando	k a n d o
mesme	m e s m e
nomine	n o m i n e
etiam	e t i a m
qual	k a l
usque	u s kw~ i
forma	f o r m a
citate	T i t a t e
post	p o s
solmente	s o l m e n t e
tempore	t e m p o r e
isto	i s t o
mundo	m u n d o
usate	u s a t e
vita	v i t a
sur	s u r
ab	a b "
linguas	l i n g u a s
circa	k L E w E L E
deveniva	d e b e n i v a
illes	i l l e
population	p o p u l a t i o n 3
si	s i
sin	s i n
alcun	a l k u n
et	e t
parolas	p e r o l a
anno	a n
ubi	u b i
debe	d e b e
importante	i m p o r t a n t e
tres	w a m i
causa	k a u s a
omne	o m i
esse	e s s e
seculo	s e kw~ l o
cata	k a th~ a p 3
plure	p l u r e
personas	p e r s o n a s
pais	p a i s
cognoscite	k o g i E 5 o S e t e
anglese	a N l e s e
ante	a n t e
exemplo	" 3 mp~ l o
stato	s t a t o
appellate	a p p e y a t e
ben	b e n
Post	o s
alicun	a l i k u n
contra	r o n t r a
illa	i l l a
numero	n u m e r o
parola	p e r o l a
ex	Z i 7
differente	d i f f e r e n t e
systema	s i m s t e m a
Pro	r o
rege	r e
persona	p e r s o n a
morte	m o r t e
fin	f i n
assi	n i i
gruppo	g a m p o
nos	n o s
historia	h i s t o r i a
vices	v i k m 3 s
Isto	s t o
la	l a
minus	m i n u s
major	C u k u
principal	p r i n k i p a l
sub	s u b
parve	p i v e
sed	s 3 d
commun	k o m u n
proque	p r o k E
haber	h a b e r
paises	p a i e
secunde	s e k u nd~ e
Durante	u r a n t e
considerate	k o s i d e r a t e
On	n
obras	o b a s
sovente	s o p e n t e
obra	o b r a
human	h u m a n
habitantes	h a b i t a n t e
politic	p o l i t i 7
sol	s o l
alte	a l t e
loco	l o k o
secundo	s e k u n d o
facer	f a C e r i t
proprie	p a z r i e
majoritate	C u k u i t a t e
Illa	L a
international	i n t E r n a t i o n a l
termino	t E r m i n o
Deo	e o
tal	t a l
uso	u s o
moderne	m o d E a n 3
membros	m e mb~ r o s
longe	l o N g e
ultime	u l t i m e
include	m a k i d 3 7
faceva	f a C e r i v a
familia	f a m i l i a
libro	b r o
nominate	n o m i n a t e
Francia	r a n C i w a
The	e
existe	" i s t e
guerra	g e r a
hodie	h o d e s i e
face	f a k e
alteres	a l t e r e
comenciava	k o p i n C i w a v a
musica	s i k a
periodo	p e r i o t o
tamben	t a m b e n
usa	u s a
significa	s i g  k a
maniera	n i e r a
popular	p o p u l a r
general	g e n e r a l
varie	v a r i e
vice	v i k e
etate	e t a t e
typo	t 3 p o
interlingua	t u r xy~ E kw~ a w i n d i
poteva	p o t e v a
publicate	p u b l i k a t e
los	l o s
quasi	k a s i
De	e
Illos	l l o s
facite	f a C y t
patre	p a t r e
quatro	k a t r o
movimento	m o v i m e n t o
Per	e r
francese	f r a n C E s E
Quando	u a n d o
ancora	5 u k a o r a
re	r e
capital	k a p i t a l
Unite	n E i 7
desde	d e s d e
governamento	g o b e r n a m e n t o
centro	C E n t r o
formas	f o r m a s
social	s o k i a l
Como	o m o
facto	f a k t o
area	a r e a
poter	p o t e r i s
serie	s e r i e
Europa	u r o p a
mesmo	m e s m o
puncto	p u n C i t o
gruppos	g a m p o s
certe	C E r t e
generalmente	g e n e r a l m e n t e
region	r e g i o n
grec	g r e k
libros	b r o s
solo	s o l o
studio	s t u d i o
filio	b i l i o
quales	k a l e
Si	i
roman	r o m a n
Union	n i o n
pauc	p a u t
scribeva	s k r i b e v a
corpore	k o r p o r e
famose	f a m o s e
homines	h o m i n i
tanto	t a n t o
moriva	m o r e
aqua	a q u a
infantes	i n f a nt~ m 3 s
trova	t r o v a
original	u r i g i n a l
tarde	t a r d e
diverse	d i e r s e
milliones	m i l l i o n i
possibile	p o s s i b i l e
terra	t e r a
Ecclesia	kh~  l e s i a
toto	t o t o
base	b a s e
europee	u o p e r u
medio	m e d i o
animales	a n i m a l e
verso	e r s o
antique	a n t i k E
insula	s u l a
religiose	r e l i g i o s e
scientific	S e e n t i f i k
sexual	s e S u a l
Jesus	e s u s
basate	b a s a t e
Secundo	e kw~ n d o
bon	b o n
caso	k a s o
nord	n o r d
partes	p e r t e
statos	s t a t o s
Ben	e n
Europee	u r o p e r u
frequentemente	f a k e n t E m E n t e
natural	n a t u r a l
sequente	s e k e n t e
create	k r e a t e
espaniol	e s p a n i o l
Christo	h r i s t o
official	o f w C i w r a l
Statos	m a t o s
autor	a u t o r
aEC	a
dice	d i k e
ecclesia	e T k l e s i a
origine	u r i g i n e
banda	b a n d a
contine	r o n t i n e
cuje	k u j e
habe	h a b e
Nonobstante	n o b s t a n t e
postea	p o s t e a
version	e r S i o n
economic	e k o n o m i
public	p u b l i k
sud	s u d
Illes	L m 3 s
cultura	k u l t u r a
die	d i e
por	p o r
Ma	a
cinque	c i n i kw~ i
elementos	l E l E m E n t o s
disveloppamento	d i s v e l o v e l o p p a m e n t o
film	b i l m
situate	s i t u a t e
classic	k l a s s i k
objecto	o by~ E C t o
scribite	s k b i t e
sia	s i a
basse	b a s s e
forte	f o r t e
homine	h o m i n e
national	n a t i o n a l
simple	s i m p l e
specialmente	s p e k i a l m e n t e
alora	a l o r a
joco	h o k o
position	p o s i t i o n 3
dies	d i e
relationes	r e l a t i o n 3 m 3 s
les	l e
Con	o n
io	i o
juvene	x u f e n e
genere	g e n e r e
ancian	5 u k a i a n
tertie	t E r t i e
theoria	th~ 3 o r i a
Interlingua	t u r xy~ E kw~ a w i n d i
nulle	n u l
texto	t e S o
Assi	s s i
Nove	o v e
depost	d e p o s
ni	n i
rolo	r o l o
usar	u s a r
natura	n a t u r a
permitte	p e r m i t t e
german	g e r m a n
mais	m a i s
typos	t 3 p o s
actual	a k t u a l
considera	k o s i d e r a
casos	k a s o s 3
jam	y a m
nigre	n i g r e
publicava	p u b l i k a v a
historic	h i s t o r i k
latin	l a t i n
titulo	t i t u l o
campo	k a m p o
codice	k o d i k e
etc	e t
membro	m e mb~ r o
nostre	n o s t r e
urbe	u r b e
Altere	l t e r e
christian	C r i s t i a n
linguage	l i n g u a j
organisation	u r g a n i s a t i o n 3
regno	r e g n o
systemas	s i m s t e m a s
unic	u n i k
esserea	e s s u r a
final	f i n a l
gente	g e n t e
processo	p r o k e s
derecto	d e r a T t o
initio	i n i t i o
labor	l a b e r
personal	p e r s o n a l
relation	r e l a t i o n 3
sempre	s e m p r e
ambe	a m b e
cultural	k u l t u r a l
datos	d a t o s
da	d a
intra	i n t r a
politica	p o l i t i k a
presente	p r e s e n t e
successo	s u k s e s
usualmente	u s u a l m e n t e
occidental	T i d e n t a l
parla	p a l a
proxime	p r o x i m e
traditional	tr~ a d i t i o n a l
alsi	a l s i
derectos	d e r a T t o s
programma	p r o g r a m a
religion	r e l i g i o n
Multe	u l t e
refere	r e f e r e
senso	s e s o
influentia	i n f l u e n t i a
ipse	i p s e
modo	m o t o
species	s p e i m 3 s
Imperio	p e r i o
album	a l b u m
practica	p r a k t i k a
tosto	t o s t o
consiste	k o ns~ i s t e
fundate	f u nd~ a t e
structura	s t r u k t u r a
vive	v i v E
Roma	o m a
education	e d u k a t i o n 3
ganiava	g a n i a v a
ideas	d e 3 s
matre	m a t r e
musical	s i k a l
schola	S o l a
radio	r a d i o
Sancte	5 u k a t e
curte	k u r t e
nivello	n i v e l o
Espania	s p a n i a
Germania	e r m a n i a
litteratura	t t E r a t u r a
medie	m e d i e
problemas	p l o b l 3 m a s
total	t a t a l
central	C E n tr~ a l
latino	l a t i n o
trans	i t r i s
casa	k a s a
fortia	f o r t i a
idea	d e a
linea	l i n e a
linguistic	l i n g i s t
traduction	tr~ a d u k t i o n 3
ver	v e r i
creava	k r e a v a
departimento	d e p i t i m e n t o
mundial	nd~ i a l
uno	u n o
Guerra	u e r a
Svedia	f e d i a
Universitate	n i v e r s i t a t e
cantos	k a n t o s
lege	l e g e
scientia	S e e n t i a
scriber	s k b e r e
Regno	g n o
creation	k r e a t i o n 3
nasceva	n a s u v a
nunc	n u n
nunquam	n u n ky~ a m
recipeva	r E c i p e v a
territorio	t e r i t o r i o
adjuta	a d h u t a
cosas	k o s a s
crear	k r e a r
epocha	a p o C a
nomines	n o m i n i
ordine	u r d i n e
resultato	r e s u l t a t o
Grande	r a nd~ e
Hodie	o d i e
feminas	f a m i n 3 s
scripte	s k r i p t e
similar	s i m i l a r
communitate	k o m u n i t a t e
en	e n
formate	f o r m a t e
insimul	s i m7~ u l
metros	m e t r o s
societate	s o k i e t a t e
via	v i a
articulo	i t i k u l o
includente	i n k l u d e n t e
monstra	m o* t a 5 s t r a
particular	p e r t i k u l a r
presidente	p r e s i d e n t e
Totevia	o t e v i a
and	a n d
objectos	o by~ E C t o s
principalmente	p r i n k i p a l m e n t e
the	th~ e
essera	e s e r a
lista	l i s t a
melior	m e l i o r
qualcunque	k a l k u n kw~ i
material	m a t e r i a l
arte	i t e
definition	d e f i n i t i o n 3
libere	b e r e
litteras	t  a s
methodo	m e t h o t o
numeros	n u m e r o s
opera	o p e r a
poterea	p o t e r e a
production	p r o C u k t i o n 3
Danmark	a n m a r i t
Plus	l u s
active	a k t i v E
energia	e n e r g i a
est	e s t
local	l o k a l
recerca	r E C E r k a
scopo	s k o p o
seculos	s e kw~ l o s
spatio	s p a t i o
specific	s p e k i f i k
ultra	u l t r a
Inter	t e r
International	t E r n a t i o n a l
appella	a p p m u S
debeva	d e b e v a
electric	e l e k tr~ i k
equalmente	e k i a l m e n t e
femina	f a m i n a
fide	f i d e
latere	l a t e r e
menses	m E n e
phrase	ph~ r a s e
succedite	s u k k  t e
canto	k a nt~ o
continuava	r o n t i n u a v a
fonte	f o n t e
leges	l E g E
physic	ph~ i k
recente	r E C E n t e
stilo	s t i l o
Alcun	l k u n
Departimento	a p i t i m e n t o
militar	m i l i t a r
necessari	d e* k a* b 3 s a a r i
Cata	a t a
associate	n i i a t e
blanc	b l a*
carriera	k a r e r a
existentia	" i s t e n t i a
independente	i n d e p e n d e n t e
principio	p r i n k i p i o i
valor	v a l o r
Biblia	i b l i a
Lor	o r
Non	o n
Wikipedia	i k i p e d i a
characteristicas	C a r a k t E r i s t i k a s
diceva	d i k e v a
fluvio	f b i o
mal	m a l
numerose	n u m e r o s e
occurre	T k u r
totevia	t o t e v i a
vide	v i d e
vista	v i s t a
Tote	o t e
action	a k t i o n 3
armea	a r m i a
color	k o l o r
concepto	r o n C i e p t o
km	k m
statounitese	s t a t a u n i t e s
tradition	tr~ a d i t i o n 3
trovate	t r o w a t e
dava	d a v a
difficile	d i f a i l e
svedese	s b e d e s e
Esperanto	s p e r a nt~ o
Terra	e r a
commercial	k o m * r i a l
complete	k o m p l e t e
crede	k r e d e
maladia	m a l a d i a
regiones	r e g i o n i
semper	s e m p e r
textos	t e S o s
Postea	o s t e a
Republica	e p u b l i k a
ad	a d
articulos	i t i k u l o s
character	C a r a k t e r
citates	T i t a t e
comencia	k o p i n C i w a
dividite	d i v i d i t e
libertate	b e r t a t e
philosophia	ph~ i l o s o ph~ i a
simplemente	s i m p l E m E n t e
special	s p e k i a l
studios	s t u d i o s
terminos	t E r m i n o s
capacitate	k a p a k i t a t e
construite	k o s t r u i t e
definite	d e f i n i t e
ergo	e r g o
filia	b i l i a
no	n o
sono	s o n o
specie	s p e k i e
America	m e r i k a
britannic	b r i t a n n i k
deveni	d e b e n i
filios	b i l i o s
programmas	p r o g r a m m a s
representa	r e p r e s e nt~ a
controlo	r o n t r o l o
distincte	d i s t i n k t e
disveloppate	d i s v e l o v e l o p p a t e
interesse	i n t e r e s s e
mar	m a r
ration	r a t i o n 3
tracta	tr~ a k t a
tunc	t u n
John	o h E 5
ambiente	a m b i e n t e
capite	k a p i t e
devenite	i s u s k n E i 7
lineas	l i n e 3 s
litterari	t t E r a r o
viage	v i a g e
amor	a m o r
appare	a p p a r e
autores	a u t o r e
defensa	d e f e s a
includeva	m a k i d 3 7 v a
information	i n f o r m a t i o n 3
jocator	h o k a t o r
julio	x u l i o
partir	p e r t i r
projecto	p t o n o x e k t o
rete	r e t e
ser	s e r
sito	s i t o
va	v a
animal	a n i m a l
contos	r o n t o s
date	d a t e
differentia	d i f f e r e n t i a
fontes	f o n t e
ibi	i b i
importantia	i m p o r t a n t i a
momento	m o p i N t o
probabilemente	p l o b a b i l E m E n t e
problema	p l o b l 3 m a
punctos	p u n C i t o s
rock	r o k
usava	u s a v a
cavallo	k a v a l o
classe	k l a s s e
data	d a t a
devenir	d e b e n i r
function	f u n C i t i o n 3
indica	i n d i k a
insulas	s u l a
lumine	l u m i n e
populo	p o p u l o
superior	s u p e r i o r
trovar	t r o w a r
conditiones	r o n d i t i o n 3 m 3 s
deos	d e o s
essente	e s e n t e
haberea	h a b e r e a
normalmente	n o r m a l m e n t e
singule	s i  l e
verbos	e r b o s
Italia	t a l i a
accordo	a k k o r d o
activitate	a k t i b i t a t e
battalia	b a t t a l i a
casas	k a s a s
interne	i n t E r n
mesura	m e s u r a
rapidemente	r a  d E m E n t e
regulas	r e g u l a
unitate	u n i t a t e
urban	u r b a n
vider	v i d e r
vole	v o l e
Alicun	l i k u n
Anglaterra	N l a t e r a
Desde	e s d e
Se	e
american	a m e r i k a n
catholic	k a t o l i k
cognoscentia	k o g i E 5 o s k e n t i a
construction	k o s t r u k t i o n 3
originalmente	u r i g i n a l m e n t e
provincia	p r o v i n C i w a
retornava	r e t o r n a v a
veni	f e n i
La	a
arrivava	m a n i v a v a
basso	b a s
collection	k o l l e k t i o n 3
cosa	k o s a
elemento	l E l E m E n t o
finalmente	f i n a l m e n t e
recognoscite	r E c o g i E 5 o S e t e
voleva	v o l e v a
west	w e s
appareva	a p p a r e v a
areas	a r e a s
clar	k l a r
dece	d e k e
foras	h a s
proprietates	p a z r i e t a t e
resto	r e s t o
septe	s e p t e
situation	s i t u a t i o n 3
subsequente	s u b s k e n t e
television	t e l e i s i o n
themas	th~ e m 3 3 s
Mundial	u n d i a l
Paris	a r i s
currente	k u r  t e
dunque	d u n kw~ i
fortias	f o r t i 3 s
grado	g r a d o
universal	u n i v e r s a l
utilisate	u t i l i s a t e
albumes	a l 8 i m 3 s
april	a p r i l
association	n i i a t i o n 3
autoritate	a u t o r i t a t e
civil	i v i l
doctrina	d o k t r i n a
ecclesias	e T k l e s i a s
economia	e k o n o m i a
gratias	g r a t i 3 s
limitate	l i m i t a t e
operation	o p e r a t i o n 3
pagina	p a x i n a
separate	s e p a r a t e
sex	s e 7
supra	s u p r a
symbolo	s i m mb~ o l o
tu	t u
veniva	f e n i v a
Anque	n kw~ i
Consilio	o s i l i o
National	a t i o n a l
Nord	u r d
cerca	C E r k a
designate	d e s i g n a t e
disco	d i s k o
effecto	e f e k t o
medios	m e d i o s
modello	m o d e l o
remane	r E m a n e
scholas	S o l a
simile	s i m i l e
sposa	s p o s a
travalio	t r a v a l i o
viveva	v i v e v a
New	e w a
Spirito	p i r i t o
anterior	a n t E r i o r
basic	b a s i k
castello	k a s t e l o
chimic	C i m i
existente	" i s t e n t e
januario	h a n u a r i o
large	l a r g e
minor	m i n o r
novembre	n o p e m u mb~ r e
pedophilia	p E d o ph~ i l i a
presso	p r e s
producite	p r o C u C y t
vidite	v i d i t e
Ante	nt~ e
Basse	n i e
Sud	u d
York	u r
direction	d i r E C t i o n 3
equipa	e k i p a
institutiones	s t i t u t i o n 3 m 3 s
romance	r o m a n C i e
vos	v o s
aperte	a p e r t e
bandas	b a n
chef	C e f
cognite	k o g n E i 7
decembre	d e u mb~ r e
edition	e d i t i o n 3
expression	" p r e s s i o n
formation	f o r m a t i o n 3
fundamental	f u nd~ a m e n t a l
rubie	r u b i e
significato	s i g  k a t o
versiones	e r S i o n i
vocabulario	v o k a b u l a r i o
Io	o
Senior	e n i o r
Stato	t a t o
campos	k a m p o s
continua	r o n t i n u a
continue	r o n t i n u e
danese	d a n e s e
dar	d a r
dicer	d i C E r
extension	e S s i o n
memoria	m e m o r i a
mense	m e s e
methodos	m e t h o d o s
paginas	p a x i n 3 s
parlate	p a l a t e
plantas	p l a y i t o s
possede	p o s e d e
posterior	p o s t E r i o r
private	p r i v a t e
question	k e s t i o n 3
sape	s a p e
servicio	s e r i i o
ulle	u l
varia	v a r i a
Malgrado	a l g r a d o
cellulas	C E L u l a
chinese	C i n e s e
complexe	k o m p l " e
directe	d i r E C t e
distantia	d i s t a n t i a
littera	t t E r a
mano	n o
nascentia	n a s k e n t i a
porta	p o t a
standard	s t a n r d
trovava	t r o w a v a
universo	u n i v e r s o
Africa	f r i k a
can	k a n
continente	r o n t i n e n t e
deberea	d e b e r e a
derivate	d e r i v a t e
dominio	b i n i o
guitarra	g i t a r a
istos	i s t o s
mi	m i
passate	p a s s a t e
referentia	r e f e r e n t i a
undas	u n d 3 s
verbo	e r b o
videva	v i d e v a
augusto	a u g u s t o
causava	k a u s a v a
circum	l r u m
computator	k o m p u t a t o r
describe	d e s k b e
dirigite	d i r i g i t e
independentia	i n d e p e n d e n t i a
km²	k m a
monarchia	m o n a r C i a
moral	m o r a l
movimentos	m o v i m e n t o s
pare	p a r e
representate	r e p r e s e n t a t e
stellas	s t e y a
cambiava	k a m b i a v a
cognosce	k o g i E 5 o s k e
commercio	k o m * i o
communication	k o m u n i k a t i o n 3
completemente	k o m p l e t e m e n t e
differentias	d i f f e r e n t i 3 s
fundava	f u nd~ a v a
interior	i n t E r i o r
lucta	l u k t a
me	m i
million	m i l l i o n
nascite	n a S e t e
nonobstante	n o n o b s t a n t e
petra	p e t r a
pois	pw~ a s
potente	p o t e n t e
qualitate	k a l i t a t e
require	r E k i r
sede	s 3 d e
superficie	s u p e r f i k i e
Maria	a r i a
attinger	a t t i N e r
feminin	f a m i n i n
greco	g r E C o
instrumento	s t r u m e n t o
martio	m a* r t u o e
materia	m a t e r i a
nation	n a t i o n 3
normal	n o r m a l
oriental	u r i n t a l
particularmente	p e r t i k u l a s a y m 3 n t e
quantitate	k a n t i t a t e
Depost	a p o s
Tractato	r a k t a t o
contento	r o n t e n t o
evolution	e v o l u t i o n 3
formava	f o r m a v a
fratre	f r a t r e
functiones	f u n C i t i o n 3 m 3 s
grecos	g r e k o s
imperio	i m p e r i o
junio	C i x u n i o
massa	s a
mental	m e n t a l
octobre	o k t o o*
parlar	p a l a r
passava	p a s s a v a
popularitate	p o p u l a r i t a t e
projectos	p t o n o x e k t o s
servicios	s e r i i o s
sole	s o l e
stella	s t e l a
subjecto	s u by~ E C t o
utilisa	u t i l i s a
vetule	f e t u l e
actiones	a k t i o n 3 m 3 s
activitates	a k t i b i t a t e
addition	a d i t i o n 3
comportamento	k o m p o r t a m e n t o
disponibile	d i s p q l  l
facile	f a c i l e
imperator	i m p e r a t o r
includite	i n k l u d i t e
jocos	h o k o s
legal	l e 7 a l
notabile	n o t t a b i l e
potentia	p o t e n t i a
proprietate	p a z r i e t a t e
publication	p u b l i k a t i o n 3
qualque	k a l kw~ i
real	r e a l
structuras	s t r u k t u r a s
victoria	v i k t o r i a
Asia	s i a
Mar	a r
Russia	u s s i a
actualmente	a k t u a l m e n t e
adultos	a d u l t o s
attacco	a t t a kh~  o
causate	k a u s a t e
costa	k o s t a
eventos	e b e n t o s
instrumentos	s t r u m e n t o s
italian	i t a l i a n
professional	p r o f e s s i o n a l
station	s t a t i o n 3
union	u n i o n
Academia	k a d e m i a
Brasil	r a s i l
Grecia	r E c i a
cambio	k a m b i o
climate	k l i m a t e
compania	k o mp~ a n i a
composite	k o m p o s i t e
dur	d u r
figura	f i g u r a
formar	f o r m a r
infante	i n f a nt~ e
ja	y a
longitude	l o N i t u d e
maio	m a i o
nederlandese	n e d i n l a n d e s e
octo	o k t o
produce	p r o C u k e
scriptor	s k r i p t o r
tempores	t e m p o r e
varietate	v a r i e t a t e
web	w e
Duo	u o
Henrico	e n i cy~ o
Nos	o s
Solmente	o l m e n t e
Tamen	a m e n
cambios	k a m b i o s
cm	k m
consilio	k o s i l i o
debite	d e b i t e
deriva	d e r e
election	e l e k t i o n 3
establiva	e s t a b l i v a
evitar	p i r i t a r
imagine	i m a g i n e
organisationes	u r g a n i s a t i o n 3 m 3 s
passato	p a s s a t o
pecia	p e k i a
perdeva	p e r b v a
plural	p l u r a l
sanitate	s a n i t a t e
velocitate	v e l o v e l o k i t a t e
village	v i l l a g e
zona	z o n a
Parlamento	a r l a m e n t o
alto	a l t o
artistas	i t i s t a s
chassa	C a s a
denominate	d e n o m i n a t e
eligite	e l i g i t e
grandor	g r a d o r
hic	h i k
obscur	o b s k u r
opposition	o p p o s i t i o n 3
pecias	p e k a s
perdite	p e o n  e
populos	p o p u l o s
presentia	p r e s e n t i a
principios	p r i n k i p i o s
quotidian	k a  dy~ a n
vivente	v i v e n t e
Catholic	a th~ o l i k
Partito	i t i t o
adversario	a d e r s a r i o
applicationes	a p p l i k a t i o n 3 m 3 s
colores	k o l o r e
combatto	k o mb~ a t t o
consequentia	r o n s k e n t i a
contrario	r o n t r a r i o
credentia	k r e d e n t i a
edificio	  i o
electronic	e l e k t r o n i k
filmes	b i l 8 i m 3 s
grammatica	g r a m m a t i k a
integre	i n t e g r e
locos	l o k o s
maestro	m a a* 7
magnetic	m a j
medietate	m e d i e t a t e
objectivo	o by~ E C t i b o
plen	p l e n
presenta	p r e s e nt~ a
primari	p l i m a r i
respecto	r e s p E kh~ a m e* t o
romanos	r o m a n o s
securitate	s e k u r i t a t e
signos	s i g n o s
software	 tw~ a r e
thema	th~ e m 3 a
usator	u s a t o r
Charles	h a l e
David	a b i d
Internet	t E r n
Odysseo	o s s a i o
Omne	m n e
absolute	a b " s o l u t e
arabe	a r a b e
attention	a t t e n t i o n 3
attingeva	a t t i N e v a
condition	r o n d i t i o n 3
conto	r o n t o
decideva	d e 7 i d e v a
domestic	b e s t
domo	bw~ e
equal	e k i a l
exacte	" a k t e
experientia	" p e r i n t i a
inclusive	i n k l u s i v E
individual	i n d i v i d u a l
istes	i s t i
m	m
moneta	m o n e t a
pedon	p E d o n
practic	p r a k 7 o t i k
previe	p b e b i e
programmation	p r o g r a m m a t i o n 3
questiones	k e s t i o n 3 m 3 s
relativemente	r e l a t Ng~ e r e p i N t e
remaneva	r E m a n e v a
seque	s e kw~ i
totalmente	t a t a l m e n t e
China	h i n a
Etiam	t i a m
Pais	i s
adjectivos	a g o j t i v o s
classification	k l a s s i f i k a t i o n 3
depende	d e p e n d e
discos	d i s k o s
extende	e S e
externe	" t E r n
generes	g e n e r e
guerras	g e r a s
habite	h a b i t e
kilometros	k i l 3 e t r o s
machina	m a C i n a
mercato	m e r k a t o
mover	m o v e r i
pertine	p e r t i n e
poco	p o k o
recipe	r E c i p e
section	s e k t i o n 3
traductiones	tr~ a d u k t i o n 3 m 3 s
troppo	t r o p p o
unda	u n d a
usatores	u s a t o r e
Britannia	r i t a n n i a
Newton	e w t o n
additional	a d i t i o n a l
aspectos	a 8 p e n e k t o s
calendario	k a l e n d a r a o
carga	k a r g a
cartas	k i t o s
christianismo	C r i s t i a n i S m o
contexto	r o n t " t o
corte	k o r t e
critica	k r i t i k a
cum	k u m
dicite	d i C y t
esperanto	e s p e r a nt~ o
existeva	" i s t e v a
februario	f e b r u a r i o
finiva	f i n i v a
forsan	f o r s a n
geographic	g e o b o ch~ ph~ i k
initial	i n i t i a l
judee	x u d E r e
justitia	x u s t i t i a
organisate	u r g a n i s a t e
pace	p a k e
partito	p e r t i t o
phase	ph~ a s e
portugese	p o r t u g 3 s e
publico	p u b l i k o
radioamatori	r a d i o a m a t o r i
realitate	r e a l i t a t e
revista	r E i s t a
septembre	s e p t e mb~ r e
symbolos	s i m mb~ o l o s
temperatura	t e N p e r a t u r a
Finalmente	i n a l m e n t e
Sol	o l
Testamento	e s t a m e n t o
University	n i v e r s i t
artista	i t i s t a
combination	k o mb~ i n a t i o n 3
correcte	k o r e k t e
curso	k u r s o
dedicate	d e d i k a t e
deo	d e o
describite	d e s k b i t e
formal	f o r m a l
habitation	h a b i t a t i o n 3
imagines	i m a g i n i
naturalmente	n a t u r a l m e n t e
peso	m i o
premio	p r e m i o
primo	p l i m o
racia	r a c i a
rapide	r a  d e
resulta	r e s u l t a
resultatos	r e s u l t a t o s
signo	s i g n o
usage	u s a g e
voce	v o k e
Carolo	a r o l o
Duvert	u w e r
acceptate	a k u p t a t e
administrative	a d m i n i s t r a t i v E
blanco	b l a*  o
communmente	k o m u n m e n t e
considerava	k o s i d e r a v a
correspondente	k o r e s p o n d e n t e
designo	d e s i g n o
directemente	d i r E C t E m E n t e
discoperite	d i s k o p e r i t e
excepte	" u p t e
facilemente	f a c i l E m E n t e
futuro	f u t u r o
germano	g e r
historias	h i s t o r i a s
immediatemente	i m  a t E m E n t e
infantil	i n f a nt~ i l
linguages	l i n g u a j
maritava	m a r i t a v a
necessitate	d e* k a* b e s s i t a t e
nocte	n o k s e
nomina	n o m i n a
notation	n o t t a t i o n 3
ora	o r a
passa	p a s a
postal	p o s t a l
pression	p r e s s i o n
professor	p r o f e s  r
protection	p r o t e k t i o n 3
regula	r e g u l a
russe	r u s s e
scriptores	s k r i p t o r e
studiava	s t u dy~ a v a
substantivo	s u b s t a n t i b o
telephonic	t e l e f o n i k
universitate	u n i v e r s i t a t e
usante	u s a n t e
American	m e r i k a n
Dunque	u n kw~ i
amicos	a m i k o s
appoio	a p pw~ a o
apprender	a p p r e n d e r
categoria	k a t e g o r i a
characterisate	C a r a k t E r i s a t e
conflicto	r o n f l i k t o
conta	r o n t a
contato	r o n t a t o
critic	k r i t i 7
declarava	d e k l a r a v a
describer	d e s k b e r e
director	d i r E C t o r
distante	d i s t a n t e
divide	d i v i d e
dum	d u m
industrial	u z i a l
masculin	s k u l i n
municipalitates	m u n i C i p a l i t a t e
nave	n a b e
nucleo	n u k l e o
omnes	o m i m 3 s
parlatores	p a l a t o r e
planeta	p l a y i n e t a
prende	p r e n d e
radices	r a d i k m 3 s
responsa	r e s p o s a
scientistas	S e e n t i s t a s
scopos	s k o p o s
soldatos	s o l d a t o s
traducite	tr~ a d u C y t
typicamente	t 3 p i k a m e n t e
vadeva	v a d e v a
veritate	e r i t a t e
Roman	t a x
Troia	r o i a
actor	a k t o r
breve	b b e b e
categorias	k a t e g o r i a s
celo	C E l o
colpo	k o l p o
contemporanee	r o n t e m p o r a n i
discurso	d i s k u r s o
divin	d i v i n
favor	f a v o r
foco	f o k o
fundator	f u nd~ a t o r
habente	h a b e n t e
humanitate	h u m a n i t a t e
includer	i n k l u d e r
inferior	i n f e r i o r
malgrado	m a l g r a d o
organismos	u r g a n i S m o s
parentes	p a r e n t e
prendite	p r e n d i t e
quarte	k i t e
rationes	r a t i o n 3 m 3 s
regnos	r e g n o s
vendite	f e n d i t e
viver	v i v e r i
Dublin	u b l i n
Irlanda	r l a n d a
Johannes	o h a n i
London	d o n
Occidental	kh~  i d e n t a l
Rege	E k E
Robert	o b e r
adjectivo	a g o j t i b o
adoptate	a d o p t a t e
antea	a n t e a
arriva	m a n i v a
cambiar	k a m b i a r
characteristic	C a r a k t E r i s t
classes	k l a s e
compone	k o m p o n e
corresponde	k o r e s p o nd~ e
dialectos	d i a l e k t o s
electiones	e l e k t i o n 3 m 3 s
films	b i l m
fratres	f r a t r e
habita	h a b i t a
horas	h o r a s
humanos	h u m a n o s
individuos	i n d i v i d u o s
jornal	c u k u n a l
oculos	o k u l o s
offere	o f e r e
physica	ph~ i k a
poteres	p o t e r e
prendeva	p r e n d e v a
profunde	p r o f u nd~ e
referer	r e f e r a r
salvage	s a l v a g e
secur	s e kw~ r
stricte	s t r i C t e
theorias	th~ 3 o r i a s
vocales	v o k a l e
Gustav	u s t a
Plure	l u r e
Raphael	a p t a e l
Sed	3 d
Societate	T i e t a t e
accesso	a k s e s
amico	a m i  o
analyse	a n a ly~ s e
aspecto	a 8 p e n e k t o
assatis	n i a t i s
benque	b e n kw~ i
colonia	k o l o n i y a
constitue	k o s t i t u 7 e
crea	k r e a
cresce	k r e s k e
dea	d e a
elevate	e l e b E t e
inseniamento	s a m e n t o
interpretation	i n t E r p r e t a t i o n 3
japonese	y a p o n e s e
juvenes	x u b e n i
maxime	m a x i m e
operas	o p e r a s
orthographia	u r t o b o ch~ t a b a
personage	p e r s o n a g e
poema	p o e m a
prender	p r e n d e r
recipite	r E c i p i t e
regional	r e g i o n a l
regular	r e g u l a r
sanguine	s a N g w i n e
scriptura	s k r i p t u r a
secundari	s e k u n d a r i
spirito	s p i r i t o
succedeva	s u k u b v a
territorios	t e r i t o r i o s
to	t o
tractamento	tr~ a k t a m e n t o
voluntate	v o l u n t a t e
Cook	o k
Dr	r
James	a m e
Prime	l i m e
Usque	s kw~ i
altitude	a l t i t u d e
artistic	i t i s t
belle	b e l
calide	k a l i d e
cambia	k a m b i a
camera	k a m E r a
cento	C E n t o
comprender	k o m p r e n d e r
concernente	r o n C E r n e n t e
decennio	d e 7 3 n o
defini	d e f i n i
dialecto	d i a l e k t o
disveloppava	d i s v e l o v e l o p p a v a
episcopo	a p i s k o p o
essential	e s e n t i a l
experimentos	" p e r i m e n t o s
fini	f i n i
functiona	f u n C i t i o n a
identic	d e n t i k
illac	i l l a
kg	k
ligate	l i g a t e
location	l o k a t i o n 3
materiales	m a t e r i a l e
novas	n o w a s
par	p a r
permittite	p e r m i t t i t e
petras	p e a s
poemas	p o e m a s
policia	p o l i i a
politicas	p o l i t i k a s
ponte	p o n t e
praseodymium	p r a s u o t i m i u m
prision	p r i s i o n
proveni	p r o p e n i
regal	r e g a l
regina	r e g i n a
saper	s a p e r
spiritual	s p i r i t u s a l
tellurium	t e l a u r i u m
terras	t e r a s
Fox	u 7
George	e o r g e
India	n t i a
Paulo	a u l o
San	a n
Star	t a r
administration	a d m i n i s t r a t i o n 3
alphabeto	a l p h a b e t o
approximativemente	a p p r o S i m a t Ng~ e r e p i N t e
attinge	a t t i N a
avante	m a v a n t e
basa	b a s a
bastante	b a s t a n t e
contacto	r o n t a  t o
credeva	k r e d e v a
cresceva	k r e s k e v a
crescimento	k r e S e m e n t o
culturas	k u l t u r a s
demanda	d e m a n d a
editiones	e d i t i o n 3 m 3 s
fusion	f u s i o n
futur	f u t u r
ganiar	g a n i a r
honor	h o n o r
hypothese	h 3 p o th~ e s e
infantia	i n f a nt~ i a
laborava	l a b o r a v a
lanthano	l a n y e n o
medieval	m e d i e b E l
nam	n a m
obstante	o b s t a n t e
occurreva	T  b e b a
pedemontese	p E d e m o* t e s
pictura	p i k t u r a
poc	p o 7
populationes	p o p u l a t i o n 3 m 3 s
pronomines	p r o n o m i n i
salvation	s a l v a t i o n 3
scena	s k e n a
servi	s e r w i
substantivos	s u b s t a n t i v o s
technic	t e C n i k
tribos	t r i b o s
unitates	u n i t a t e
verde	e r d e
Erasmo	r a s m o
Kristian	r i s t i a n
Mexico	e n  o
Patre	a t r e
Premio	r E m i o
accepta	a k u p t a
applicate	a p p l i k a t e
application	a p p l i k a t i o n 3
armas	a r m a s
aves	E b e
biblic	b i b l i k
composition	k o m p o s i t i o n 3
copias	k o p i a s
distinction	d i s t i n k t i o n 3
documento	d o k u m e n t o
effectos	e f e k t o s
establite	e s t a b l i t e
frequentia	f a k e n t i a
industria	i d u s t r e
investigation	i n v e s t i g a t i o n 3
jammais	c a m o i s
jocatores	h o k a t o r e
medicina	m e d i k i n a
message	m e s s a g e
ministro	m i n i s t r o
monarcha	m o n a l l a
monstrar	m o* t a 5 s t r a r a
parlantes	p a l a n t e
partita	p e r t i t a
pede	p E d e
positive	p o s i t i v E
realisar	r e a l i s a r
registrate	r e g i s t r a t e
resultava	r e s u l t a v a
romances	r o m a n C i m 3 s
romanic	r o m a n i k
significante	s i g  k a n t e
signification	s i g  k a t i o n 3
singular	s i n g u l a r
tamen	t a m e n
termination	t E r m i n a t i o n 3
Committee	o f a t t i 3 n
Eduardo	d u a r d o
General	e n e r a l
Generalmente	e n e r a l m e n t e
Thomas	h o m a s
alimento	a l i m e n t o
apparatos	a p p a r a t o s
architectura	a r C i t e k t u r a
auxiliar	 i l i a r
capabile	k a p a b i l e
cauda	k a u d a
christianos	C r i s t i a n o s
culto	k u l t o
distingue	d i s t i N g w e
division	d i v i s i o n
eveni	e b e n i
executate	" e kw~ t a t e
exterior	e S e r i o r
familias	f a m i l i a s
incontrava	i n k o n t r a v a
iodo	i o t o
juridic	x u r i d i k
mantener	m a n t 3 n 3 q
modellos	m o d e l l o s
multes	l t e
neodymium	n e o t i m i u m
nihil	n i h i l
obtener	o b t 3 n 3 q
parlamento	p a l a m e n t o
particulas	p e r t i k u l a
plano	p l a y i n o
produceva	p r o t y L u v a
pur	p u r
recognosce	r E c o g i E 5 o s k e
reges	r e
representation	r e p r e s e n t a t i o n 3
revolution	r E f o l u t i o n 3
ric	r i k
septimanas	s e p t i m a n a s
slave	s l a v e
successor	s u k s e s  r
turre	t u r
Documento	o k u m e n t o
Eneas	n e 3 s
Japon	a p o n
Kalmar	a l m a r
William	i ly~ i a m
acto	a k t o
adherentes	a d e r e n t e
anima	a n i m a
appellava	a p p e l l a v a
armate	a r m a t e
cathedral	k a th~ e d r a l
centos	C E n t o s
citatanos	T i t a t a n o s
classificate	k l a s s i f i k a t e
colonias	k o l o n i a s
constante	k o s t a n t e
conversion	r o n e r S i o n
corona	k o r o n a
cupro	k u ph~ r o
dependente	d e p e n d e n t e
determinate	d e t e r m i n a t e
dominante	b i n a n t e
figuras	f i g u r a s
finite	f i n i t e
frequente	f a k e n t e
fundation	f u nd~ a t i o n 3
ganiate	g a n i a t e
generation	g e n e r a t i o n 3
grados	g r a d o s
indium	i n d i u m
lassava	l a s s a v a
ligno	l i g n o
metropolitan	m e t r o p o r i t a n
move	m o v e
passo	p a s
patrono	p a t r o n o
pensa	p e s a
permitteva	p e r m i t t e v a
perque	p e r kw~ i
positiones	p o s i t i o n 3 m 3 s
protestante	p r o t e s t a n t e
provide	p r o v i d e
quadrato	k 7 t a d r a t o
quanto	k a nt~ o
representar	r e p r e s e n t a r
samarium	m a r i u m
scientias	S e e n t i 3 s
scribe	s k b e
sexualitate	s e m a l i t a t e
sinistre	s i n i s t r e
technica	t e C n i k a
tentava	t e n t a v a
travaliava	t r a v a l i a v a
typic	ty~ e b i k
variante	v a r i a n t e
vermente	e r m e n t e
visibile	v i s i b i l e
vulpes	v u l p e
zinc	5
Association	a d a m i a t i o n 3
Erik	r i k
Filio	i l i o
Secunde	e kw~ nd~ e
Smith	m i
West	e s t
aere	a e r e
affaires	a f y i r e
campania	k a m a n i a
canes	k a* m 3 s
clave	k l a v e
communitates	k o m u n i t a t e
continental	r o n t i n e n t a l
dama	d a m a
debile	d e b i l e
defender	d e f e n d e r
dictionario	d i k t i o n a r i o
documentos	d o k u m e n t o s
entrata	e n t r a t a
exactemente	" a k t E m E n t e
false	f a l s e
gay	g a y
genetic	g e n e t i k
implica	i m p l i k a
informationes	i n f o r m a t i o n 3 m 3 s
krypton	k r 3 p t o n
maritage	m a r i t a j
mathematica	m a t h e m a t i k a
minores	m i n o r e
nordic	n o o n
opinion	o p i n i o n
peninsula	p e d i s u l a
possibilitate	p o s s i b i l i t a t e
presentava	p r e s e n t a v a
previemente	p b e b i E m E n t e
promethium	p r o m e t i u m
rarmente	r a r m e n t e
realisate	r e a l i s a t e
reciper	r E c i p e r
reputation	r e p u t a t i o n 3
retro	r E t r o
rubidium	r u b i d i u m
sablo	s a b l u
sequite	s e k i t e
tante	t a n t e
tractato	tr~ a k t a t o
transverso	i t r i s e r s o
valores	v a l o r e
yttrium	3 t u m
Oriental	r i e n t a l
affirma	a f f i r m a
alternative	a l t E r n a t i v E
ample	a m p l e
arbore	a r b o r e
cambiate	k a m b i a t e
cercar	C E r k a r
characteristica	C a r a k t E r i s t i k a
concertos	r o n z i r t o s
constitution	k o s t i t u t i o n 3
decision	d e 7 i s i o n
determinar	d e t e r m i n a r
developpamento	i s u s k u L p a m e n t o
differe	d i f f e r e
equivalente	e k i w a l e n t e
estimate	e s t i m a t e
evento	e b e n t o
exemplos	" 3 mp~ l o s
haveva	h a v e v a
homosexual	h o s " u a l
impossibile	i m p o s s i b i l e
initiava	i n i t i a v a
intendite	i n t e n d i t e
interpretate	i n t E r p r e t a t e
introduceva	i n t r o t y L u v a
isolate	i s o l a t e
italiano	i t a l i a
jocar	h o k a r
leger	l E g E r
manos	n o s
media	m e d i a
mente	m e n t e
mythologia	m 3 t h o l o g i a
nivellos	n i p e m u S o s
occidite	T i d i t e
officialmente	o f w C i w r a l m e n t e
palladium	p a l l a d i u m
passar	p a s s a r
pedophilos	p E d o ph~ i l o s
poner	p o n 3 q
prefixos	p r e f i S o s
processos	p r o k e s
regime	r e g i m e
relative	r e l a t i v E
republica	r e p u b l i k a
responsabile	r e s p o n a b a  l
rolos	r o l o s
scala	s k a l a
soror	s o r o r
studentes	s t u d e n t e
tabula	t a b u l a
talia	t a l i a
terrestre	t e r a* 7
theatro	th~ e a t r o
tractos	tr~ a k t o s
utile	u t i l e
vetere	f e t e r e
Bernard	E a n a r d
Copenhagen	o p e d a g 3 n
Edward	d w a r d
Israel	s u r u
Joseph	o s e p
Licentia	C " e l e n t i a
Mais	i s
Ricardo	i k a r d o
abstracte	a b " s t r a k t e
addite	a d i t e
adjutar	a d h u t a r
capace	k a p a k e
consentimento	r o n e n t i m e n t o
corde	k o r d e
crescente	k r e s k e n t e
despecto	d e s p E kh~ a m e* t o
destruite	d e s t r u i t e
districto	d i s t r i C t o
duple	d u p l e
enorme	e n o r m e
entrava	e n t r a v a
essayava	e s  y a v a
essayos	e s  y o s
estate	e s t a t e
exprimer	" p r i *
factos	f a k t o s
folios	f o l i o s
for	f o r
fortemente	f o r t E m E n t e
gadolinimum	g a d o l i n i m u m
heroe	h e r o e
identitate	d e n t i t a t e
incontra	i n k o n t r a
individuo	i n d i v i d u o
ligamines	l i g a m i n i
logica	l o g i k a
marca	m a* r k a
melio	m e l i o
novo	n o w o
occupa	T kw~ p a
organo	u r g a
participava	p e r t i k i p a v a
pauco	p a u k o
pensamento	p e s a m i n t o
phenomeno	ph~ u m E n o
poeta	p o e t a
ponite	p o n i t e
portava	p o r t a v a
primarimente	p l i m a r i m e n t e
producer	p r o C u z i r
religiones	r e l i g i o n i
rhodium	r h o d e s i u m
scriptos	s k r i p t o s
sequeva	s e s o X v a
solution	s o l u t i o n 3
strontium	s t r o n t i u m
technetium	t e C n e t i u m
technicas	t e C n i k a s
templo	t 3 mp~ l o
temporal	t e m p o r a l
vicin	v i k i n
von	v o n
vulpe	v u l p e
Carl	a r
Dynastia	y n a s t a
Ergo	r g o
Hall	o l
Marx	a r 7
OmegaT	a w a n
Proque	r o k E
Stockholm	t o k o l m
Studios	t u d i o s
academic	a c a d 7 e m i
apud	a p u d
aures	a u r e
cavallos	k a v a l l o s
commando	k o m m a n d o
componentes	k o m p o n e n t e
conception	r o n C i e p t i o n 3
conceptos	r o n C i e p t o s
consequentias	r o n s k e n t i 3 s
conservate	r o n e r v a t e
credentias	k r e d e n t i 3 s
designos	d e s i g n o s
editor	e d i t o r
evidentia	p i r i d e n t i a
expansion	" k ns~ i o n
foreste	f o r e s t e
fructo	f r u k t o
fundo	f u n d o
germanium	g e r m a n i u m
gratia	g r a t i a
guida	g i d a
influentiate	i n f l u e n t i a t e
inspirate	s p i r a t e
judeos	x u d e o s
manco	n C i o
manieras	n i a a s
mentionate	m e n t i o n a t e
milles	m i l l e
native	n a t i v E
nigro	n i g r o
obteneva	o b t o N u s a
periodos	p e r i o d o s
philosophic	ph~ i l o s o ph~ i k
poesia	p o e s i a
populate	p o p u l a t e
publicar	p u b l i k a r
pueros	p u e r o s
reformas	r e f o r m a s
sequer	s e k a r
sitos	s i t o s
sta	s t a
theologic	th~ 3 o l o g i k
traditiones	tr~ a d i t i o n 3 m 3 s
unite	u n i t e
viste	v i s t e
zonas	z o n a s
Apollon	p o l o
Provincia	r o v i n C i w a
Royal	o y a l
Senato	e n a t o
Switza	w i c a
acheos	a g o s
actrice	a k i cy~ e
assemblea	n i e mb~ l e a
atomos	a t u m o s
attitude	a t t i t u d e
auro	a u r o
automatic	a u t o m a t i k
autonome	a u t o n o m e
autoritates	a u t o r i t a t e
candidato	k a nd~ i d a t o
carne	k a r n
cobalt	k o b a l t a s
communista	k o m u n i S th~ a
comparation	k o m a r a t i o n 3
componite	k o m p o n i t e
considerar	k o s i d e r a r a
doctrinas	d o k t r i n 3 s
durava	d u r a v a
errores	e r ph~ m 3 s
ethnic	e t n i k
fama	f a m a
familiar	f a m i l i a r
federal	f e d e r a l
fixate	f i S a t e
formato	f o r m a t o
governamentos	g o b e r n a m e n t o s
guarda	g u a r d a
habitava	h a b i t a v a
historicos	h i s t o r i k o s
initialmente	i n i t i a l m e n t e
ista	i s t a
jazz	y a z
juventute	x u b e n t u t e
mathematic	m a t h e m a t i k
modificationes	m o d i f i k a t i o n 3 m 3 s
multiple	l t e p l e
nationes	n a t i o n 3 m 3 s
negative	n e g a t i v E
niobium	n i o b i u m
nota	n o t a
occupava	T kw~ p a v a
pelle	p e l
personages	p e r s o n a g e
piano	p y a
placia	p l a y i i a
precise	p r E c i s e
proponite	p r o p o n i t e
proposition	p r o p o s i t i o n 3
proteger	p r o t E g E r
puero	p u e r o
rebellion	r e b e ly~ i o n
referite	r e f e r i t e
resistentia	r e s i s t e n t i a
series	s e r i
sorta	s o r t e
specialisate	s p e k i a l i s a t e
sufficiente	s u f i C y e n t e
troianos	t r o a n o s
univa	u n i v a
vertical	e r t i k a l
Achilles	C i l l e
Balki	a l k i
Cesare	e s a r e
Instituto	s t i t u t o
Larry	a r
Madrid	a d r i d
Marco	a r k o
Museo	u s a i o
Nobel	o b e l
Nota	o t a
World	u r l
adulte	a d u l t e
african	a f r i k a n
annual	a n a l
blau	b l a u
brasilian	b r a s i l i a n
carbon	k a g i b o n
comprendite	k o m p r e n d i t e
conjuncto	r o n C i x u n C i t o
corpores	k o r p o r e
description	d e s k r i p t i o n 3
disciplina	d i S e p l i n a
duceva	d u s e v a
ecclesiastic	e T k l e s u s t
edificios	  i o s
entitate	e n t i t a t e
exclusivemente	" k l u z e Ng~ e r e p i N t e
explica	" p l i k a
facie	f a c i e
governate	g o b e r n a t e
illas	i l l a
jocava	h o k a v a
labores	l a b o r e
minerales	m i n e r a l e
molybdenum	o l a* d e n u m
monstrate	m o* t a 5 s t r a t e
naves	n a b e
necun	n e k u n
notas	n o t t o s
pan	p a n
parlava	p a l a v a
partitos	p e r t i t o s
pornographia	p o r ndw$ b o ch~ t a b a
presentate	p r e s e n t a t e
primitive	p l i m i t i v E
radice	r a d i k e
retorno	r e t o r n o
ruthenium	r u th~ 3 n i u m
selenium	s e l e n i u m
senior	s e n i o r
studia	s t u d i a
supreme	s u p r e m e
tempo	t e N p o
tractate	tr~ a k t a t e
transition	i t r i s i t i o n 3
vento	f e n t o
violentia	v i o l e n t i a
wiki	w i k i
Alora	l o r a
Cambridge	a m b r i d g e
Circa	i r k a
City	i t
Egypto	gy~ p t o
Ibi	b i
adjutava	a d h u t a v a
adresse	a d r e s s e
antiquitate	a n t i k i t a t e
apparato	a p p a r a t o
assere	n i e r e
bandiera	b a n d i e r a
bibliotheca	b i b l i o th~ e k a
characteres	C a r a k t e r e
cognoscer	k o g Ng ~ o n o 8 5 i r a t
cognosceva	k o g Ng ~ o n o 8 u v a
considerabile	k o s i d e r a b i l e
copyright	k o p 3 r i t
definir	d e f i n i r
demandava	d e m a nd~ a v a
depois	d e p o i s
deserto	d e s E r t o
detalios	d e t a l i o s
di	d i
difficultates	d i f f i k u l t a t e
diffusion	d i f f u s i o n
dura	d u r a
duration	d u r a t i o n 3
effortios	i f h t i o s
espanioles	e s p a n i o l e
esseres	e s s u r
estranie	e s t r a n i e
experientias	" p e r i n t i 3 s
global	g l o b a l
habilitate	h a b i l i t a t e
historico	h i s t o i cy~ o
introducite	i n t r o C u C y t
invention	i n f e n t i o n 3
lente	l e n t e
marin	m a r i n
menacia	m E n a g a a
musicos	s i k o s
nuclear	n u k l e a r
organic	u r g a n i k
paradoxo	p a r a d o g o
passage	p a s s a g e
pena	p e n a
periculo	p e r i k u l o
permanente	p e r m a n e n t e
picturas	p i k t u r a s
portate	p o r t a t e
prefere	p r e f e r e
prefixo	p r e f i S o
presidentia	p r e s i d e n t i a
provincias	p r o v i n C i w 3 s
publica	p u b l i k a
quantic	k a n t i k
representantes	r e p r e s e n t a n t e
retornar	r e t o r n a r
selection	s e l e k t i o n 3
silicium	s i l i i u m
societates	s o k i e t a t e
solide	s o l i d e
stationes	s t a t i o n 3 m 3 s
throno	t r o n o
totes	t o t e
variantes	v a r i a n t e
vision	v i s i o n
Antonio	t o o
Augusto	t u g u s t o
Brown	r o w n
Central	e n t r a l
Gratias	r a ty~ a s
Oriente	r i e n t e
Ultra	l t r a
alcunos	a l k u n o s
assassinate	n i a s s i n a t e
assecurar	n i e n i u r a r
calor	k a l o r
cameras	k a * a s
catena	k a t e n a
catholicos	k a t o l i k o s
circulo	l r u l o
civilisation	i v i l i s a t i o n 3
computatores	k o m p u t a t o r e
connectite	r o n d e* k a* b d i
cursos	k u r s o s
dansa	d a s a
decide	d e 7 i d e
determina	d e t e r m i n a
distribuite	d i s t r e i t e
episcopos	a p i s k o p o s
error	e r o r
execution	" e k u t i o n 3
extra	e S
frigide	f x i d e
fronte	f b u* d a k
gallium	g a ly~ i u m
habitate	h a b i t a t e
hiberno	h i b E a n o
i	i
impostos	i m p o s t o s
incontro	i n k o n t r o
infra	i n f r a
instruction	s t r u k t i o n 3
irregular	i r e g u l a r
jocate	h o k a t e
judicio	x u w C i w r o
limite	l i m i t e
logic	l o g i k
manuscriptos	m a n u s k r i p t o s
minutas	m i n u t o s
normas	n o r m a s
participar	p e r t i k i p a r
peccato	p e k k a t o
permitter	p e r m i t t e r
planetas	p l a y i n e t o s
planos	p l a y i n o s
productos	p r o C u k t o s
rar	r a r
realisava	r e a l i s a v a
secun	s e k u n
sembla	s e m b l a k
sinistra	s i n i s t r a
slovene	s v e l o v e n e
substantias	s u b s t a n t i 3 s
technologia	t e C n o l o g i a
terreno	t e r
transmission	i t r i s m i s s i o n
tropic	t r o p i k
vitas	v i t a s
Athena	th~ 3
Benque	e n kw~ i
Bolívar	o l i v a r
Corte	u r t e
Gulielmo	l i e l m o
Linné	i n t e
Portugal	u r t u g a l
Toki	o k i
Vasa	a s a
adolescentes	a d o l e s k e n t e
agricultura	y i cy~ u l t u r a
ambes	a m b e sy~ s
ancestre	5 u k a a* 7
artificial	a r   i a l
catto	k a t t o
causar	k a u s a r
cinema	i n i m a
comenciamento	k o p i n C i w a m e n t o
compositos	k o m p o s i t o s
comprende	k o m p r e n d e
contribueva	r o n b u e v a
coperi	k o p e r i
debatto	d e b a t t o
decisiones	d e 7 i s i o n i
desiro	d e s i r o
distribution	d i s t r i b u t i o n 3
dynamic	o n a m i
effective	e f e k t i v E
establir	e s t a b l i r
eveniva	u s k n i v a
executive	" e k u t i b e
experimental	" p e r i m e n t a l
extreme	e S a m e
governator	g o b e r n a t o r
gris	g r i s
ido	d o
influentias	i n f l u e n t i 3 s
institution	s t i t u t i o n 3
internet	i n t E r n
introduction	i n t r o C u k t i o n 3
iva	i v a
kitsune	k i t o r i
licentia	l i C E n t i a
marcate	m a* r k a t e
mechanica	m e C a n i k a
metallos	m e t a l l o s
mille	m i l l e
monstrava	m o* t a 5 s t r a v a
nickel	n i S k
nobile	n o b i l e
novem	n o p e m
nube	n u b e
oceano	T E a
oculo	o k u l o
pedophile	p E d o p l a b i
placiate	p l a y i i a t e
polonese	p o l o n e s e
posto	p o s t o
proposito	p r o p o s i t o
reguardate	r e g u a r d a t e
resta	r e s t a
saison	s e i s o n
sclavos	s k l a v o s
serviva	s e r v i v a
significantia	s i g  k a n t i a
significar	s i g  k a r
simultaneemente	S i m u l t a n 3 s 3 m E m E n t e
studiar	s t u dy~ a r
ulterior	u l t E r i o r
universitates	u n i v e r s i t a t e
vocal	v o k a l
Citate	i t a t e
Democratic	e m o k r a t i k
Fluvio	l u i o
Islam	s l a m
Language	a n g u a j
Lingua	i N u a
Louis	o u i s
Mundo	u n d o
Norvegia	u r e N i
Polonia	o l o n i y a
Pona	o n a
Scotia	k o t i a
Shakespeare	h a k e 8 p e n e a r e
Tony	5
Zeus	e u s
activismo	a k t i i s m o
actualitate	a k t u a l i t a t e
alliantia	o l  a n t i a
amonta	a m o* t a
appoiava	a p pw~ a a v a
arrivar	m a n i v a r
arrivata	m a n i v a t a
artes	i t e
atomic	a t u m i
beltate	b e l t a t e
calculo	k a l kw~ l o
causas	k a u s a s
clarmente	k l a s a y m 3 n t e
conscientia	r o n S e e n t i a
continuar	r o n t i n u a r
contributiones	r o n b u t i o n 3 m 3 s
controlar	r o n t r o l a r
decennios	d e 7 n i o s
dimension	d i * ns~ i o n
discoperiva	d i s k o p e r e
disveloppar	d i s v e l o v e l o p p a r
diversitate	d i e r s i t a t e
editate	e d i t a t e
entrar	e n t r a r a
eterne	e t E r n
expertos	" p e r t o s
fixe	f i S 3
fluxo	f % g o
fortalessa	f o r t a l 3 s a
fungos	f u N o s
habera	h a b e r a
hora	h o r a
identificate	d e n t i f i k a t e
incognite	i n k o g n E i 7
initia	i n i t i a
intellectual	i n t e l a e k t u a l
intelligente	i n t 3 x e n t e
jornales	c u k u l e*
laborar	l a b o r a r a
lectores	l e k t o r e
liberal	b e r a l
magazin	a z i n
maladias	m a l a d i a s
manganese	m a N a n e s e
massive	s s i v E
minoritate	m i n o r i t a t e
motor	m o t o r
nominava	n o m i n a v a
obtenite	o b t e
oleo	o l e o
oral	o r a l
phosphoro	f o s f o r o
pone	p o n e
porto	p o r t o
povre	p o w
practicas	p r a k t i k a s
precedente	p r E C E d e n t e
presidential	p r e s i d e n t i a l
prominente	p r o m i n e n t e
promotion	p r o m o t i o n 3
reforma	r E h m a
regularmente	r e g u l a s a y m 3 n t e
requirite	r E k i r i t e
schema	S E m a
sexo	s e g o
solar	s o l a r
suffreva	s u f b e b a
superfacie	s u p e r y i e
surgeva	s u r  v a
syllaba	s u y L a b a
theologia	th~ 3 o l o g i a
titulos	t i t u l o s
torno	t o r n o
transformation	i t r i s f o r m a t i o n 3
transporto	i t r i s p o r t o
truppas	t o u p p a s
usos	u s o s
variationes	v a r i a t i o n 3 m 3 s
vaste	v a s t e
zirconium	z i r k o n i u m
Bibliotheca	i b l i o th~ e k a
Carinthia	a r i t i a
Centro	e n t r o
Constitution	o s t i t u t i o n 3
Evangelio	v a n g e l i o
Istes	s t e
Istos	s t o s
Jerusalem	i d u s a l 3 m
Latin	a t i n
Libro	i b r o
Lo	o
Originalmente	x i n a l m e n t e
Que	u e
Rock	T
Sparta	p i t a
Tiberio	i b e r i o
Vide	d e
accompaniate	a k k o mp~ a n i a t e
apparentia	a p p a r e n t i a
attaccos	a t t a kh~  o s
avantiate	m a v a n t i a t e
axe	a x e
benes	b i n i
binari	b i n a r i
chimia	C i m i a
chromium	C r o m i u m
circulation	l r u l a t i o n 3
contrasto	r o n t r a s t o
coperite	k o p e r i t e
copia	k o p i a
criticos	k r i t i k o s
decade	d e k a d e
denomina	d e n o m i n a
describeva	d e s k r i b e v a
dirigeva	d i r i g 3 v a
distinctive	d i s t i n k t i v E
dramas	d r o m o s
duce	d u k e
efficace	e f i k a k e
exister	" i s t e r e n
fluvios	f l u b i o s
indian	i n d i a n
infection	i n f k t i o n 3
inseniava	s a v a
labora	l a b o r a
largemente	l a r N g E m E n t e
litteralmente	t t E r a l m e n t e
locate	l o k a t e
manual	m a n u a l
masculo	s k u l o
mineral	m i n e r a l
mm	m m
modificate	m o d i f i k a t e
montanias	m o* t a n i a s
notate	n o t t a t e
observate	o b e r v a t e
occupate	T  c h a
patronos	p a t r o n o s
pedes	p e 8 r m 3 s
pensar	p e i r a r a
perdita	p e o n e n
proteina	p r o t e i n a
pseudonymo	p s u d o 5 m o
publicationes	p u b l i k a t i o n 3 m 3 s
quadratos	k 7 t a d r a t o s
racias	r a i 3 s
radical	r a d i k a l
risco	r i s k o
scandium	s k a nd~ i u m
scripto	s k r i p t o
seligite	s e l i g i t e
sensibile	s e ns~ i b i l e
serea	s e r e a
servitor	s e r v i t o r
sic	s i k
sulfure	s u l f u r e
symbolic	s i m b o l i k
te	t e
tendentia	t e n d e n t i a
teneva	t e n e v a
tenite	t e
titanium	t i t a n i u m
transmittite	i t r i s m i t t i t e
travalios	t r a v a l i o s
vias	v i a s
visual	v i s u a l
Ambe	mb~ e
Amsterdam	m s t E r d a m
Battalia	a t t a l i a
Brian	r i a n
Colombia	o l o m b i a
Couturat	o u t u r a t
Era	r a
Luna	u n a
Nederland	p i e d r xy~ E kw~ a n d i g
Paises	a z o s
Peter	e t e r
Press	r e s
accento	a k C E n t o
adder	a d a r
adoptava	a d o p t a v a
age	a g a
augmenta	a u k m e nt~ a
autonomia	a u t o n o m i a
censo	C E s o
chacos	C a k o s
chloro	C l o r o
clause	k l a u s e
collectiones	k o l l e k t i o n 3 m 3 s
commenciava	k o m i n C i w a v a
compositor	k o m p o s i t o r
condemnate	r o n d e m n a t e
construer	r o n u z i a
costo	k o s t o
criticas	k r i t i k a s
denomination	d e n o m i n a t i o n 3
discipulos	d i S e C u m b o s
discussion	d i s k u s s i o n
disputa	d i s p u t a
dolor	d o l o r
electromagnetic	e l e k tr~ o m a j
episodio	a p i s o d i o
equilibrio	e k i l i b ry~ o
expedition	" p e d i t i o n 3
files	b i l e
financiari	f i n a n C i w a r i
football	f o t b o l
frontiera	f r o n t a o r a
fructos	f r u k t o s
generic	g e n e r i k
germanic	g e r m a n i k
grave	g r a v e
horologio	h o r o l o g i o
humide	h u m i d e
immediate	i m  a t e
indianos	i n d i a n o s
indicate	i n d i k a t e
inseniar	s a r
intense	i n t e s e
interessante	i n t e r e s s a n t e
interessate	i n t e r e s s a t e
inventate	i n f e n t a t e
inviate	i n v i a t e
lassa	l a s a
lector	l e k t o r
limites	l i m i t e
magic	m a g i k
manteneva	m a n t e n e v a
masculos	s k u l o s
mechanismo	m e C a n i S m o
mixtura	m i S t u r a
mobile	m o b i l e
municipal	m u n i C i p a l
muro	u d o
necessita	d e* k a* b e s s i t a
notion	n o t i o n 3
nubes	s u c "
objectivos	o by~ E C t i v o s
observationes	o b e r v a t i o n 3 m 3 s
offereva	o f e r e v a
officio	o f w C i w r o
opposite	o p p o s i t e
orientate	u r i n t a t e
origines	u r i g i n i
papiro	p a p i r o
plan	p l a n k o
proba	p l o b a
probabile	p l o b a b i l e
producto	p r o C u k t o
promover	p r o m o v e r i
pronunciation	p r o n u n C i w a t i o n 3
quand	k a n d i g
radiation	r a d i a t i o n 3
radioamatores	r a d i o a m a t o r e
recognosceva	r E c o g Ng ~ o n o 8 u v a
referentias	r e f e r e n t i 3 s
reimplaciate	r e i m p l a y i i a t e
rende	r e n d e
representationes	r e p r e s e n t a t i o n 3 m 3 s
ressources	r e s  u r k m 3 s
sapeva	s a p e v a
secrete	s e k r e t e
sectiones	s e k t i o n 3 m 3 s
sector	s e k t o r
separation	s e p a r a t i o n 3
sera	s e r a
sona	s o n a
sonos	s o n o s
spatial	s p a t i a l
strictemente	s t r i C t E m E n t e
studiate	s t u dy~ a t e
substantia	s u b s t a n t i a
suggere	s u m e r e
supporto	s u p p o r t o
temperaturas	t e N p e r a t u r a s
tende	t e n d e
tornados	t o r n a d o s
tubo	t u b o
una	u n a
unes	u n i
utilisar	u t i l i s a r
virus	v i r u s
vitro	v i c e
volumine	v o l u m i n e
votos	v o t o s
Anne	a n n e
Assemblea	s e mb~ l e a
Cage	a g a
Cid	s e i
Communitate	o m u n i t a t e
Existe	S i s t e
Historia	i s t o r i a
Hollywood	o l ly~ w o d
Kansas	a sh~ 3 s
Latino	a t i n o
Martin	i t i n
Minor	i n o r
Revolution	e v o l u t i o n 3
Sicilia	i i l i a
Sur	u r
Tamben	a m b e n
Tres	r e
Turre	u r
Vetule	e t u l e
acceptava	a k u p t a v a
acido	a c i d o
animate	a n i m a t e
annunciava	a n n C i w a v a
approximatemente	a p p r o S i m a t E m E n t e
arbores	a r g a b e
armeas	a r m e 3 s
arrestate	m a n e s t a t e
cade	k a d e
capitulos	k a p i t u l o s
cercava	C E r k a v a
collo	k o l o
combina	k o mb~ i n a
comenciate	k o p i n C i w a t e
comprehende	k o m p r e h e n d e
consistente	k o ns~ i s t e n t e
contactos	r o n t a  t o s
cosmic	k o s m i
creator	k r e a t o r
cura	k u r a
democratic	d e m o k r a t i k
diametro	d i m E t r o
digital	d i g i L a l
dispareva	d i s p a r e v a
distinguer	d i s t a w i n d i a
donava	d o n a v a
essentialmente	e s e n t i a l m e n t e
exprime	" p l i m e
frontieras	f r o n t a o r 3 s
fundatores	f u nd~ a t o r e
illegal	i l l e 7 a l
impedir	i m p e d i r
influentiava	i n f l u e n t i a v a
legenda	l E g e n d a
liberation	b e r a t i o n 3
ligamine	l i g a m i n e
meliorar	m e l i o r a r a
mixte	m i S
montaniose	m o* t a n i o s e
morite	m o r i t e
nasce	n a s k e
operationes	o p e r a t i o n 3 m 3 s
opiniones	o p i n i o n i
ordinari	u r d i n a r i
orthodoxe	u r t o d o g e
palatio	p a l a t i o
partiva	p e r t i v a
pensava	p e s a v a
periculose	p e r i k u l o s e
periodic	p e r i o d i k
possedeva	p o s e d e v a
posteriormente	p o s t E r i o s a y m 3 n t e
progressive	p r o g r 3 s a Ng~ e r e
propone	p r o p o n e
propositiones	p r o p o s i t i o n 3 m 3 s
puncta	p u n C i t a
quitava	k i t a v a
realmente	r e a l m e n t e
representante	r e p r e s e n t a n t e
resultante	r e s u l t 3 n t e
reuniones	r e u n i o n i
rito	r i t o
saepe	s a e p e
secretario	s e k r e t a r i o
septimana	s e p t i m a n a
servite	s e r g o y t
situationes	s i t u a t i o n 3 m 3 s
soldato	s o l d a t o
sposo	s p o s o
successos	s u k u 7 o s
supernomine	s u p E a n o m i n e
tentativa	t e n t a t i v a
theoric	th~ 3 o r i k
traditionalmente	tr~ a d i t i o n a l m e n t e
unitari	u n i t a r i
urbes	u r b e sy~ s
vader	v a d e r
visitava	v i s i t a v a
Bon	o n
Britannic	r i t a n n i k
Canada	a n a d a
Esseva	s e v a
Fame	a m e
Francisco	r a n C i s k i s  o
Hic	i k
Insulas	s u l a
Justitia	u s t i t i a
Luther	u t h e r
Miguel	i g
Paul	a u l
Platon	l a t o n
Posteriormente	o s t E r i o s a y m 3 n t e
Region	g i o n
Tal	a l
Texto	" t o
acute	a k u t e
angulo	a n g u l o
apertura	a p e r t u r a
architecto	a r C i t e k t o
assertion	n i e r t i o n 3
augmentar	a u k m e n t a r
conjunctemente	r o n C i x u n C i t E m E n t e
constitutional	k o s t i t u t i o n a l
cooperation	k o o p e r a t i o n 3
costumes	k o s t u 8 i m 3 s
credite	k r e d i t e
criticate	k r i t i k a t e
designa	d e s i g n a
detra	d E t r a
dictionarios	d i k t i o n a r i o s
discoperta	d i s k o p e r t e
editorial	e d i t o r i a l
effortio	i f h t u o e
emphase	3 mp~ h a c e
estima	e s t i m a
extendite	e S t e
forestes	f o r e s t i
functionamento	f u n C i t i o n a m e n t o
ideal	d e a l
identificar	d e n t i f i k a r
imperial	i m p e r i a l
imprimite	i m p l i m i t e
influente	i n f l u e n t e
instructiones	s t r u k t i o n 3 m 3 s
intention	i n t e n t i o n 3
interrate	i n t e r a t e
ir	i r
jalne	y a l
magnesium	m a j  i u m
manca	n k a
mangiar	m a N i a r
mantene	m a n t e n e
memorias	m e m o r i a s
modificar	m o d i f i k a r
nobilitate	n o b i l i t a t e
note	n o t e
occupation	T kw~ p a t i o n 3
opponente	o p p o n e n t e
orbita	u r b i t a
organos	u r g a n o s
pagar	p a x a r
passos	p a s s o s
perfecte	p e r f e k t e
phenomenos	ph~ u m E n o s
placer	p l a y i 5 i r a t
planta	p l a y i nt~ a
possibilemente	p o s s i b i l E m E n t e
presentar	p r e s e n t a r
pressa	p r 3 s a
probas	p l o b a s
prova	p r o v a
psychologic	p a C o l o g i k
quadrate	k 7 t a d r a t e
quantitates	k a n t i t a t e
rango	r a n g o
recentemente	r E C E n t E m E n t e
recercas	r E C E r k a s
refusava	r e f u s a v a
regulate	r e g u l a t e
respectivemente	r e s p E kh~ a m e*  Ng~ e r e p i N t e
responsabilitate	r e s p o i r a r u w i l i t a t e
retes	r e t e
revela	b e b e l a
seriose	s e r i o s e
sport	s p o r
stabilitate	s t a b i l i t a t e
stratas	s t r a t a s
stylo	s t l o
succession	s u k u s s i o n
superviveva	s u p e r i e v a
territorial	t e r i t o r i a l
totalitate	t a t a l i t a t e
turres	t u r m 3 s
ut	u t
valle	v a l
van	v a n
vector	s k a* b t o r
verbal	e r b a l
video	v i d e o
Achille	C i l l e
Actualmente	k t u a l m e n t e
Athenas	th~ 3
Berlin	e r l i n
California	a l i f o r n i a
Die	i e
Etate	t a t e
Frits	r i c
Fundation	u n d a t i o n 3
Guerras	u e r a s
Harry	a r
Hectore	e k t o r e
Insula	s u l a
Libere	i b e r e
Luca	u k a
Renascentia	e n a s k e n t i a
Scripturas	k r i p t u r a s
Super	u p e r
Tjörn	h a r tn~
acclamate	a k k l a m a t e
accusate	a k k u s a t e
actos	a k t o s
adaptate	a d a p t a t e
agricole	y i cy~ o l e
alco	a l  o
algorithmos	a l k o r i th~ m o s
alliatos	o l  a t o s
ancestres	5 u k a % r u z i
applica	a p p l i k a
apprendeva	a p p r e n d e v a
arco	a r k o
arrangiamento	a r a N i  e n t o
attingite	a t t i N i t e
augmentava	a u k m e n t a v a
brevemente	b r e Ng~ e r e p i N t e
celle	k
cellula	C E L u l a
cellular	C E L u l a r
characterisa	C a r a k t E r i s a
circular	l r u l a r
coincide	k o m a i d e
comenciar	k o p i n C i w a r
conducta	r o n d u k t a
conserva	r o n e r v a
consonante	k o Th~ o n a n t e
consonantes	k o Th~ o n a n t e
cornamusa	k o r n a m u s a
creante	k r e a n t e
credente	k r e d e n t e
deber	d e b e r
decisive	d e 7 i s i v E
dedicava	d e d i k a v a
defende	d e f e n d e
destruction	d e s t r u k t i o n 3
discoperi	d i s k o p e r i
discoperir	d i s k o p e r i r
distinguite	d i s t i N g i t e
emergentia	E m E r x e n t i a
emplea	3 mp~ l e a
ensemble	e n s mb~ l e
eruditos	e r u d i t o s
eventualmente	p i r 3 n t u a l m e n t e
examine	e S a m 3 n e
exilio	" i l i o
exposition	" p o s i t i o n 3
expressiones	" p r e s s i o n i
ferro	f e r o
filias	b i l i a s
functional	f u n C i t i o n a l
gas	x a s
gases	g a e
idiomas	d i o m a s
indicar	i n d i k a r
insenia	s e n i a
interslavo	i n t E r s l a v o
intervention	i n t E r f e n t i o n 3
jornalista	c u k u n a l i s t a
kalium	k a l i u m
laboratorio	l a b o r a t o r i o
linguistica	l i n g i s t i k a
listas	l i s t a s
luctava	l u k t a v a
machinas	m a C i n 3 s
magazines	a z i n i
materne	m a t E r n
medic	m e d i k
melodic	m e l o d i k
meridional	m e r i d i o n a l
metallic	m e t a ly~ i k
minime	m i n i m e
mission	m i s s i o n
municipalitate	m u n i C i p a l i t a t e
muros	r o s
museo	s a i o
narra	n a r a
narration	n a r a t i o n 3
natrium	n a t r e u m
nominar	n o m i n a r
novemente	n o Ng~ e r e p i N t e
obtene	o b t e n e
parco	p i r o
partialmente	p e r t i a l m e n t e
participantes	p e r t i k i p a n t e
patiente	p a t i E n t e
pederastia	p e 8 r e r a s t a
personalitate	p e r s o n a l i t a t e
pictor	p i k t o r
planification	p l a y i  k a t i o n 3
poneva	p o n e v a
portas	p o r t o s
portion	p o r t i o n 3
precoce	p r e k o k e
preter	p r e t e r
productor	p r o C u k t o r
progresso	p r o g r e s
prohibite	p r o h i b i t e
pronomine	p r o n o m i n e
pulvere	p u l e r e
reducite	r e d u C y t
renominate	r e n o m i n a t e
restava	r e s t a v a
sancte	s a*  t e
sapite	s a p i t e
signava	s i g n a v a
sphera	s p i*
stilos	s t i l o s
suffre	s u f
summa	s u m a
supernatural	s u p E a n a t u r a l
tenta	t e n t a
tono	t o n o
totos	t a t o s
toures	t o u r e
tractatos	tr~ a k t a t o s
ventos	f e n t o s
viages	v i a g e
Annos	a n n o s
Castello	a s t e l o
Commission	o m m i s s i o n
Congresso	o N r e s
Derectos	e r a T t o s
Duce	u k e
Est	s t
Exemplos	S 3 mp~ l o s
Juan	u a n
King	i N
Liga	i k a
Ludovico	u d o v i k o
Manifesto	a n i f i S t o
Ordine	r d i n e
Prince	r i n k e
Richard	i C a r d
Sovente	o p e n t e
Trump	r u m p a
Zamenhof	a m e S
abuso	a b u s o
adjacente	a d j a C E n t e
adjutate	a d h u t a t e
ager	a g a r
alimentos	a l i m e n t o s
altemente	a l t E m E n t e
antenna	a n t e
aperite	a p e r i t e
appropriate	a p p a z ry~ a t e
aquas	a q u a s
assignate	n i i N n i s a t e
atmosphera	a t m o s p i*
authentic	a u th~ 3 7 o t i k
avantiamento	m a v a n t i a m e n t o
battalias	b a t t a l i a s
batteria	b a t t E r i a
bloco	b l o k o
blues	b l u e
bordo	b o r d o
brancas	b r o m a s a
canal	k a n a l
celate	C E l a t e
celebre	C E l E o*
centros	C E n t r o s
cerebro	C E r e b r o
cessava	k 3 s a a v a
chordas	C o r d 3 s
claudite	k l a u d i t e
cogniscite	k o g n i S e t e
colonos	k o l o n o s
committee	k o f a t t i 3 n
complexo	k o m p l " o
conferentias	r o n f e r e n t i 3 s
congresso	k o N r e s
consisteva	k o ns~ i s t e v a
continuitate	r o n t i n u i t a t e
corruption	k o r k i n t i o n 3
credentes	k r e d e n t e
crise	k r i s e
criterios	k r i t E r i o s
declaration	d e k l a r a t i o n 3
declinava	d e k l i n a v a
democratia	d e m o k r a t i a
densitate	d e ns~ i t a t e
des	d e
descriptiones	d e s k r i p t i o n 3 m 3 s
desira	d e s i r a
digitos	d i g i t o s
divisiones	d i v i s i o n i
donate	d o n a t e
drogas	d r o x a s
eminente	e m i n e n t e
entitates	e n t i t a t e
essaya	e s s a y a
exceptiones	" u p t i o n 3 m 3 s
exemplares	" 3 mp~ l a r e
facente	f a C E n t e
fragmentos	f r a n k i m e n t o s
gradualmente	g r a d u a l m e n t e
imposto	i m p o s t o
indigena	x e n a
invasion	i n b E s i b o n
legendas	l E g E d 3 s
legislative	l E g i s l a t i v E
legite	l E g i t e
liberate	b e r a t e
longor	l o N g o r
luna	l u n a
maritate	m a r i t a t e
mediante	m e d i a t e
mus	n o s
musico	s i k o
neon	n e 7 o n
objective	o by~ E C t i v E
opponentes	o p p o n e n t e
originava	u r i g i n a v a
papa	p a p a
parlante	p a l a n t e
participation	p e r t i k i p a t i o n 3
patientes	p a t i E n t e
permission	p e r m i s s i o n
perspectiva	p e r 8 p e n e k t i v a
petroleo	p e t r o l e o
photographia	f o  b o ch~ t a b a
phrases	ph~ r a e
pop	p o p
pronunciate	p r o n u n C i w a t e
pugno	p u g n o
reducer	r e d u z i r
resolution	r e s o l u t i o n 3
restos	r e s t o s
revistas	r E i s t o s
rural	r u r a l
saliva	s a l i v a
san	s a n
scenas	s k e n 3 s
sedes	s e d a m 3 s
studente	s t u d e n t e
symptomas	s i m p t u m o s
tabella	t a b e y a
telescopio	t e l e s k o p i o
tendentias	t e n d e n t i 3 s
universitari	u n i v e r s i t a r i
variabile	v a r i a b i l e
vicinitate	v i k i n i t a t e
visita	v i s i t a
Addams	d m
Age	g e
Anna	a n n a
Argentina	r g 3 n t i n a
Florentia	l o r e n t i a
German	e r m a n
Helena	e l e n a
Jean	e
Lege	E k E
Mae	a e
Medievo	e d i e b o
Mesmo	e s m o
Papa	a p a
Pedro	p i e d r o
Petro	a t 3 r o
Schola	C o l a
Scriptura	k r i p t u r a
Singapur	i N a p u r
Sovietic	o v i e t i k
Sub	u b
Tom	i r
Vasari	a s a r i
acceptation	a k u p t a t i o n 3
adde	a d e
aer	a e r
aeree	a e r a
agente	a g 3 n t e
agitation	y i t a t i o n 3
alcunes	a l k u n i
appello	a p p e l o
appreciate	a p p r E C y a t e
assistentia	n i i s t e n t i a
associationes	n i i a t i o n 3 m 3 s
avantage	m a v a n t a j
avantiar	m a v a n t i a r
bilingue	b i l i N g w e
brillante	b r e l l a n t e
castellos	k a s t e l l a o s
celebrate	k e l e b r a t e
circulos	l r u l o s
colpos	k o l p o s
communicar	k o m u n i k a r
communitari	k o m u n i t a r i
concerne	r o n C E r n
conclusion	r o n k l u z e o n
conduceva	r o n d y L u v a
conferentia	r o n f e r e n t i a
consenso	r o n e s o
constituyentes	k o s t i t u y e n t e
contava	r o n t a v a
convention	r o n f e n t i o n 3
defensive	d e f e ns~ i v E
descendentes	d e s k e n d e n t e
descendentia	d e s k e n d e n t i a
designar	d e s i g n a r
diabete	d i a b e t e
dirige	d i r i g e
disposition	d i s p o s i t i o n 3
dissolution	d i s s o l u t i o n 3
disveloppa	d i s v e l o v e l o p p a
dominava	b i n a v a
drama	d r a m a
dubita	d u b i t a
dulce	d u l j e
edificate	e d i f i k a t e
educative	e d u k a t i v E
elemental	l E l E m E n t a l
evidente	p i r i d e n t e
explicar	" p l i k a r
exprimite	" p l i m i t e
factor	f a k t o r
fiction	f i k t i o n 3
flotta	f l o t t a
fortiate	f o r t i a t e
generationes	g e n e r a t i o n 3 m 3 s
hospite	h o s p i t e
incorporate	i n k o r p o r a t e
independentemente	i n d e p e n d e n t E m E n t e
inseniate	s a t e
integrate	i n t e g r a t e
integration	i n t e g r a t i o n 3
interesses	i n t e r e s e
intime	i n t i m e
isse	i s s e
joca	h o k a
juxta	x u r a
lanceate	l a n k o e a t e
leader	l E a d e r
lentemente	l e n t E m E n t e
li	l i
licentias	l i C E n t i 3 s
medical	m e d i k a l
micre	m i C
millennio	m i l l 3 n o
milliardos	m i l l i a r d o s
molle	o l l e
moveva	m o p e m u v a
mythos	m 3 t h o s
nemo	n e m o
novella	n o p e m u S
obligatori	o b l a i g a t o r i
observar	o b e r v a r
occasiones	T k a s i o n i
operator	o p e r a t o r
or	o r
ordinate	u r d i n a t e
ordinava	u r d i n a v a
ordines	u r Z u i
organismo	u r g a n i S m o
parlamentari	p a l a m e n t a r i
passive	p a s s i v E
patas	p a t a s
pertineva	p e r t i n e v a
phases	ph~ a e
photographias	f o  b o ch~ t a b 3 s
photos	f o t o s
platteforma	p l a y i t h m a
portar	p o r t a r
possibilitates	p o s s i b i l i t a t e
pp	p p
precios	p r E c i o s
preparation	p r e p a r a t i o n 3
pretendentes	p r e t e n d e n t e
prince	p r i n k e
propagation	p r o p a g a t i o n 3
protegite	p r o t e g i t e
registrava	r e g i s t r a v a
resurrection	r e s u r e k t i o n 3
retirava	r e t i r a v a
revolta	r E f o l t a
ritos	r i t o s
riviera	r i v i e r a
rugby	r u gb~
sacre	s a q
sagessa	s a g 3 s a
sentimentos	s e n t i m e n t o s
serpente	s e r p e n t e
seta	s e t a
sonate	s o n a t e
specificamente	s p e k  k a m e n t e
statal	s t a t a l
suffice	s u f i k e
tabuliero	t a b u l i e r o
termina	t E r m i n a
tornava	t o r n a v a
trenta	w a m i n t a
usual	u s u a l
vacuo	v a k w o
vale	v a l e
venir	f e n i r
vulgar	v u l g a r
Abu	b u
Australia	u s t r a l i a
Christian	h r i s t i a n
Derecto	e r a T t o
Don	o n
Frequentemente	r E k e n t E m E n t e
Gruppo	n i n p o
Hans	a n
Jehovah	e h o w a h
Jonathan	o n a t a n
Karl	a r
Lord	u r d
Los	o s
Mary	a r
Multo	u l t o
Quasi	u a s i
Regal	g a l
Santa	a n t a
Sin	i n
Tacito	a c i t o
Vos	o s
abandonava	a b a n d o n a v a
absentia	a b " e n t i a
acceptar	a k u p t a r
alique	a l i k E
alter	a l t e r
amicitate	a m i C i t a t e
aperiva	a p e r e
apparente	a p p a r e n t e
applicabile	a p p l i k a b i l e
attribuite	a t b u i t e
bases	b a e
besonia	b e s o n i y a
biologic	b i o l o g i k
bits	b i c
brun	b r u n
ca	k a
cadita	C i w a
cammino	k a m m i n o
captura	k a p t u r a
cavallero	k a v a l l e r o
combatter	k o mb~ a t t e r
commandante	k o m m a nd~ a n t e
complexitate	k o m p l " i t a t e
componente	k o m p o n e n t e
componeva	k o m p o n e v a
comprendeva	k o m p r e n d e v a
connexe	r o n " e
connexiones	r o n " i o n i
contar	r o n t a r
controlate	r o n t r o l a t e
convertite	r o n e r d i
cosino	k o s i n o
costose	k o s t o s e
creaturas	k r e a t u r a s
creder	k r e d e r
cursa	k u r s a
descendente	d e s k e n d e n t e
detaliate	d e t a l i a t e
discopertas	d i s k o p e r t o s
discussiones	d i s k u s s i o n i
domination	b i n a t i o n 3
dominios	b i n i o s
dynastia	o n a s t a
elaborate	e l a b o r a t e
emergeva	E m E r x e v a
emphysema	3 mp~ c e m a
entra	e n t r a
episodios	a p i s o d i o s
establimento	e s t a b l i m e n t o
executar	" e kw~ t a r
experimento	" p e r i m e n t o
extendeva	e S e v a
extense	e S i s e
factores	f a k t o r e
ferroviari	f e r o v i a r i
franc	f r a*
gamma	g a m a
gania	g a n i a
gigante	g i g a n t e
grammatic	g r a m 7 o t i k
hereditate	h e r e d i t a t e
ideologia	d e o l o g i a
incorpora	i n k o r p o r a
inimicos	i n i m i k o s
intermediari	i n t E r m  a r i
introducer	i n t r o C u z i r
irlandese	i r l a n d e s e
laco	l a  o
legier	l E g i e r
leon	l e 7 o n
liquido	l i k i d o
longemente	l o N E m E n t e
luctar	l u k t a r
malade	m a l a d e
mammales	m a m m a l e
manifesta	n i f e s t a
mappa	m a p p a
matrimonio	m a t r i m o* i o
mentiona	m e n t i o n a
metallo	m e t a l o
modos	m o d o s
mortal	m o r t a l
mortes	m o r t e
motivo	m o t i b o
motores	m u t u r e
musulmanes	s u l m o n i
necessarimente	d e* k a* b 3 s a a r i m e n t e
nobiles	n o b i l e
obligate	o b l a i g a t e
occasion	T k a s i o n
occide	T i d e
paisage	p a i s a g e
partitas	p e r t i t a s
partition	p e r t i t i o n 3
pedones	p E d o* m 3 s
penal	p e n a l
perception	p e r e p t i o n 3
philosophos	ph~ i l o s o f o s
poetas	p o e t o s
precio	p r E c i n o
preparate	p r e p a r a t e
primavera	p l i m a b e r a
promove	p r o m o v e
proponeva	p r o p o n e v a
provar	p r o w a r
providite	p r o v i d i t e
qualitates	k a l i t a t e
quinte	k i nt~ e
radios	r a d i o s
reactiones	r e a k t i o n 3 m 3 s
realisa	r e a l i s a
reception	r E C E p t i o n 3
redaction	r e d a k t i o n 3
reflecte	r e f l e k t e
representava	r e p r e s e n t a v a
reproduction	r e p r o C u k t i o n 3
respondeva	r e s p o n d e v a
rhythmo	r h 3 t hm~ o
satis	s a t i s
senti	s e n t i
spiral	s p i r a l
statua	s t a t u a
suffixos	s u f i S o s
superava	s u p e r a v a
superficial	s u p e r a i a l
supponite	s u p p o n i t e
supportar	s u p p o r t a r
switze	sw~ i c e
tertio	t E r t u o e
theatral	th~ 3 a tr~ a l
tra	t r a
tractava	tr~ a k t a v a
tropical	t r o p i k a l
utensiles	u t e s i l e
vehiculo	e i k u l o
versos	e r s o s
viagiar	v i a g i a r
vostre	v o s t r e
Anglese	N l e s e
Basel	a s
Bison	i s o n
Camera	a m e r a
Castilia	a s t i l i a
Claudio	l a u d i o
Comocunque	o m o k u n kw~ i
Confederation	o f e d e r a t i o n 3
Contato	o* t a t o
Copertura	o p e r t u r a
Dorking	u r q i N
Dum	u m
Evangelios	v a n g e l i o s
Giovanni	i l o v a n i
Joh	o
Julio	l i o
Leonardo	e o n a r d o
Les	m 3 s
Marilyn	a ry~ ly~ n
Michael	i C a
Monte	b u* d a k
Palatio	a l a t i o
Ponte	b u* d a k
Presidente	r e s i d e n t e
Van	a n
alcuno	a l k u n o
alimentation	a l i m e n t a t i o n 3
ama	a m a
apparer	a p p a r e r
armenie	a r m E n i e
arrangiate	a r a N i a t e
attacca	a t t a k k a
ave	a b e
bisonte	b i s b u* d a k
branca	b r a C a
cambiamento	k a m b i a m e n t o
capitulo	k a p i t u l o
capturate	k a p t u r a t e
cavitate	k a b i t a t e
circumstantias	l r u m s t a n t i 3 s
citatano	T i t a t a n o
cognoscimento	k o g i E 5 o S e m e n t o
comprar	k o m p r a r a
comprension	k o m p r e ns~ i o n
concrete	r o n C i r e t e
configuration	r o n f i g u r a t i o n 3
connexion	r o n " i o n
consequente	r o n s k e n t e
conservative	r o n e r v a t i v E
constantemente	k o s t a n t E m E n t e
contineva	r o n t i n e v a
controverse	r o n t r o e r s e
converteva	r o n e r t e v a
copertura	k o p e r t u r a
cornos	k o r n o s
correspondentia	k o r e s p o n d e n t i a
crescer	k r e s 5 i r a t
cultivate	k u l t i b a t e
decime	d e 7 i m e
demonstrate	d e m o* s t r a t e
dense	d e s e
desinentia	d e s i n e n t i a
developpate	i s u s k u L p a t e
disciplinas	d i S e p l i n 3 s
discrimination	d i s k l i m i n a t i o n 3
discursos	d i s k u r s o s
dona	d o n a
elevation	e l e b E t i o n 3
emission	e m i s s i o n
estranier	e s t r a n i e r
evita	p i r i t a
excambio	" k a m b i o
expandite	" p a n d i t e
explicate	" p l i k a t e
explication	" p l i k a t i o n 3
explicitemente	" p l i C y t E m E n t e
explosion	" p l o s i o n
fabrica	f a b r i k a
filos	b i l o s
formante	f o r m a n t e
functionalitate	f u n C i t i o n a l i t a t e
genes	g e n i
geometria	g e o m E t r i a
governar	g o b e r n a r
governava	g o b e r n a v a
gran	g r a
granos	g r a n o s
gusto	g u s t o
historicamente	h i s t o r i C i C e n t e
horizontal	h o r i z o n t a l
humor	h u m o r
hydrogeno	h i g e n o
impression	i m p r e s s i o n
ingeniero	i N e r o
inseniamentos	s a m e n t o s
intende	i n t e n d e
involvite	i n v o l g o y t
justo	x u s t o
lacte	l a k t e
liquide	l i k i d e
lontan	l o n t a n
magazine	a z i n e
maximo	m a x i m o
medico	m e d i k o
mesuras	m e s u r a s
migration	m i g r a t i o n 3
multitude	l t i t u d e
occider	T i d e r
occurrer	T k u r a r
offensiva	o f k u b a
opponeva	o p p o n e v a
optic	o p t i c a
orientation	u r i n t a t i o n 3
parallel	p a r a ly~
parente	p a r e n t e
pareva	p a r e v a
participa	p e r t i k i p a
participio	p e r t i i p i o i
perse	p e r s e
precision	p r E c i s i o n
preste	p r e s t e
pretende	p r e t e n d e
proclamava	p r o k l a m a v a
promovite	p r o m o v i t e
proteinas	p r o t e i t n~ 3 s
puera	p u e r a
punk	p u n
quartiero	k i t a o r o
rational	r a t i o n a l
recensiones	r E C E ns~ i o n i
reduction	r e d u k t i o n 3
referendum	r e f e r e n d u m
registration	r e g i s t r a t i o n 3
reguarda	r e g u a r d a
removite	r E m o v i t e
reservate	r e s E r v a t e
respective	r e s p E kh~ a m e* t i v E
responde	r e s p o nd~ e
reticulo	r e t i k u l o
scandalo	s k a nd~ a r o
scripturas	s k r i p t u r a s
secular	s e k u l a r
secundas	s e k u n d 3 s
sensos	s e Th~ o s
sequentia	s e k e n t i a
signate	s i g n a t e
significatos	s i g  k a t o s
spisse	s p i s s e
sportive	s p o r t i v E
stabile	s t a b i l e
static	s t a t i k
strata	s t r a t a
strategia	s t r a t e g i a
suffixo	s u f i S o
supervive	s u p e r v i v E
supporta	s u p p o r t e
talento	t a l e n t o
terminate	t E r m i n a t e
testa	t e s t a
timor	t i m o r
traducer	tr~ a d u z i r
traduceva	tr~ a d y L u v a
transferite	i t r i s f e r i t e
utilisation	u t i l i s a t i o n 3
victima	v i k t i m a
vigor	v i g o r
virtute	v i r t u t e
zero	z e r o
Alexander	l E a n d e r
Alfred	l f r e d
Ancora	nC~ o r a
Atlantic	L a n t i k
Bakonyi	a k e d i
Brongersma	r o N e r s m a
Cascadas	a s k a d 3 s
Concilio	o i l i o
Corea	o r e a
Daejeon	a e t e 7 o n
Disney	i s n i
Districto	% l u z i k t o
Francese	r a n C E s E
Georgio	e o r i o
Herodoto	e r o d o t o
Hertz	e r c
Historicamente	i s t o r i C i C e n t e
Intertanto	t E r t a n t o
Jacobo	a k o b o
Jam	a m
Jedi	e d i
Margareta	a r N a r e t a
Nationes	a t i o n 3 m 3 s
Nulle	u l
Ora	r a
Pace	a k e
Parola	a r o l a
Priamo	r i a m o
Records	e k o r d
Secun	e kw~ n
Tu	u
Universal	n i v e r s a l
Victoria	i k t o r i a
Wilson	i l o*
Zelanda	e l a n d a
abbreviate	a b " o*  i a t e
abbreviation	a b " o*  i a t i o n 3
abundante	a b u n d a n t e
accusationes	a k k u s a t i o n 3 m 3 s
activista	a k t i i s t a
actores	a k t o r e
adequate	a d e k a t e
administrator	a d m i n i s t r a t o r
adoptar	a d o p t a r
advocato	a d v o k a t o
affirmava	a f f i r m a v a
alternativa	a l t E r n a t i v a
anatomia	a n a t o m i a
appoia	a p p o i a
approbation	a p p l o b a t i o n 3
astronomic	a s t r o n o m i
attaccate	a t t a k k a t e
attrahite	a t tr~ a i t
auree	a u r e
automaticamente	a u t o m a t i k a m e n t e
balla	b a ly~ a
bestial	b e s t i a l
campion	k a m p i o n
carta	k i t a
centimetros	C E n t i m E t r o s
codification	k o d i f i k a t i o n 3
cognate	k o g i E 5 a t e
collaboration	k o l l a b o r a t i o n 3
comocunque	k o m o k u n kw~ i
companias	k o mp~ a n i a s
companion	k o mp~ a n i o n
complicate	k o m p l i k a t e
compositores	k o m p o s i t o r e
conflictos	r o n f l i k t o s
conforme	r o n h m e
conjugation	r o n j u g a t i o n 3
consideration	k o s i d e r a t i o n 3
constitueva	k o s t i t u 7 3 v a
costas	k o s t o s
costume	k o s t u
declino	d e k l i n o
demandar	d e m a n
derivation	d e r i v a t i o n 3
descende	d e s k e n d e
desirava	d e s i r a v a
dieta	d i e t a
difficultate	d i f f i k u l t a t e
dimensiones	d i * ns~ i o n i
discutite	d i s k u t i t e
distantias	d i s t a n t i 3 s
domesticate	b a* 7 i k a t e
du	d u
equipas	e k i p a s
esperantistas	e s p e r a n t i s t a s
essayo	e s  y o
europeos	u o p e o s
evangelio	p i r a N e l i o
evolveva	e v o l e v a
excellente	" C E l l e n t e
explicite	" p l i C y t
exploration	" p l o r a t i o n 3
extinction	e S m a t i o n 3
extrememente	e S a m E m E n t e
faciente	f a C y e n t e
favorabile	f a v o r a b i l e
ferite	f e r i t e
file	b i l e
filo	b i l o
gothic	g o th~ i k
idioma	d i o m a
immigration	i m m i g r a t i o n 3
impedi	i m p E d i
indefinite	i n d e f i n i t e
indice	i n d i k e
infinite	i n f i n i t e
influential	i n f l u e n t i a l
initiate	i n i t i E t e
inscription	s k r i p t i o n 3
inspiration	s p i r a t i o n 3
installation	s t a l l a t i o n 3
internationalmente	i n t E r n a t i o n a l m e n t e
islamic	i s l a m i
judicial	x u d i k i a l
juncte	C i x u n C i t e
lancea	l a n k o e a
las	l a
lectiones	l e k t i o n 3 m 3 s
lectura	l e k t u r a
leve	l e v e
luce	e 7 k
luctas	l u k t o s
manifestation	n i f i S t a t i o n 3
marita	m a r i t a
mechanic	m e C a n i k
mechanismos	m e C a n i S m o s
ministerio	m i n i S t E r i o
monasterio	m o n a s t E r i o
monumentos	m o n u m e n t o s
negotios	n e g o t i o s
neutral	n e u tr~ a l
nodo	n o t o
nomen	n o m e n
novellas	n o p e y a
observation	o b e r v a t i o n 3
organisa	u r g a n i s a
partial	p e r t i a l
peccatos	p e k k a t o s
pertinente	p e r t i n e n t e
pesante	p e s a n t e
phonetic	f o n e t i k
pipiones	p i p i o n i
politico	p o l i t  o
possession	p o s e s s i o n
potentias	p o t e n t i 3 s
preciose	p r E c i o s e
predominante	p r e d o m i n a n t e
primemente	p l i m E m E n t e
principe	p r i n k e p e
protagonista	p r o t a g o n i S th~ a
qualcosa	k a l k o s a
rapiditate	r a  d i t a t e
realisation	r e a l i s a t i o n 3
registrar	r e g i s t r a r a
rejectate	r e h e k t a t e
render	r e n d e r
reunion	r e u n i o n
romantic	r o m a n t i k
salvate	s a l v a t e
scientista	S e e n t i s t a
signal	s i g n a l
significative	s i g  k a t i v E
sino	s i n o
spectaculo	s p e k t a  l o
stoppar	s t o p p a r
subito	s u b i t o
substantial	s u b s t a n t i a l
sue	s u e
superviver	s u p e r v i v e r i
supportate	s u p p o r t a t e
surge	s u r g e
temperate	t e N p e r a t e
tene	t e n e
terminologia	t E r m i n o l o g i a
unicamente	u n i C i C e n t e
utilisante	u t i l i s a n t e
vacca	v a k k a
vade	v a d e
variate	v a r i a t e
veces	s k a* b m 3 s
venite	f e n i t e
verificar	e r  k a r
vinti	v i t i
wikis	w i k i s
Alexandria	l E a nd~ r i a
Ambes	mb~ e
Angeles	g e l e
Antique	t i k E
Aphrodite	ph~ r o d i t e
Aragon	r a g o n
Brahe	r a e
Casa	a s a
Cor	o r
Costa	o s t a
Elizabeth	l i r o t
Espaniol	s p a n i o l
Gabriel	a b "
Galles	a ly~ m 3 s
Gay	a y
Granada	r a n a d a
Groenlandia	r o l a n d i a
Intra	t r a
Joco	o k o
José	o s e
Leonidas	e o n i d 3 s
Lisbona	i s p o l a
Love	o v e
Mattheo	a t t a e o
Normalmente	o r m a l m e n t e
Occidente	kh~  i d e n t e
Oceano	C E a
Odense	d e s e
Pacific	a c i f i k
Personas	e r s o n a s
Re	e
Representantes	a p r e s e n t a n t e
Roll	o l o
Romulo	l o
Septe	a p t e
Society	T i e t
Supreme	u p r e m e
Toto	o t o
Tribunal	b u n a l
Urano	r o
Version	e r S i o n
Washington	a S i N r t o n
Windows	i d o 3
accidente	a k i d e n t e
acquirite	a k k i r i t e
alas	a l a
alicunes	a l i k u n i
ambito	a m b i t o
apogeo	a p o g e o
appoiar	a p pw~ a a r
apprentissage	a p p r e n t i s s a g e
arbitrari	a r b i t r a r o
arrivate	m a n i v a t e
asino	a s i n o
assume	n i u
astronomia	a s t r o n o m i a
attaccar	a t t a k k a r
attraction	a t tr~ a k t i o n 3
attributos	a t b u t o s
bolla	b o ly~ a
bracio	b r a i o
cadeva	k a d e v a
canales	k a n a l e
capites	k a p i t e
cargate	k a r g a t e
cassa	k a s a
catalan	k a t a l a n
chaco	C a kw~ e o
chimpanzes	C i m p a n z i
cifra	i f r a
colon	k o l o n
columna	k o l u m n a
combinate	k o mb~ i n a t e
comic	k o m i
competition	k o m p e t i t i o n 3
compilation	k o m p i l a t i o n 3
completar	k o m p l e t a r
compositiones	k o m p o s i t i o n 3 m 3 s
concentration	r o n C i tr~ a t i o n 3
concerto	r o n z i r t o
confirmate	r o n f i r m a t e
confrontava	r o n f r o n t a v a
conquesta	r o n k e s t a
conquireva	r o n ky~ i r E f a
conspiration	k o s p i r a t i o n 3
continueva	r o n t i n u e v a
contractiones	r o n tr~ a k t i o n 3 m 3 s
contribue	r o n t r e bw~ a
controversia	r o n t r o e r s i a
crimine	k l i m i n e
curiositate	k u r i o s i t a t e
denominava	d e n o m i n a v a
dextre	d e S
directiones	d i r E C t i o n 3 m 3 s
doctor	d o k t o r
domos	b o s
dramatic	d r a m a t i k
electricitate	e l e k i cy~ i t a t e
electrones	e l e k tr~ u i
elegite	E l E g i t e
elementari	l E l E m E n t a r i
empleate	3 mp~ l e a t e
empleo	3 mp~ l e o
epochas	a p o C a s
ethica	e t i k a
exception	" u p t i o n 3
expandeva	" p a n d e v a
extensive	e S k u b e
extincte	e S m a t e
faction	f a k t i o n 3
febre	f e o*
felicitate	f e l i k i t a t e
fidel	f i d
fideles	f i d e l e
filas	b i l a
fossile	f o s i l e
galaxias	g a l a x i a s
gentes	g e n t e
geographia	g e o b o ch~ t a b a
guitarras	g i t a r a s
habitual	h a b i t u a l
hebreo	b a s a o
immigrantes	i m m i g r a nt~ m 3 s
impacto	i m p a k t o
incendio	m a e n d i o
indicante	i n d i k a n t e
infundibulo	i n f u nd~ i b u l o
initiativa	i n i t i E t i v a
instantia	s t a n t i a
interaction	i n t E r a k t i o n 3
interpretationes	i n t E r p r e t a t i o n 3 m 3 s
interprisa	i n t E r p r i s a
investigationes	i n v e s t i g a t i o n 3 m 3 s
invisibile	i n i s i b i l e
is	i s
judicamento	x u d i k a m e n t o
judice	x u d i k e
lassar	l a s s a r
lassate	l a s s a t e
liberar	b e r a r a
libertates	b e r t a t e
linguistas	l i n g i s t a s
magne	m a j
magnitude	m a h n i t u d e
mantenite	m a n t e n i t e
massas	s s a s
matur	m a tw~
mexican	m e S i k a n
minimo	m i n i m o
ministros	m i n i s t r o s
moderate	m o d e r a t e
montania	m o* t a n i a
monte	m o* t a 5 a
mytho	m 3 t h o
natal	n a t a l
nive	n i v E
notar	n o t t a r
nova	n o v a
observava	o b e r v a v a
optime	a t i m e
p	p
pacchetto	p a k 5  t o
pacchettos	p a k C e t o s
pensata	p e s a t a
peste	p e S t e
phasic	ph~ a s i k
photo	f o t o
photographic	f o  b o ch~ ph~ i k
pluvial	p l u b i a l
poetic	p o e t i k
portrait	p o r tr~ a i t
practicate	p r a k t i k a t e
preparar	p r e p a r a r
principato	p r i n k i p a t o
prisioneros	p r i s i o n e r o s
pronunciar	p r o n u n C i w a r
proprietario	p a z r i e t a r i o
provider	p r o v i d e r
pueras	p u e r a s
quadro	k i
quam	k a m
radioamator	r a d i o a m a t o r
rattos	r a t o s
reaction	r e a k t i o n 3
recercatores	r E C E r k a t o r e
recognoscer	r E c o g Ng ~ o n o 8 5 i r a t
registro	r e g i s t r o
reimplaciar	r e i m p l a y i i a r
reimplaciava	r e i m p l a y i i a v a
remaner	r E m a n 3 q
renascentia	r e n a s k e n t i a
residentia	r e s i d e n t i a
resolver	r e s o l v e r i
responder	r e s p o n d e r
ritual	r i t u a l
satellite	s a t 3 t e
sentimento	s e n t i m e n t o
servir	s e r k w 3 L i
significava	s i g  k a v a
slovenos	s v e l o v e n o s
socialismo	s o k i a l i s m o
socialista	s o k i a l i s t a
solutiones	s o l u t i o n 3 m 3 s
sonar	s o n a r
specificate	s p e k  k a t e
spectro	s p e k t r o
subite	s u b i t e
successive	s u k k 3 s a Ng~ e r e
sucro	s u k r o
superviventia	s u p e r v i v e n t i a
tener	t 3 n 3 q
tentativas	t e n t a t i v a s
terminava	t E r m i n a v a
these	th~ e s e
titulate	t i t u l a t e
tolerantia	t o l e r a n t i a
tourismo	t o u r i s m o
transformate	i t r i s f o r m a t e
travaliar	t r a v a l i a r
travaliatores	t r a v a l i a t o r e
troian	t r o i a n
tue	t u a
vectores	s k a* b t o r e
vender	f e n d e r
vino	v i n o
vocabulos	v o k a b u l o s
voces	v o k m 3 s
volumines	v o l u m i n i
Additionalmente	d i t i o n a l m e n t e
Adjectivos	g o j t i v o s
Buddha	u d a
Chinese	h i n e s e
Convention	o f e n t i o n 3
Daniel	a n i
Dobkin	o b k i n
English	N l i S
Federal	e d e r a l
Federation	e d e r a t i o n 3
Festival	e s t i w a l
Frank	r a n
Gallia	a ly~ i a
Hannover	a n n o v e r i
Henry	e n r
Hitler	i L e r
House	o u s e
Ido	d o
Initialmente	n i t i a l m e n t e
Invariabile	n v a r i a b i l e
Jamblicho	a m b l i T o
Java	a v a
Jupiter	u p i t e r e n
Jutlandia	u t l a n d i a
Largo	3 y
Leon	e 7 o n
León	e o n
Liberation	i b e r a t i o n 3
Lublin	u b l i n
Magne	a j
Marte	i t e
Martijn	i t i j n
Medie	e d i e
Mi	i
Neptuno	a p t u n o
Niagara	i a g a r a
Nostre	o s t r e
Nuwas	u pw~
Orthodoxe	r t o d o g e
Peano	e a
Poseidon	o s e i d o n
Pote	o t e
Professor	r o f e s  r
Quatro	u a t r o
Regina	g i n a
School	C o l
Sectiones	e k t i o n 3 m 3 s
Similarmente	i m i l a s a y m 3 n t e
Superman	u p e r m a n
São	a o
Traditionalmente	r a d i t i o n a l m e n t e
Turner	u r n 3 q
Uppsala	p p s a l a
Varie	a r i e
abandonar	a b a n d o n a r
abolition	a b o l i t i o n 3
academia	a c a d 7 e m i a
adresses	a d r e s e
affaire	a f y i r
affectate	a f f k t a t e
affligite	a f l i g i t e
algorithmo	a l k o r e hm~ o
alicunos	a l i k u n o s
alteremente	a l t E r E m E n t e
amplemente	a m p l E m E n t e
analytic	a n a ly~ 7 o t i k
anonyme	a n o nm~
apparition	a p p a r i t i o n 3
appellar	a p p e y a r
applicar	a p p l i k a r
apprende	a p p r e n d e
aragonese	a r a g o n e s e
archivos	a r C i v o s
asiatic	a s u 7 o t i k
assumeva	n i u m e v a
attitudes	a t t i t u d e
audir	a u d i r
aut	a u t
baptisate	b a p t i s a t e
baptismo	b a p t i s m o
biographias	b i o b o ch~ t a b 3 s
bisontes	b i s o n t e
bucca	b u k k a
byzantin	by~ u k a n t i n
calcular	k a l k u l a r
calculate	k a l k u l a t e
cardiac	k a g i dy~ a k
cargo	k 3 y
celebration	k e l e b r a t i o n 3
celtic	C E l 7 o t i k
chefes	C e f e
cocina	k o k i n a
commentarios	k o m e n t a r i o s
communion	k o m u n i o n
competentia	k o m p e t e n t i a
complite	k o m p ty~
concipite	r o n C i i p i t e
concorda	k o nC~ o r d a
conducto	r o n d u k t o
conservation	r o n e r v a t i o n 3
constituente	k o s t i t u 7 e n t e
constituite	k o s t i t u y t
conte	r o n t e
contes	r o n t e
continuate	r o n t i n u a t e
converte	r o n e r t e
creative	k r e a t i v E
criterio	k r i t E r i o
crystallin	k ry~ s t a l l i n
currer	k u r a r
cyclo	ky~ k l o
damnos	d a m n o s
dante	d a n t e
debilitate	d e b i l i t a t e
decades	d E c a d 7 m 3 s
declara	d e k l a r a
declarate	d e k l a r a t e
demonstra	d e m o* s t r a
der	d e r
destinate	d e s t i n a t e
destination	d e s t i n a t i o n 3
destrueva	d e s t r u e v a
detalio	d e t a l i o
dialogo	d i a l o g o
diario	d i a r i o
dirigente	d i x e n t e
disordine	d i s o r d i n e
dispare	d i s p a r e
dissolveva	d i s s o l e v a
dominate	b i n a t e
dorso	d o r s o
eligeva	e l i g 3 v a
emissiones	e m i s s i o n i
emittite	e m i t t i t e
energetic	e n e r g e t i k
energic	e n e r g i k
epistolas	a p i s t o l a
equipamento	e k i p a m e n t o
essentia	e s e n t i a
excessive	" k 3 s a Ng~ e r e
executa	" e k u t a
exige	" i g e
explicava	" p l i k a v a
fabula	f a b u l a
facilita	f a c i l i t a
ferma	f e r m a
festas	f e S t o s
fila	b i l a
finir	f i n i r
foramine	f o r a m i n e
formalmente	f o r m a l m e n t e
fraude	f r a u d e
frequentias	f a k e n t i 3 s
genera	g e n e r a
gestion	g e s t i o n 3
glacie	g l a c i e
gloria	g l o r i a
granpatre	g r a n p a t r e
greges	g r e
guidate	g i d a t e
habitat	h a b i t a t
hardware	h a r d w a r e
hereditario	h e r e d i t a r i o
homosexuales	h o s " a l e
hospites	h o s p i t e
humano	h u
identifica	d e n t i f i k a
importa	i m p o r t e
imprisionate	i m p r i s i o n a t e
ingenieria	i N e r i a
innovationes	i n n o w a t i o n 3 m 3 s
inspirava	s p i r a v a
integral	i n t e g r a l
interprisas	i n t E r p r i s a s
intersection	i n t E r e n i t i o n 3
interslave	i n t E r w o
invariabile	i n v a r i a b i l e
inviava	i n v i a v a
laboratores	l a b o r a t o r e
lanceava	l a n C E a v a
lassante	l a s s a n t e
legislation	l E g i s l a t i o n 3
liberemente	b e r E m E n t e
lithium	l i t h i u m
litros	t r o s
lupo	p o
mandava	m a nd~ a v a
match	m a S o
menaciate	m E n a g a a t e
minuta	m i n u t a
modifica	m o d i f i k a
moleculas	o l k u l a
momentos	m o p i n t o s
monarchias	m o n a r C i a s
motion	m o t i o n 3
motivos	m o t i v o s
movite	m o v i t e
n	n
navigation	n a v i g a t i o n 3
norma	n o r m a
nude	n u d e
occideva	T i b v a
occurrite	T k u r t e
orbital	u r b i t a l
ossos	o s s o s
ove	o v e
pagan	p a g a n
paisanos	p a i s a n o s
parasito	p a r a s i t o
pares	p a r e
patria	p a t r i a
perder	p e r d e r
permittente	p e r m i t t e n t e
physico	ph~ i k o
plagias	p l a y i i 3 s
plu	p l u
pluvia	p l u b i a
politicos	p o l i t i k o s
possessive	p o s 3 s a Ng~ e r e
posta	p o s t a
practicamente	p r a k t i k a m e n t e
precipitation	p r E c i p i t a t i o n 3
preda	p r e d a
preferentia	p r e f e r e n t i a
premios	p r e m i o s
prepositiones	p r e p o s i t i o n 3 m 3 s
presentation	p r e s e n t a t i o n 3
preservation	p r e s E r v a t i o n 3
primates	p l i m a t e
psychologia	p a C o l o g i a
publicitate	p u b l i k i t a t e
qua	k a
quaranta	k a r a nt~ a
racemo	r a C E m o
rebelliones	r e b e ly~ i o n i
recognition	r E c o g i E 5 i t i o n 3
redactor	r e d a k t o r
representative	r e p r e s e n t a t i v E
republican	r e p u b l i k a n
requireva	r E k i r E f a
resimila	r e s i m i l a
retorna	r e t o r n a
sacco	s a kh~  o
sacrificio	s a q  i o
sclavitude	s k l a v i t u d e
secta	s e k t a
sectores	s e k t o r e
secunda	s e k u n d a
seliger	s e l i g e r
semantic	s e m a n t i k
senatores	s e n a t o r e
sentiva	s e n t i v a
septime	s e p t i m e
sever	s e v e r i
show	S o
sine	s i n E
sovietic	s o v i e t i k
spatios	s p a t i o s
sperantia	s p e r a n t i a
stellar	s t e y a r
strato	s t r a t o
subgeneres	s u b g e n e r e
substituite	s u b s t i t u y t
sulco	s u l  o
supervivente	s u p e r v i v e n t e
tabulas	t a b u l a
taxa	t a x a
technologias	t e C n o l o g i a s
tornado	t o r n a d o
touristas	t o u r i s t a s
traduce	tr~ a d u k e
traffico	tr~ a f i k o
traverso	t r a v e r s o
u	u
uncias	u n C i w 3 s
valide	v a l i d e
vegetation	f e g 3 t a t i o n 3
vel	f e l
vestimentos	f e s t i m e n t o s
visitar	v i s i t a r
visitate	v i s i t a t e
vocabulo	v o k a b u l o
voto	v o t o
Albert	l k
Arthur	r t u r
Austria	u s t r e
Aves	f e
Bakunin	a k u n i n
Beatles	E w e L e
Belgica	e l g i k a
Blue	l u e
Book	o k
Celsius	e l s i u s
Certe	e r t e
Ciceron	i u r
Congo	o n g o
Consequentemente	o* s e k e n t E m E n t e
Constantino	o s t a n t i n o
Conte	b u* d a k
Corona	o r o n a
Cure	u r e
Ecce	kh~  e
Ensemble	s e mb~ l e
Fide	d e
Foucault	o u k a u l
Grammy	r a m
Institute	s t i t u t e
Jane	a n e
Kinsey	s u y
Lupin	u p i n
Manuel	a n
Mark	a r
Michel	i C
Microsoft	i k r o
Multes	u l t e
Nascite	n i C y t
Neubronner	u o* o* n 3 q
Nigre	i g r e
Organisation	r g a n i s a t i o n 3
Pakistan	a k i s t a n
Philippinas	h i l i p p i n 3 s
Philippo	h i l i p p o
Pois	w a z
Polo	o l o
Praga	r a g a
Quanto	u a nt~ o
Research	e s a i a dy~ o
Sede	e d e
Street	a
Systema	y s t e m a
Textos	e S o s
Theatre	h e a t r e
Traduction	r a d u k t i o n 3
Vaticano	a t i k a
Venetia	e n e t i a
Vietnam	i e t n a m
Vita	i t a
Wilhelm	i l h e l m
Zag	a g
Zig	i g
absolutemente	a b " s o l u t E m E n t e
accordos	a k k o r d o s
addeva	a d b v a
adopta	a d o p t a
adverbios	a d e r b i E o s
affecta	a f f k t a
aggressive	y g r 3 s a Ng~ e r e
ambiental	a m b i e n t a l
amplitude	a m p l i t u d e
apparentemente	a p p a r e n t E m E n t e
apparite	a p p a r i t e
appartamento	a p p i t a m e n t o
apportava	a p p o r t a v a
approbate	a p p l o b a t e
arabic	a r a b i k
archeologic	a l l a g o l o g i k
argumentos	a r g u m e n t o s
armenio	a r m E n i o
assecurava	n i e n i u r a v a
assisteva	n i i s t e v a
audientia	a u d i e n t i a
ballon	b a l l o n
bonasus	b o n a s u s
canna	k a* n a
cantator	k a nt~ a t o r
cantava	k a nt~ a v a
capturar	k a p t u r a r
cargas	k a g i x a s
celebrava	k e l e b r a v a
centrate	C E n tr~ a t e
ceremonia	C E r E m o n t a 5 i a
cholera	C o l e r a
cinctura	i nC~ t u r a
circumferite	l r u m f e r i t e
cives	i e
clinic	k l i n i k
codices	k o d i k m 3 s
combinationes	k o mb~ i n a t i o n 3 m 3 s
comedias	k o m e dy~ a s
comenciante	k o p i n C i w a n t e
commercialmente	k o m * r i a l m e n t e
communismo	k o m u n i S m o
companiones	k o mp~ a n i o n i
comparate	k o m a r a t e
computation	k o m p u t a t i o n 3
concentrate	r o n C i tr~ a t e
conduce	r o n d u k e
conducer	r o n d u z i r
confession	r o n f e s s i o n
confrontar	r o n f r o n t a r
confusion	r o n f u s i o n
conquirite	r o n ky~ i r i t e
conventiones	r o n f e n t i o n 3 m 3 s
converter	r o n e r t e r
corage	k o r a g e
coronate	k o r o n a t e
cortes	k o r t e
cumulo	k u m u l o
cyclos	ky~ k l o s
damno	d a m
decidite	d e 7 i d i t e
defia	d e f i a
definitiones	d e f i n i t i o n 3 m 3 s
definitive	d e f i n i t i v E
definiva	d e f i n i v a
dentes	d e n t e
deputatos	d e p u t a t o s
destino	d e s t i n o
destruer	d e s t r i a
dextera	d e S e r a
dialogos	d i a l o g o s
digito	d i g i t o
discographic	d i s k o b o ch~ ph~ i k
discuter	d i s k u t e r
divider	d i v i d e r
divideva	d i v i d e v a
durar	d u r a r
educate	e d u k a t e
egyptian	3 dy~ y p t i a n
emotional	e m o t i o n a l
epic	e b i k
equationes	e k i a t i o n 3 m 3 s
erronee	e r u k a i
escappar	e s k a p p a r
estraniero	e s t r a n i e r o
evolvite	e v o l g o y t
exigeva	" i g 3 v a
expectate	" p E kh~ a m e* t a t e
experte	" p e r t e
expone	" p o n e
fabrication	f a b r i k a t i o n 3
facilitar	f a c i l i t a r
facultate	f a k u l t a t e
felice	f e l i k e
finales	f i n a l e
flores	f l o r e
fluido	f l u i d o
folklore	f o l k o r e
formulas	f o r m u l a
forni	f o r n i
fossiles	f o s i l e
fresc	f r L w E
fugir	f u g i r
fundos	f u n d o s
generar	g e n e r a r a
geometric	g e o m E t r i k
goal	g o a l
habilitates	h a b i l i t a t e
harmonia	h a r m o* i a
hasardo	h a s e r d o
hebree	b a s r e
hereditava	h e r e d i t a v a
heterosexual	h e t e r o s E r m a l
historiographia	h i s t o r i o b o ch~ t a b a
hollandese	h o l l a n d e s e
iconic	i k o n i k
immagazinage	i m a z i n a g e
immagazinate	i m a z i n a t e
immense	i m  s e
imposition	i m p o s i t i o n 3
incarcerate	m a u r a t e
incorporava	i n k o r p o r a v a
indicava	i n d i k a v a
indigenas	x e n 3 s
industrias	u z i a s
intensitate	i n t e ns~ i t a t e
interactiones	i n t E r a k t i o n 3 m 3 s
involve	i n v o l v e
julian	x u l i a n
late	l a t e
liga	l i g a
limita	l i m i t a
linear	l i n e a r
listate	l i s t a t e
literalmente	t E r a l m e n t e
litoral	t o r a l
longeve	l o N g e v e
mandato	m a nd~ a t o
marcas	m a* r k a s
membrana	m e mb~ r a n a
messages	m e s s a g a
mesurate	m e s u r a t e
millias	m i l l i a s
miraculos	m i r a k u l o s
monachos	m o n a d o s
mori	m o r i
motto	m o t t o
multos	l t o s
museos	s e o s
music	s i k
musulman	s u l 3 m
mythic	m 3 t i k
narrationes	n a r a t i o n 3 m 3 s
naval	n a v a l
necesse	d e* k a* b 3 s a
neutre	n e u t r e
nomination	n o m i n a t i o n 3
notava	n o t t a v a
occasionalmente	T k a s i o n a l m e n t e
officiero	o f i C y e r o
pacific	p a k i f i k
parentheses	p a r e nt~  e
passages	p a s s a g a
pectore	p e k t o r e
pedophilic	p E d o ph~ i l i k
pellicula	p e ly~ i k u l a
pensatores	p e s a t o r e
perditas	p e o n
persecution	p e r e n i u t i o n 3
philosopho	ph~ i l o s o p h o
pilo	p i l o
pionero	p i o n e r o
pisces	p i s k i s  m 3 s
populose	p o p u l o s e
potential	p o t e n t i a l
potite	p o t i t e
predas	p r e d 3 s
prediction	p r e d i k t i o n 3
prefixate	p r e f i S a t e
preservar	p r e s E r v a r
profunditate	p r o f u nd~ i t a t e
programmatura	p r o g r a m m a t u r a
promitteva	p r o m i t t e v a
promoveva	p r o m o p e m u v a
propaganda	p r o p a g a n d a
proprietarios	p a z r i e t a r i o s
protocollo	p r o t o k o l o
protocollos	p r o t o k o l l o s
proximitate	p r o x i m i t a t e
pullos	p u l l o s
quartieros	k i t a o r o s
quicunque	k i C a u n kw~ i
r	r
radioamatorismo	r a d i o a m a t o r i s m o
rationamento	r a t i o n a m e n t o
recte	r E c t e
reduce	r e d u k e
relationate	r e l a t i o n a t e
remover	r E m o v e r i
rendite	r e n d i t e
reporto	r e p o r t o
resultar	r e s u l t 3 r
reteneva	r e t e n e v a
reuniva	r e u n i v a
revelate	b e b e l a t e
revolutiones	r E f o l u t i o n 3 m 3 s
rhythmos	r h 3 t m o s
rocca	r o k k a
rotation	r o t a t i o n 3
rumine	r u m i n e
salas	s a l a
sanitari	s a n i t a r i
scuto	s k u t o
segmento	s e N m e n t o
seligeva	s e l i g 3 v a
sententia	s e n t e n t i a
separatemente	s e p a r a t E m E n t e
star	s t a r
stratos	s t r a t o s
subjecte	s u by~ E C t e
supernominate	s u p E a n o m i n a t e
sustene	s u s t e n
syntactic	s 3 n t a  7 o t i k
syntaxe	s i m nt~ a x e
tecto	t e k t o
telephono	t e l e f o n o
traductor	tr~ a d u k t o r
transgenere	i t r i s g e n e r e
ubicate	u b i k a t e
ubique	u b i k E
umbra	u mb~ r a
unification	u n i f i k a t i o n 3
unquam	u n ky~ a m
utilisava	u t i l i s a v a
variabiles	v a r i a b i l e
variar	v a r i a r
variation	v a r i a t i o n 3
vendeva	f e n d e v a
viagia	v i a g i a
victimas	v i k t i m a s
vinceva	v i n u v a
violente	v i o l e n t e
vital	v i t a l
voluntari	v o l u n t a r i
Agamemnon	g a m e m n o n
Alcunes	l k u n i
Alcunos	l k u n o s
Alte	l t e
Andross	s
Aristotele	r i S th~ o t e a
Barcelona	a r k e l o n a
Blanc	l a n k o
Bornholm	u r h o l m
Canto	a n t o
Cathedral	a th~ e d r a l
Collegio	o l l e g i o
Columbia	o l u m b i a
Credo	r e d o
Debite	e b i t e
Dido	d o
Dominica	i n i k a
Donald	o n a l
Donatello	o n a t e l o
Ecclesias	kh~  l e s i a s
Engels	g e l
Enrique	n X i t kw~ i
Entertainment	t E r t a i N m E n t
Equalmente	k a l m e n t e
Fiume	i u
Gaio	a y o
Georgia	e o r N i
Gode	o d e
Gregorio	r e g o r i o
Heleno	e l e n o
Hidalgo	i d a l g o
Human	u m a n
Introduction	t r o C u k t i o n 3
Johan	o h a n
Johann	o h a n n
Kazakhstan	t r o kx~ s t a n
Kennedy	3 n b
Libano	i b a
Madagascar	a d a g a s k a r
Membros	e m b a r o s
Menelao	e n e l a o
Messia	e s s i a
Ministerio	i n i S t E r i o
Montreal	o t r e a l
Nam	a m
Nova	o v a
Orleans	r l e a*
Paz	a z
Penelope	e n e l o p e
Pilato	i l a t o
Qui	u i
Russe	u s s e
Sapir	a p i r a
Sayyid	a y i d
Software	o f tw~ a r e
Tempore	e m p o r e
Testes	e s t i
Texas	" 3 s
Top	o p
Trek	r E k
Tudor	u d o r
Tunc	u n
Typicamente	3 p i k a m e n t e
Valle	a l
acceder	a k C E d e r
accentuate	a k k 3 n t u a t e
accordate	a k k o r d a t e
acidos	a c i d o s
acquireva	a k k i r E f a
acquisition	a k k i s i t i o n 3
administrate	a d m i n i s t r a t e
adolescentia	a d o l e s k e n t i a
alcohol	a l k o h o l
algebra	a l g E m r a
aliquando	a l i k a n d o
altera	a l t E r a
anniversario	a n Ng~ e r e n s a r i o
antennas	a n t e
anthropologia	a n t h r o p o r o g i a
aperi	a p e r i
apostolos	a p o s t o l o s
appoiate	a p pw~ a a t e
aquelle	a q u
as	a s
assalto	n i a l t o
astronomos	a s t r o n o m o s
attachate	a t t a C a t e
aun	a u n
autumno	a u t u m
avantages	a b a nt~ a g e
avantia	m a v a n t i a
banca	b a n k a
becco	b e kh~  o
bibliothecas	b i b l i o th~ e k a s
bosco	s k o
cambiamentos	k a m b i a m e n t o s
canta	k a nt~ a
capitano	k a p i t a n o
captivitate	k a p t i b i t a t e
catholicismo	k a t o l i k i s m o
caudas	k a u d 3 s
causante	k a u s a n t e
christiano	C r i s t i a
chronic	C r o n i k
classificar	k l a s s i f i k a r
clientes	k l i e n t e
colonisation	k o l o n i s a t i o n 3
compacte	k o mp~ a k t e
complimento	k o m p l i m e n t o
conditional	r o n d i t i o n a l
confundite	r o n f u nd~ i t e
connecte	r o n d e* k a* b t e
conquirer	r o n ky~ i r e r
conservar	r o n e r v a r
contextos	r o n t e S o s
contrari	r o n t r a r o
conventional	r o n f e n t i o n a l
conversation	r o n e r s a t i o n 3
coperir	k o p e r i r
cordes	k o r b
coronas	k o r o n a s
corporal	k o r p o r a l
correctemente	k o r e k t E m E n t e
cortice	k o r t i k e
crescentia	k r e s k e n t i a
crescite	k r e S e t e
criminal	k l i m i n a l
cruce	k k a 7 k
crusta	k r u s t a
cyclones	ky~ k l a i
debattos	d e b a t o s
declarationes	d e k l a r a t i o n 3 m 3 s
defendeva	d e f e n d e v a
depingite	d e p i N i t e
derivar	d e r e  r
designator	d e s i N n i w a t o
destructive	d e s t r u k t i v E
dextra	d e S
diabolo	d i a b o l o
diagramma	d i a g r a m a
dicte	d i k t e
differentemente	d i f f e r e n t E m E n t e
diffundite	d i f f u nd~ i t e
discute	d i s k u t e
disparition	d i s p a r i t i o n 3
dispositiones	d i s p o s i t i o n 3 m 3 s
disputas	d i s p u t o s
distacca	d i s t a k k a
districtos	d i s t r i C t o s
dominica	b i n i k a
dos	d o s
editores	e d i t o r e
eliger	e l i g e r
equation	e k i a t i o n 3
esque	e s kw~ i
eucaryotes	e u k a g i j o t e
expeditiones	" p e d i t i o n 3 m 3 s
fabricate	f a b i cy~ a t e
facte	f a k t e
fiasco	f i a s k o
fictional	f i k t i o n a l
fixar	f i S a r
flechas	f l e C a s
fora	f o r a
formula	f o r m u l a
fornite	f o r n E i 7
forrage	f o r a g e
fortuna	f o r t u n a
fugiva	f u g w i v a
fundamento	f u nd~ a m e n t o
galleco	g a l l e k o
ganiator	g a n i a t o r
generate	g e n e r a t e
germanos	g e r m a n o s
gigantes	g i g a nt~ m 3 s
governamental	g o b e r n a m e n t a l
grammatical	g r a m m a t i k a l
haver	h a v e r i
hemispherio	h e m i s p i* o
hereditage	h e r e d i t a j
hierarchia	hy~ e r a r C i a
homosexualitate	h o m o s E r m a l i t a t e
horologios	h o r o l o g i o s
identification	d e n t i f i k a t i o n 3
implementation	i m p l E m E n t a t i o n 3
imponeva	i m p o n e v a
imponite	i m p o n i t e
incerte	i n k  t e
incomplete	i n k o m p l e t e
incontrar	i n k o n t r a r a
incontrate	i n k o n tr~ a t e
incorrecte	i n k o r e k t e
inducite	i d u C y t
induction	i d u k t i o n 3
inflation	i n f l a t i o n 3
informal	i n f o r m a l
insular	s u l a r
integremente	i n t e g r E m E n t e
intendeva	i n t e n d e v a
interviews	i n t E r v i e 3
introduce	i n t r o C u k e
inventor	i n f e n t o r
istas	i s t a s
judices	x u d i k m 3 s
juncto	C i x u n C i t o
lacos	l a k o s
lateres	l a t e r e
lexical	l " i k a l
limitationes	l i m i t a t i o n 3 m 3 s
localisate	l o k a l i s a t e
localitate	l o k a l i t a t e
magia	m a g i a
mangia	m a N i
mappas	m a p p a s
martial	m a* r t i a l
mediterranee	m e d i t e r i
meliorava	m e l i o r a v a
metro	m e t r o
modification	m o d i f i k a t i o n 3
molecular	o l k u l a r
monetari	m o n e t a r i
montante	m o* t a n t e
mortos	m o r t o s
mostra	s t r a
mythologic	m 3 t h o l o g i k
naturalistic	n a t u r a l i s t
necessitates	d e* k a* b e s s i t a t e
necuno	n e kw~ n o
nervose	n e r v o s e
norvegian	n o r e N i
notitias	n o t i t i 3 s
obscuritate	o b s k u r i t a t e
octave	o k t a b e
offensive	o f k u b e
offerer	o f e r a r
orchestra	a l l a g s t r a
origina	u r i g i n a
pariete	p a r i e t e
participante	p e r t i k i p a n t e
particula	p e r t i k u l a
passageros	p a s s a g e r o s
patres	p a t r e
patrimonio	p a t r i m o* i o
perde	p e r d e
phantastic	ph~ a nt~ a s t
placiava	p l a y i i a v a
plagia	p l a y i N i
plures	p l u r e
pms	p m
potera	p o t E r a
predecessor	p r e d e k e s  r
preservate	p r e s E r v a t e
prestigio	p r e s t i g i o
primes	p ry~ 8 i m 3 s
privilegios	p r i v i l e g i o s
procede	p r o k e d e
productive	p r o C u k t i v E
professores	p r o f e s  r e
programmatores	p r o g r a m m a t o r e
prole	p r o l e
prophetia	p a z h e t i a
prototypo	p r o  t 3 p o
provate	p r o w a t e
proveniente	p r o w e n t e
purmente	p u s a y m 3 n t e
rata	r a t a
reguardo	r e g u a r d o
remarcabile	r E m a r k a b i l e
requesta	r E k e s t a
requestas	r E k e s t o s
resolvite	r e s o l g o y t
respectar	r e s p E kh~ a m e* t a r
reuni	r e u n i
revolutionari	r E f o l u t i o n a r i
rival	r i w a l
rosate	r o s a t e
russo	r u s
sacerdote	s a k  d o t e
sacramentos	s a q r a m e n t o s
sal	s a l
salute	s a l u t e
sanctos	s a*  t o s
satellites	s a t 3 t e
scepticismo	s k e p t i c a i s m o
sculptura	s k u l p t u r a
selectionate	s e l e k t i o n a t e
semines	s e m i n i
separa	s e p a r a
separava	s e p a r a v a
septentrional	s e p t E nt~ u z i o n a l
sexanta	s e a nt~ a
sexte	s e S
sicut	s i k u t
single	s i N l e
solitari	s o l i t a r i
sonava	s o n a v a
specialistas	s p e k i a l i s t a s
stabilite	s t a b i l i t e
stadios	s t a d i o s
statistica	s t a t i s t i k a
structural	s t r u k t u r a l
suggerite	s u m e r i t e
superar	s u p e r a r a
superate	s u p e r a t e
synonymo	s  m o
tan	t a n
tango	t a n g o
technologic	t e C n o l o g i k
tensiones	t e s i o n i
tenue	t e a
terminar	t E r m i n a r
testimonio	t e s t i m o* i o
touristic	t o u r i s t
traciar	tr~ a i a r
tractamentos	tr~ a k t a m e n t o s
traductores	tr~ a d u k t o r e
transformava	i t r i s f o r m a v a
tumba	t u* b E
uni	u n i
unificate	u n i f i k a t e
uniforme	u n i f o r m e
unir	u n i r
vapor	v a p o r
vehiculos	e i k u l o s
velocitates	v e l o v e l o k i t a t e
vendita	f e n n e n
vengiantia	f e N i  t i a
verme	e r m e
viagiava	v i a g i a v a
viro	v i r o
visitas	v i s i t a s
voluntarios	v o l u n t a r i o s
ya	y a
Aeroporto	e r L o k t o
Aires	i r e
Alba	l b a
Alteremente	l t E r E m E n t e
Alteres	l t e r e
Andersen	d i n e n
Apollo	p o l o
Armstrong	r m u z i m
Arte	r t e
Atlantico	L a n t  o
Auro	u r o
Bismarck	i s r k
Boston	o s t o n
Buddhismo	u d i s m o
Buenos	u e n o s
Bulgaria	u l N a r i a
Carlos	a r l o s
Chicago	h i k a g o
Ci	i
Civil	i v i l
Compania	p a n i a
Corporation	u r p o r a t i o n 3
Creta	r e t a
Cromwell	r o m w e l o
Day	a y
Declaration	e k l a r a t i o n 3
Der	e r
Dewey	a w e
Dictionary	i k t i o n a r
Equus	k u s
Esque	s kw~ i
Football	o t b o l
Gallecia	a ly~ k 3 r i a
Gilbert	i l k
Google	o g l e
Grec	r E C
Groningen	r o n i N 3 n
Ha	a
Hector	e k t o r
Historias	i s t o r i a s
Hogwarts	o gw~ a c
Hollanda	o l l a n d a
Huygens	u y g e n
Indonesia	d o n e s i a
Jan	a n
Jocos	o k o s
Jones	o i
Julia	l i a
Julietta	l i e t t a
Laco	a k o
Lancaster	5 u k a a s t e r e n
Las	a s
Latio	t u o e
Linnaeus	i n t u i u s
Lu	u
Macedonia	a C E d o n i y a
Magazine	a g a z i n e
Magnus	y nd~ u t i a
Manila	a n i l a
Mappa	a p p a
Maurice	a  i cy~ e
Media	e d i a
Minnesota	i n n e s o t a
Naruto	a r u t o
Ni	i
Nicolas	i k o l a
Normandia	o r m a n d i a
North	u r
Olympic	l i m p i k
Pablo	a b l u
Pacioli	a c i o l i
Parolas	a r o l a
Patroclo	a t r o k l o
Pauc	a u
Peru	e r u
Piaget	n o g e t
Piro	i r o
Pythagoras	3 t a g o a s
Recerca	e T E r k a
Republican	e p u b l i k a n
Roger	o g e r
Saturno	a t u r n o
Science	C y e n C i e
Solo	o l o
Sture	t u r e
Taiwan	i r i k
Tractatos	r a k t a t o s
Turchia	u r k u C i a
Uno	n o
Usualmente	s u a l m e n t e
Utah	t a h
Verso	e r s o
White	h i t e
Wikidata	i k i d a t a
Wujek	u h e k
Xenophon	e n o f o n
You	o u
abandonate	a b a n d o n a t e
abundantia	a b u n d a n t i a
abusos	a b u s o s
accentos	a k C E n t o s
accentua	a k k 3 n t u a
accessibile	a k u s s i b i l e
adverbio	a d e r b i E o
affin	a f f i n
alicuno	a l i k u n o
alie	a l i e
alimenta	a l i m e nt~ a
alimentar	a l i m e n t a r
alterate	a l t E r a t e
amante	a m a n t e
amica	a m i k a
anatomic	a n a t o m i
angelo	a n g e l o
annuncia	a n n C i w a
anteriormente	a n t E r i o s a y m 3 n t e
apportar	a p p o r t a r
apportate	a p p o r t a t e
appunctate	a p d o m a t a t e
apte	a p t e
aquatic	a q u a t i k
archaic	a r C a i k
argumento	a r g u m e n t o
articulation	i t i k u l a t i o n 3
assassinato	n i a s s i n a t o
assereva	n i e r e v a
assimilation	n i m i l a t i o n 3
assumer	n i u m a m e
atheismo	a th~ e i s m o
audite	a u d i t e
augmentate	a u k m e n t a t e
aventuras	E b e n t u r a s
biographia	b i o b o ch~ t a b a
biologia	b i o l o g i a
bobina	b o p a n i n a
boxa	b o a
boxer	b o " e a r
brasilianos	b r a s i l i a n o s
cader	k a d e r
calefaction	k a l e f a k t i o n 3
cantatores	k a nt~ a t o r e
cantatrice	k a nt~ a i cy~ e
car	k a r
catalogo	k a t a l o g o
celebra	k e l e b r a
centra	C E n t r a
certemente	C E r t E m E n t e
certo	C E r t o
cessa	k 3 s a
chassatores	C a s s a t o r e
cinquanta	T i n ky~ a nt~ a
civilisationes	i v i l i s a t i o n 3 m 3 s
classifica	k l a s s i f i k a
cliente	k l i e n t e
climatic	k l i m a t i k
cognoscentias	k o g i E 5 o s k e n t i 3 s
collaborava	k o l l a b o r a v a
columnas	k o l u m n 3 s
comedia	k o m e d i a
compara	k o m a r a
competentias	k o m p e t e n t i 3 s
compilate	k o m p i l a t e
completate	k o m p l e t a t e
complir	k o m p l i r
compliva	k o m p l i v a
concedite	r o n C i  t e
condemnation	r o n d e m n a t i o n 3
consentite	r o n e n t i t e
constructiones	k o s t r u k t i o n 3 m 3 s
construe	k o s t r u w e
contatos	r o n t a t o s
continentes	r o n t i n e n t e
continer	r o n t i n 3 q
continuemente	r o n t i n u E m E n t e
contribution	r o n b u t i o n 3
control	r o n t r o l
controlava	r o n t r o l a v a
copula	k o p u l a
corda	k o r d a
coxa	k o a
criticava	k r i t i k a v a
cruciate	k r u C a a t e
culpa	k u l p a
declination	d e k l i n a t i o n 3
defensores	d e f e Th~ o r e
demonstrava	d e m o* s t r a v a
dependentia	d e p e n d e n t i a
designava	d e s i g n a v a
desirate	d e s i r a t r a
dextere	d e S e r e
dialectal	d i a l e k t a l
diaphragma	d i ph~ r a n k i m a
digne	d i N n i s
dignitate	d i g i E 5 i t a t e
diminue	d i m i n u e
diminuer	d i m i n i a
diplomatic	d i p xy~ u 7 7 o t i k
disparite	d i s p a r i t e
distaccate	d i s t a k k a t e
distribuer	d i s t r i b i a
disveloppamentos	d i s v e l o v e l o p p a m e n t o s
divinitate	d i v i n i t a t e
documentari	d o k u m e n t a r i
dollares	d o l l a r e
dono	d o n o
donos	d o n o s
ducite	d u C y t
durabile	d u r a b i l e
educational	e d u k a t i o n a l
elastic	e l a s t
electe	e l e k t e
electron	e l e k tr~ u n
emotiones	e m o t i o n 3 m 3 s
encyclopedia	i n C i S e k l o p e d i a
equalitate	e k i a l i t a t e
equipage	e k i p a g e
erigite	r i g i t e
erosion	e r o s i o n
essayate	e s  y a t e
ethic	e t i k
etiquetta	e t i k i e t t a
etymologic	t Th~ m o l o g i k
excludite	" k l u d i t e
existite	" i s t i t e
experimentation	" p e r i m e n t a t i o n 3
experimentava	" p e r i m e n t a v a
explora	" p l o r a
extremitate	e S a m i t a t e
facilitates	f a c i l i t a t e
falcon	f a l k o n
falleva	f a l l e v a
fame	f a m e
favorite	f a v o r i t e
flexibile	f l " i b i l e
focar	f o k a r
folk	f o l
fornir	f o r n i r
fortalessas	f o r t a l 3 s a 3 s
frigido	f x i d o
fundamentos	f u nd~ a m e n t o s
galaxia	g a l a x i a
gamba	g a m b a
glacial	g l a c i a l
glandulas	g l a nd~ u l a
governa	g o b e r n a
grandemente	g r a n d E m E n t e
grano	g r o
graphic	b o ch~ ph~ i k
gravitate	g r a w i t a t e
gravitational	g r a w i t a t i o n a l
grosse	g r o s s e
hellenistic	h e l l e n i S 7 o t i k
hereditari	h e r e d i t a r i
hindu	h i n d u
historietta	h i s t o r i e t t a
honorari	h o n o r a r o
honores	h o n o r e
hypothetic	h 3 p o t h e t i k
illustrate	i l l u s t r a t e
imperatores	i m p e r a t o r e
implicate	i m p l i k a t e
incarnation	m a n a t i o n 3
infectate	i n f k t a t e
infectiones	i n f k t i o n 3 m 3 s
infinitivo	i n f i n i t i b o
influentiar	i n f l u e n t i a r
inimico	i n i m i  o
insectos	s e k t o s
instabilitate	s t a b i l i t a t e
instantanee	s t a n t a n 3 s 3 m e
insulina	s l i n a
intentiones	i n t e n t i o n 3 m 3 s
interpreta	i n t E r p r e t a
interpretar	i n t E r p r e t a r
intervallo	i n t E r v a l o
inundation	i n u nd~ a t i o n 3
inventava	i n f e n t a v a
jardin	h a r i a n
judicate	x u d i k a t e
largor	l a r g o r
lequales	l E k a l e
lettera	l e t t E r a
liturgic	t u r g i k
locationes	l o k a t i o n 3 m 3 s
loyal	l o y a l
mandate	m a nd~ a t e
mangiate	m a N i a t e
manifestava	n i f i S t a v a
manipulation	n i p u l a t i o n 3
manuscripto	m a n u s k r i p t o
mares	m a r e
margine	m a* r g i n e
marineros	m a r i n e r o s
marito	m a r i t o
mata	m a t a
materias	m a t e r i a s
medalia	m e d a l i a
medievo	m e d i e b o
meliorate	m e l i o r a t e
mer	m e r
mesurar	m e s u r a r
mina	m i n a
minas	m i n 3 s
monastic	m o n a s t
morphologia	m o r f o l o g i a
municipios	m u n i C i p i o s
mutual	m u t u a l
mystic	m 3 s t
ne	n e
nervos	n e r v o s
nodos	n o d o s
nominal	n o m i n a l
normanne	n o r m a n n e
normative	n o r m a t i v E
notabilemente	n o t t a b i l E m E n t e
obedientia	o b e d i e n t i a
obvie	o b v i e
oceanic	T E a n i k
offerite	o f e r i t e
omaso	t a s o
opportunitate	o p p o r t u n i t a t e
orange	o r a N a
oration	o r a t i o n 3
organisava	u r g a n i s a v a
originari	u r i g i n a r i
originate	u r i g i n a t e
oves	o p e
pagate	p a g a t e
pannello	p a n n e l o
parietes	p a r i e t e
participate	p e r t i k i p a t e
partisanos	p e r t i s a n o s
patente	p a t e n t e
paupere	p a u p e r e
periodico	p e r i o d i k o
personalitates	p e r s o n a l i t a t e
pesa	p e s a
pete	p e t e
petroglyphos	p e t r o g o ly~ f o s
physicamente	ph~ i k a m e n t e
pisca	p i s k i s  a
plana	p l a n a
politicamente	p o l i t i k a m e n t e
portraits	p o r tr~ a i c
posseder	p o s e d e r
prece	p r e k e
precisemente	p r E c i s E m E n t e
predecessores	p r e d e k e s  r e
predication	p r e d i k a t i o n 3
prestigiose	p r e s t i g i o s e
prevention	p b e b e n t i o n 3
priones	p r i o n i
productivitate	p r o C u k t i b i t a t e
prohibition	p r o h i b i t i o n 3
promissa	p r o m i s s a
pronuncia	p r o n u n C i w a
proportion	p r L o k t i o n 3
proportiones	p r L o k t i o n 3 m 3 s
propriemente	p a z r i E m E n t e
psychiatria	p a C i a t r i a
pulmonar	p u l m o n a r
qualificate	k a l i f i k a t e
quante	k a n t e
quarto	k i t o
rangos	r a N o s
ratto	r a t t o
receptas	r E C E p t o s
recognoscibile	r E c o g Ng ~ o n o 8 i d o b i
recommenda	r E c o m e n d a
recursos	r E C u r s o s
reflexion	r e f l " i o n
reger	r e  r
registros	r e g i s t r o s
regite	r e g i t e
rejection	r e h e k t i o n 3
relievo	r e l i e b o
repasto	r e p a s t o
republicas	r e p u b l i k a s
reside	r e s i d e
restante	r e s t a n t e
retirar	r e t i r a r a
retirate	r e t i r a t e
rigide	x i d e
roccas	r o k a s a
ronde	r o nd~ e
rota	r o t a
rotante	r o t a n t e
ruptura	n i n t u r a
sacrificios	s a q  i o s
scenario	s k e n a r i o
schemas	S E m a s i
segmentos	s e N m e n t o s
sentir	s e n o x e l
separar	s e p a r a r
servitores	s e r v i t o r e
sexos	s e S o s
sexualmente	s e m a l m e n t e
signala	s i g n a l a
silva	s i l a a
similaritates	s i m i l a r i t a t e
simultanee	S i m u l t a n 3 s 3 m e
situa	s i t u a
slavos	s l a v o s
soveranitate	s o w e r a n i t a t e
stadio	s t a d i o
standardisate	s t a n r d i s a t e
statistic	s t a t i s t
statuas	s t a t u a s
subinde	s u b i d e
subjectos	s u by~ E C t o s
supertoto	s u p e r t o t o
supervivite	s u p e r v i v i t e
supportava	s u p p o r t a v a
suppression	s u p p r e s s i o n
surprisa	s u r p r i s a
synthetic	s i m nt~  7 o t i k
tagalog	t a g a l o
tales	t a l e
tardive	t a r d i v E
tempos	t e m p o s
terminationes	t E r m i n a t i o n 3 m 3 s
testamento	t e s t a m e n t o
textual	t e S u a l
titular	t i t u l a r
trainamento	tr~ a i n a m e n t o
transmitter	i t r i s m i t t e r
triangulo	t r i a N g u l o
tribo	b o
tubos	t u b o s
und	u n d
usabile	u s a b i l e
validitate	v a l i d i t a t e
veniente	f e n i e n t e
venita	f e n i t a
vicinos	v i k i n o s
vincite	v i n C i w a
viros	v i r o s
