kan	k a n
fi	f i
hin	h i n
akka	a k
isaa	i s a
ture	t u r e
kana	k a n a
yoo	y o
tokko	t o k k o
waan	w a
yeroo	y e r o
keessa	k e 3 s a
keessatti	k e 3 s a E t
itti	i t t i
gara	g a r a
koo	k o
irratti	i r a t t i
dha	d a
kun	kw~ n
jiru	h i r u
keessaa	k e 3 s a a
bara	b a r a
nama	n a m a
booda	d a
na	n a
isa	i s a
ni	n i
irraa	i r a
mana	m a n a
qabu	q a b u
garuu	g a r u
qaba	q a b a
irra	i r a
osoo	o s o
ishee	i S e
hanga	h a n g a
malee	m a l e
immoo	i m m o
natti	n a t
jira	h i r a
inni	i N
bakka	b a k
isaanii	i s a n i
Yeroo	e r o
keenya	k e n y a
wal	w a l
Oromoo	r o m o
kunis	k u n i s
adda	a d a 7
sana	s a n a
baayyee	b a y i
walitti	w a l i t t i
jedhu	h e d u
guddaa	g u d a
ykn	y k n
isaan	i s a
wajjin	w a i n
jedhamu	h e d a m u
Piiter	i t e r
hunda	h u nd~ a
karaa	k a r a
Bara	a r a
biraa	b i r a
hojii	h o h i
kutaa	k u t a
kanaa	k a n a
afaan	a f a
erga	e r g a
ol	o l
guyyaa	g u y y a
waliin	w a r i i n
ani	a n i
jedhee	h e d S i
qofa	q o f a
haa	h a
naa	n a
amma	a m a
biyya	b 3 ty~ a
Garuu	a r u
naannoo	n a n n o
turan	t u r a
akkan	a k k a n
immo	i m m o
sitti	s i t t i
kanaan	k a n a
waggaa	w a m a
lafa	l a f a
Aanaa	a n a
kessatti	k e s s a t t i
maqaa	m a q a
argamu	a r g a m u
kessa	k 3 s a
akkasumas	a k a s u m a s
jechuun	h e C u n
nu	n u
sadarkaa	s a d a r k a
Kana	a n a
Akka	k
lama	l a m a
ummata	l u m m a t a
dura	d u r a
jechuu	h e C u
miti	m i t i
warra	w a r a
ammoo	a m m o
maal	m a l
Afrikaa	f r i k a
akkuma	a k k u m a
Kan	a n
ittiin	i t
gadi	g a d i
si	s i
Afaan	f a
Kiitii	i t i
abbaa	a b " b a
kuni	k u n i
addaa	a d d a
namoota	n a m o t a
jedhama	h e d a m a
kee	k e
namni	n a m n i
nan	n a n
harka	h a r
jalqabaa	y a q a b a
humna	h u m n a
taane	t a n e
Faandaan	a nd~ a
iddoo	i d a i s o
haala	h a l a
jalqabe	y a q a b e
jiran	h i r i
gosa	g o s a
yeroon	y e r o
Kunis	u n i s
ofii	o f i
bishaan	b i S a
Kanaaf	a n a a f
isaas	i s a
iyyuu	i  u
mataa	m a t a
Haa	a
tokkoo	t o k nk ~ o b a
aanaa	a n a
addunyaa	a d n y a
dandeenye	d a nd ~ e n y e
jedhe	h e d e
walii	w a r i
garaa	g a r a
kanin	k a n i n
kiyya	k i  a
siin	s i i n
waraanaa	w a r a n a
sababa	s a b a b a e
jalqaba	y a q a b a
jecha	h e C a
qaban	q a b a n
magaalaa	a a l a
hafe	a f e
kanatti	k a n a t
Waan	a n
Amma	m a
illee	i l l e
lamaan	l a m a
beeku	b e k u
godhe	g o d e
seenaa	s e n a
sun	s u n
Obbo	b w e
hunduu	h u n t u
jireenya	h i r e n y a
mootummaa	o t u m m a
odoo	o d o
sirna	s i r a n a
yaada	y a a d a
fuula	f u L
jala	y a l a
kiitii	k i t i
obbo	o b b o
ti	t i
argama	a r g a m a
dhugaa	T u g a
kanan	k a n a n
waraana	w a r a a n a
Maargoot	a r g o t
dhufe	T u f e
naan	n a
namoonni	n a m o  n i
yokan	y o k a n
bira	b 3 r a
gaarii	g a r i
qabne	q a b n e
gidduu	g i d t u
jiruu	h i r u
namaa	n a m a
too	t o
Eeyyee	e y i
Teslaan	e s  a n
jedhamee	h e d a m i
darbee	d a r k e
dhibee	T i b e
addaan	a d a n
duukaa	d u u k a
haaraa	h a r a
jedha	h e d a
Sana	a n a
hedduu	h e t t u
qabdu	q a b d u
biratti	b 3 r E t
gaafa	g a a f a n a
icciitii	i k i i t i
ijoollee	i j o l l e
ishii	i S i
Addunyaa	d n y a
hundi	h u nd~ i
keenyaa	k e n y a
turre	t u r
xiqqoo	S i k pw~ o
ija	i y a N u
rakkoo	r a k nk ~ o b a
waanti	w a i n t i N
Oromoon	r o m o
argate	a r g a t e
guddaan	g u d a n
jalaa	y a l a
kanaaf	k a n a a f
meeshaa	m e k 3 S a
miira	m i r a
qaama	q a m a
turte	t u r t e
Abbaa	b w a
aadaa	k i m a t o a
fakkaata	f a k a t a
jaarraa	y a r a
muraasa	m u r a a s a
Gadaa	a d a
godhu	g o d u
jalatti	y a l a t t i
sii	s i
Erga	r g a
isheen	i S e n
waanan	w a n a n
dhufu	T u w u
kaasee	k a s E r e
qabdi	q a b d i
tokkoon	t o k o n
Egaa	g a
Mana	a n a
guutuu	g u t u
maatii	m a t a
manaa	m a n a
qabsoo	q a j o
barnoota	b a r n o t a
bayye	b a y
caalaa	k a a l a
duraa	d u r a
hidhaa	i d a
jedhanii	h e d a n i
ammaa	a m m a
ati	a t i
irraan	o r a
sammuu	s a m u
Akkuma	k k u m a
akkam	a k a m
fakkaatu	f a k a t u
himuu	h i m u
nyaata	5 a a t a
seelii	s e l i
Kun	u n
beeka	b E k
lafaa	l a f a g a
lammaffaa	l a m f a
sanaa	s a n a
uummata	u m m a t a
Yoo	o
gochuu	g o C u
kudha	k u d a
Namoonni	a m o  n i
achi	a C i
akkasii	a k a s i
gidduutti	g i d a u t a
godha	g o d a
wayita	w a y i t a
Aanaan	a n a
Ani	n i
Inni	n i
Sababiin	a b a b i
aabbaa	a mp~  a
isaatti	i s a t t i
namatti	n a m a t t i
carraa	k a r a
dhimma	T i m a
jedhamuun	h e d a m u n
jedheen	h e d e n
jettee	h e t t i 3 n
amantii	a m a n t i
isaani	i s a n i
kompitara	m i p i t a r a
nutti	n u t t i
sanatti	s a n a t
tokkotti	t o k k o t t i
warri	w a r i
Akkasumas	k k a s u m a s
dhufee	T u f e
aadde	k i m a t o d e
barumsaa	b a r u m s a
haadha	h a a d a
kamiyyuu	k a m i  u
sagantaa	s a g a nt~ a
barbaadu	b a r b a a d u
darbe	d a r b e
dheeraa	dh~ e r a
fayyadamuun	f a y a d a m u n
hojjatu	h o h j a t u
kitaaba	k i t 3 a b a
osoon	o s o
seera	s e r a
Guyyaa	u y y a
akkas	a k
deeme	d e e m e
jette	h e t
kaan	k a n
meetira	m e e t i r a
nuu	n u
seete	s e e t e
siif	s i i f i
sirriitti	s i r i t t i
takkaa	t a k k a
argaman	a r g a m a n
lakkoofsa	l a k o f s a
sarkiyuutii	s a r N z u t i
turee	t u r e
yoon	y o n
Maqaan	a q a
dhiiga	T i g
dirqama	d i r q a m a
himu	h i m u
Aadde	a d e
Karaa	a r a
Waraana	a r a a n a
dhukkuba	T u k kh~ 3 7 b a
durii	d u r i 7 i
uume	u m e
barumsa	b a r u m s a
beekkama	b e n y k a m a
duraan	d u r a
fedhii	f e d i
garee	g a r e
jirru	h i r u
jirutti	h i r u t t i
meeshaalee	m e k 3 S a 7 m a
sagalee	s a g a l e
yookaan	y o k a
Maal	a l
Namni	a m n i
caala	k a a l a
dhufan	T u n i
jiraatu	h i r a r 3 s i g i
kkf	k k f
naaf	n a f
qorannoo	q o r a n n o
shan	S a n
walakkaa	w a l a k k a
Oromiyaa	r o m i y a
cimaa	T i m a
ilma	i l m a
jirti	h i r t i
kooti	o t i
sadii	s a d i
sanyii	s a 5 i
taatu	t a t u
yaalii	y a l i
Dhugaa	h u g a
ajaja	s u a
amala	a m a l a
ammas	a m m a s
barnootaa	b a r n o t a
dhaloota	dh~ a l o t a
dubbii	d u b e k u i
mootummaan	o t u m m a
nuti	n u t i
qabatee	q a b a t e n
taate	t a t e
uffata	u f a t a
Waggaa	y g a
Yuurooppi	u r o p p i
arge	a r g e
baayyeen	b a y e n
bifa	b i f a
deemu	d e e m u
ergaa	e r g a
gochaa	g o C a
godhee	g o d S i
hime	h i m e
isaaf	i s a a f
ofitti	o f i t t i
tajaajila	t a h a x i l a
Itti	t t i
Yeroon	 o n
and	a n d
dhufeenya	T u f e n y a
gochuun	g o C u n
harmee	h a r m i
jiraachuu	h i r a C u
kanas	k a n a s
mucaa	m u k a
waantota	w a n t o t a
Yuunivarsiitii	u n i v a r  i t i
akkamitti	a k k a m i t t i
fudhatee	f u d a t e n
gad	g a d
gale	g a l e
ganna	g a b a n n a
hundaa	h u nd~ a
ilaalcha	i l a l C a
jedhan	h e d a n
karantii	k a r a n t i
kootti	k o t t i
laga	l a g a
mala	m a l a
malees	m a l e s
qabata	q a b a t a
wanti	w a n t i
Abbaan	b w a
Fakkeenyaaf	a k e n y a a f
Haala	a l a
aabbaan	a mp~  a n
ala	a l a
ammayyaa	a m m a y y a
dhalate	dh~ a l a t e
gaaffii	g a f i
haga	h a g a
harmeen	h a r m e n
kanarratti	k a n a r a t t i
kompitaraa	m i p i t a r a
qabaachuu	q a b a C u
saba	s a b a
the	th~ e
wayii	w a y i
Innis	a n n i s
Maraatoonii	a r a a t o " w i
Piiteriin	i t E r i i n
baatirii	b a t i r i
barsiisaa	b a r  i s a
dhumaa	T u m a
eenyu	e n y u
fayyadamu	f a y a d a m u
gogaa	g o g a
kuma	k u m a
maaltu	m a l t u
miirri	m e N w E r i
mirga	m i r g a
olii	o l i
otoo	k o t o
qofaa	q o f a g a
tiyya	i y a
xiqqaate	S i k k " a t e
Magaalaa	a g a a l a
afur	a f u r
argamti	a r g a m d i
bahee	b a h i*
dhiibbaa	T i g b b a
dhuma	T u m a
dorgommii	d o r g o m m i
jalqabu	y a q a b u
miliyoona	m i l i y o r o o n a
miseensa	m i s e n s a
oduu	o t u
qabuu	q a b u
xiqqaa	S i k l u k a
yaaliin	y a l i i n
Gara	a r a
Hanga	a N a
Kuush	u S
Namoota	a m o t a
anaa	a n a
as	a s
balaa	b a l a
dubartii	d u b i t i
gala	g a l a
gargaarsa	g a r t u l s a
ilaaluu	i l a l u
jalqabee	y a q a b e
jedhaman	h e d a m a n
maqaan	m a q a
olaanaa	o l 3 b a n a
onnee	o S i
tti	t t i
wantoota	w a n t o t a
yerro	y e r o
Mariin	a ry~ i n
barate	b a r a t e
duubatti	d u u b a t t i
fufe	f u f e
gudda	g u d
hafan	a f a n
harkaa	h a r k a
hima	h i m a
hojjatame	h o h j a t a m e
ifa	f a
jalqaban	y a q a b a n
n	n
Isa	s a
abbaan	mp~  a n
baayyen	b a y e n
beekkamu	b e n y k a m u
daangaa	d a a N a
dabalatee	d a b a l a t e n
deebiin	d e E b 3 i n
dhufa	T u a n a
dhufuu	T u f u
fayyadaman	f a y a d a m a n
galgala	g a l g a l a
gammachuu	g a m m a u
godhame	g o d a m e
hagam	h a x a m
hundumaa	h u nd~ u m a
jechuudha	h e C u d a
jireenyaa	h i r e n y a
keessoo	k e e s  o
km	k m
kunii	k u n i
maaliif	m a l i i f i
qabee	q a b e
qarqara	q a r q a r a
qilleensa	q i l l e n s a
qillensa	q i l l e s a
qulqulluu	k q u L u
sochii	s o C i
yaadu	y a a d u
Dubbii	u b e k u i
anis	a n i s
argatu	a r g a t u
baayyinaan	b a y i n a n
bahaa	b a h a
dhibeen	T i b e n
dubbatu	d u b b a t u
ergan	e r g a n
galee	g a l e
gossa	g o s a
hojjachuu	h o x a C u
jedhame	h e d a m e
jedhamuu	h e d a m u
jirra	h i r a
lubbuu	l u b u
nagaa	n a g a
qabame	q a b a m e
seene	s e n e
sirrii	s i r i
ummatta	l u m m a t t a
umurii	u m u r i 7 i
waa	w a
Laga	a g a
Warri	a r i
amana	a m a n a
ana	a n a
baate	b a t e
barbaada	b a r b a y a
beekama	b e k a m a
biroo	b 3 r o
biyyaa	b 3 ty~ a
biyyoota	b 3 ty~ o t a
deemee	d e E m E e
dhiigaa	T i g  a
eenyummaa	e n y u m m a
galaa	g a l a
galu	g a l u
gochuuf	g o C u f
godina	g o d i n a
hamaa	h a m a
jiraatan	h i r a a t a n
kanneen	k a n n e n
lamaa	l a m a
lubbuun	l u b u n
olitti	o l i t t i
takka	t a k
tiraanzisterii	t i r a n z i S t E r i
umrii	u m r i
xumure	S u m u r e
yaaduu	y a t u
Bakka	a k
Kutaa	u t a
Olompiikii	l o f u k T i
aangoo	a N o
afuura	a f u r 3
ammaatti	a m E t
barbaachisaa	b a r b a C i s a
bilisa	b i l i s a
buufata	b u f a t a
deebii	d e e b i
fayyadamuu	f a y a d a m u
fudhate	f u d a t e
gadii	g a d i
gahu	g a h u
galatti	g a l a t t i
guutuutti	g u t u t a
haalli	h a u r i
hedduun	h e t b a d u n
hundaaf	h u nd~ a a f
isaati	i s a t i
jalqabaaf	y a q a b a a f
jechi	h e C i
jedhamutti	h e d a t i
jiraachaa	h i r a C a
marsaa	m a* r s a
mata	m a t a
muraasni	m u r a a s n i l
ogummaa	o g m m a
qabanii	q a b a n i
qubee	k G e
taanaan	t a n a
waraanni	w a r a n i
Anis	n i s
Finfinnee	i n f e f i n i
Isaan	s a n a
Kireeler	i r e e l e r
Koloneel	o l o n i e l
Mootummaa	o t u m m a
Oliiqaa	l i q a l u k a
Qananiisaan	a n a n i s a n a
Teslaa	e s  a
barreeffama	b a r h r e f a m a
barreesse	b a r  3 s a
beekkamaa	b e n y k a m a
biraan	b i r a
deemuu	d e e m u
dhabuu	dh~ a b u
dhiisuu	T i g s u
durbaa	d u r b a
gama	g a m a
guddate	g u d a t e
hamma	h a m a
ifatti	f E t
iin	i n
isaanis	i s a n i s
jechoota	h e C o t a
kompitarri	m i p i t a r i
laata	l a t a
mooraa	m o r a
qaamaa	q a m a
qawwee	q a w a C a
saffisa	s a f a
san	s a n
tokkoyyuu	t o k k o y y u
Agarii	g a r i
Arsii	r s i
Dr	r
anniisaa	a n n i s a
barreessuu	b a r h r e 7 u
biraatti	b 3 r a r 3 s i g t i
damee	d a m i
fishiinii	f i S i i n i
gaazii	g a z i
gabaabaa	g a b a b a
guddina	g u d i n a
hawaasa	h a w a a s a
hojjate	h o h j a t e
jijjiirama	j i j b i r a m a
mootii	o t i
nuun	n u n
saayinsii	s a i  s i
sanaan	s a n a
seenee	s e n i
uumuu	u m u
vaayiresii	v a y i r e s i
yookan	y o k a n
Aabbaan	mp~  a n
Hayila	a y i l a
Kaleessa	a l e 3 s a
abdii	a b " d i
addaatti	a d a t t i
agarsiisa	a g a r S i s a
alaa	a l a
dubartoota	d u b i t o t a
dubbata	d u b b a t a
faa	f a
fakkaatiin	f a k
fudhachuu	f u d a C u
ganama	g a n a m a
godhan	g o d a n
hojiirra	h o h i r a
ibsu	i b s u
isaaniif	i s a n i i f i
isaanitti	i s a n i t t i
kanarraa	k a n a r a
kanuma	k a n u m a
kenna	k e n n a
kilometers	k i l 3 e t e r
kolonii	k o l o n i
oole	o l e
parsentii	p i e n t i
qabate	q a b a t e
qabatu	q a b a t u
qabna	q a b n a
qabuuf	q a b u f n a
ummataa	l u m m a t a
voolteejii	v o l % t e y i
yaadannoo	y a a d a n o
yookiin	y o k i i n
Abbabaan	b w a b a n
Haalli	a u r i
Jeneraal	e n e r a l
Waraanni	a r a n i
agarsiisu	a g a r  i s u
armaan	a r m a
asii	a s i
baha	b a h a
bahan	b a h a n
balbala	b a l b a l a
barachuu	b a r a C u
barbaachisu	b a r b a C i s u
beekne	b e n y n e
bulchiinsa	l C i s a
dafee	d a f i
dandeettii	d a nd ~ e th~ t i
deeman	d e 3 m a n
dhiira	T i g r a
dhiiraa	T i g r a
dijitaalaa	d i j i t a a l a
dubbachuuf	d u b b a z u r f n a
eegale	e x a l e
elektirikii	e l e k t i r i g i
fudhatama	f u d a t a m a
garba	g a r b a
gita	g i t a
guyyoota	g u y n 3 m a 7 a
halkan	h a l u m
hojiin	h o h 3 nd~ a n
hojjachaa	h o x a C a
ibolaa	i b o l a
kennu	k e n t u
kuusaa	k u s a
lamatti	l a m a t t i
mallattoo	m a l l a t o
mirgaa	m i r g a
namicha	n a m i T a
nyaataa	5 a t a
odeeffannoo	o d e f a* n o
ofirraa	o f i r a
oolu	o l u
qabeenya	q a b e n y a
qabnu	q a b n u
qabxii	q a b n i
square	s k a r e
Ameerikaa	m e e r i k a
Biriiten	i r i t e n
Boodarra	o r a
Caamsaa	a m s a
Dargii	a r g i
Godina	o d i n a
Kuni	u n i
Meeppeen	e p p e n
Sheek	h e k
Tarii	a r i
The	e
antiraaksii	a n t i r a k s i
baaxii	b a n i
bahe	b a e
bahuu	b a h u
barattoota	b a r a t o t a
beekamu	b e k a m u
bilisummaa	b i l i s u m m a
boodarra	b o r a
deema	d e e m a
deemuun	d e e m u n
fayyadama	f a y a d a m a
gahaa	g a h a
galuu	g a l u
guutummaa	g u t u m m a
hojjatan	h o h j a t a n
hoo	h o
in	i n
innis	i n n i s
isheef	i S e f
kaanii	k a n i
kabaja	k a b a h a
kallattii	k a l a t t i
kenne	k e n n e
kennuu	k e n n u
kessaa	k e s s a
kudhan	k u d a n
loon	l o n
lubbu	l u b b u
mara	m a r a
qabamee	q a b a m i
qofatu	q o f a t u
siinqee	s i E e
siyaasaa	s i y a a s a
suuta	s u t a
tasa	t a s a
tasaa	t a s a
tolu	t o l u
ummanni	l u m m a n i
wagga	w a g g a
ABOn	n
Firaansi	i r a  s i
Harmeen	a r m e n
Jalqaba	a q a b a
Mosee	o s E r e
Nama	a m a
Osoo	s o
Piyeer	i y e r
Roontigan	o t i g a n
Shaampiyoonaa	h a m p i y o n a
Waanti	a n t i
aansee	a s E r e
afaanii	a f a n i
akkamii	a k k a m i
alatti	a l a t t i
argachuu	a r g a C u
argamtu	a r g a m t u
baasu	b a s u
baatee	b a t i 3 n
ballina	b a l l i n a
barbaade	b a r b a r 3 s 3 r e
baruumsaa	b a r u m s a
biiroo	b i r o
dheeraaf	dh~ e r a a f
dhuunfaa	T u X f a g a
diimaa	d i i m a
fakkii	f a k i
fidu	f i d u
gargaara	g a r t u l u
goota	g o t a
guddoo	g u d o
ilmaan	i l m o
jaalala	y a a l a l a
jirre	h i r
jirtu	h i r t u
keessan	k e 3 s a
keessattis	k e 3 s a a t t i s
kennaa	k e a
kibba	k i b b a
kuufannoo	k u f a b a n n o
lammii	l a m m i
mitii	g i v i
mormii	m o r m i
qabamu	q a b a m u
qarshii	q o m i 7 S i
raadiyoo	r a a d i y o
sirni	s i r a n i
tokkoffa	t o k k o f a
torba	t o r b a
warraa	w a r a
yoomillee	y o m i l l e
Ammas	m m a s
Gaafa	a a f a n a
Haaluma	a l u m a
Hoolaandi	o l a nd~ i
Isaanis	s a n i s
Maalumaafuu	a l u m a a f u
Maccaa	a k k a
Marii	a r i
Poorchugaal	o r C u g a l
Sababa	a b a b a e
Waaqayyo	a q a y y o
aartii	a i t i
achii	a C i
achuma	a C u m a
adunya	a d u 5 a
amantaa	a m a n t a
argatan	a r g a t a n
argee	a r  e
ayyaana	a y a a n a
biyyotta	b i  o th~ a
boodas	d 3 s
caalu	k a l u
darbuu	d a r u
dhagahame	d a g a h a m e
dhibba	T i b b a
dubbachuu	d u b b a C u
dubbate	d u b b a t e
dubbisuu	d u b t u
duraatti	d u r a E t
eegaa	e x a
eessa	e 3 s a
fayyaa	f a y y a
gaafate	g a f a t e
gargar	g a r g a r
ibsa	i b s a
ifaa	f a g a
jedhamti	h e d a m d i
jedhuun	h e d u n
jettu	h e t u
kamiiyyuu	k a m i E 5 3 ty~ u
konkolaataa	k o nk ~ o b l a t a
koon	k o n
loltoota	l o l t o t a
magaala	a a l a
narra	n a r a
niwuukilaaraa	n i w u k i l a r a
ofiin	o f u i n
qabuun	q a b u n
qodaa	q o d a
qooda	q d a
saddeet	s a d a
taatee	t a t e n
tokkoffaa	t o k k o f a
tooftaa	o f t a
torban	t o r b a n
tureef	t u h r e f
ulfaataa	u l y a t a
uuma	u m a
uummanni	u m m a n i
wanta	w a nt~ a
yaadaa	y a a d a
Baalee	a e* e
Bilisummaa	i l i s u m m a
Garba	a r b a
Hojii	o h i
Maaliif	a l i i f i
Magaalaan	a g a a l a
Tulluu	u L u
Walumaa	a l u m a
a	a
akkana	a k k a n a
akkasuma	a k a s u m a
argitee	a r g i t e n
baasee	b a s E r e
barruu	b a r u k
bineensota	b i t t e Th~ o t a
biyyatti	b 3 ty~ E t
boombii	b o mb~ i
caalaatti	k a a l a t t i
dabarsu	d a b a r s u
dachaa	d a C a
darbu	d a r b u
deemaa	d e e m a
dhagahamu	d a g a h a m u
dhiigni	T i g  n i
dhiisee	T i g s E r e
fiyuuzyinii	f i z u z i n i
fudhatu	f u d a t u
fuudhee	f u d S i
guddachaa	g u d C a
gurguddaa	g u r g u d a
guutummaan	g u t u
guyyaan	g u y y a
hangan	h a N a n
ijoollummaa	i j o l N a l u m m a
ilaaluun	i l a t " u m i
irraatti	i r a E t
ittin	i t t i n
jedhuu	h e d u
jennee	h e i
kenname	k e m e
kitaabota	k i t a b o b o t a
lola	l o l a
lolaa	l o l a
maashinii	i n e i 7 i  i n i
mudate	r u g o t e
narratti	n a r a t t i
qabaatu	q a b a r 3 s i g i
qabachuu	q a b a C u
qabaman	q a b a m a n
raajii	r a x i
sirba	s i r a b a
tahuu	h i
tokkoof	t o k S
turu	t u r u
waanin	w a n i n
waldaa	w a l d a
xalayaa	S a l a y a
yaalaa	y a a l a
yommuu	y o m u
Adda	d a 7
Baatiriin	a t i r i i n
Dhuguman	h u g u m a n
Gadaan	a d a
Haroon	a r o
Jechi	e T i
Kitaaba	i t a a b a
Meeppee	e p p e r u
Naannoo	a n n o
Naazii	a L i
Raashiyaa	a S i y a
Sababni	a b a b n i
Ummata	m m a t a
aanee	a i
achitti	a C i t i
adii	a d i
argame	a r g a m e
argatte	a r g a t t e
arguu	a r g u
asattoo	a s a t o
bakki	b a k k i
beekta	b e n y t a
boqonnaa	b o x o a
bulchaa	l C a
daldalaa	d a l d a l a
duree	d u r e
gaafatiin	g a f a t i s
gahe	g a e
galle	g a l
galtee	g a l t e n
gargaaruu	g a r g a r u
gidiraa	g i d i r a c i
godhamu	g o d a m u
gurguddoo	g u r g u d o
haati	h a t i
hafeen	a f e n
hafne	a f n e
halluu	h a l u
humnaa	h u m n a
ilaalu	i l a l u
ishe	i S
jedhamtu	h e d a m t u
jiraata	h i r a a t a
jiranii	h i r a n i
kiyyaa	k i  a
kootii	k o t i
maatiin	m a t a
manni	n i
miidhaa	m e N w E 8 a
nafxanyaa	n a f a 5 a
nuuf	n u f n a
per	p e r
seena	s e n a
shanii	S a n i
sodaa	s o d a
sodaan	s o d a
taasise	t a s i s e
tahe	t a e
tajaajilaa	t a h a x i l a
tajaajilu	t a h a x i l u
tarii	t a r i
tola	t o l a
umriin	u m ry~ i n
uummataa	u m m a t a
waanta	w a a nt~ a
xixiqqoo	x i x i k pw~ o
Dhihaa	h i h a
Duusel	u s
Guyyaan	u y y a
Humna	u m n a
Jimmaa	i m m a
Kompitaroonni	i m p i t a t o n u N
Laatinii	a t i n i
Mahaammad	a h a m d i b
Mee	e
Mootummaan	o t u m m a
Naayil	a y i l
Oliiqaan	l i i k " a n
Si	i
Taayitaa	a y i t a
Ummanni	m m a n i
Waaqni	a q o n i
Walakkaa	a l a k k a
Xaaliyaanii	a l i y a n i
ajajaa	s u gy~ a
akkamiin	a k k a m i b
amanu	a m a n u
argu	3 y
barachaa	b a r a C a
bare	b a r e
barreeffame	b a r h r e f a m e
birra	b 3 r a
bittaa	b i t a
dabalataa	d a b a l a t a
dabarse	d a b a r s e
dabarsuu	d a b a r S u
darban	d a r b a n
dhaaba	T a g a X a b a
dhagahama	d a g a h a m a
diina	d i i n a
diinagdee	d i i n a g d E r e
dubbatama	d u b b a t a m a
faayidaa	f a y i d a
fayyadame	f a y a d a m e
fii	f i
foon	f o n
gatii	g a t i
guddicha	g u d i T a
hafu	a f u
herregaa	h e r e g a
horii	h o r i
ibsuuf	i b s u f
isaatiin	i s a
isaatin	i s a t i n
isatti	i s a t t i
jechaa	h e C a
jirruu	h i r u k
kennameef	k e m e f
kmÂ²	k m a
lafee	l a f i
leenjii	l E l o nTy$ E i
madda	d a 7
maraatoonii	r a a t o " w i
murtii	m u r t i
qaamni	q a m n i
qilleensaa	q i l l e n s a
reefu	h r e w u
sadarka	s a d a r
summii	s u m m i
tilmaamaan	t i l m o a m a r a n
urjii	u r j i 7 i
uumama	u m a m a
waaqa	w a i
waggoota	w a g  o t a
warqee	w a r E e
yihuudota	y i h u d o t a
Abbabaa	b w a b a
Abdiisaa	b dy~ i s a
Arabaa	r a b a
Bahaa	a h a
Booranaa	o r a n a
Dhuma	h u m a
Firaanki	i r a  k i
Hagayya	a g a y a
Harmee	a r m i
Islaamaa	s l a m a
Kanaafuu	a n a a f u
Kanas	a n a s
Kunii	u n i
Of	f
Sillaasee	i l l a s E r e
Waldaa	a l d a
abjuu	S a q  u
ajajni	c a x n i
akkanaa	a k k a n a
akkuman	a k k u m a n
anaaloogii	a n a l o g i
baane	b a n e
baayoogaazii	b a y o t u L i
bayinna	b a y i N
bayyee	b a y i
beekan	b e k a n
beektu	b e u
bineensa	b i t t e n s a
bishaanii	b i S a n i
biyyi	b 3 ty~ i
bulaa	b u l a
daldala	d a l d a l a
dandeessu	d a nd ~ e 7 u
daqiiqaa	d a q i q a l u k a
deebisee	d e e  s E r e
dhahaa	dh~ a h a
dhigaa	T i g a
dhihaa	T i h a
dhiifama	T i g f a m a
dhukkubbii	T u k kh~ 3 7 b e k u i
faallaa	f a l l a
fakkaatan	f a k a t a n
fida	f i d a
fiduu	f i t u
fiigicha	f u i g i T a
filannoo	b i l a n k n o
galgalaa	g a l g a l a
gammachuun	g a m m a cy~ u* u n
goone	g o
gootummaa	g o t u m m a
gurra	g u r a
gurraacha	g u r a C a
guyyaatti	g u y a E t
haasaa	h a s o a
himi	h i m i
hunduma	h u nd~ u m a
ijaan	u j a
jaalalli	y a a l a l l i
jechuunis	h e C u n i s
jedhus	h e d u s
jenne	h e
kaaba	k a b a
malle	m a l
muka	m u k a
murteesse	m u r t i 3 s a
qabattu	q a b a t u a n
rakkisaa	r a k i s a
rakkoon	r a k o n
sababiinsaas	s a b a b i s a
siree	s i r e
speed	s p e 3 d
turiin	t u r i i n
weerara	w e n r a r a
yaadadhu	y a a d a d u
yaade	y a a d e
yerootti	y e r o t t i
Agariin	g a r i i n
Haroo	a r o
Huseen	u s e n
Jaarraa	a r a
Jarman	a r m a n
Jechuun	e T u n
Kaaba	a b a
Koongoo	o N o
Kutaan	u t a
Minilik	i n i l i k
New	e w a
Niwuu	i w u
Noobelii	o b e l i
Sirni	i r n i
Takka	a k
Waaqa	a q a
akkaataa	a k a t a
amino	a m i n o
ardii	a r d i
arganne	a r g a n e
baase	b a s e
bahu	b a u
bakkee	b a k i
baratee	b a r a t e n
bodda	b o d a 7
boolla	o l l a
calu	k a l u
dabalaa	d a b a l a
dandeenyu	d a nd ~ e n y u
de	d e
dhaan	T a g a X a n i
dhiba	T i b a
dhufeenyi	T u f e 5 i
dubbisee	d u b i k a s e
egaa	g a
fagoo	f a g o
fedhu	f e d u
fudhachuun	f u d a C u n
fudhatan	f u d a t a n
galan	g a r a
geesse	g e 3 s a
giddu	g i d d u l
gootu	g o t u
guddoon	g u d o n
hiriyaa	h i r i y a
hojjata	h o h j a t a
hubachuu	h u b a C u
ijoolleen	i j o l l e n
isii	i s i
ittuma	i t t u m a
jaalatu	y a a l a t u
jabaa	y a b a
ka	r o x
kam	k i t a
kamiinuu	k a m a t sy~ a u
kanaafis	k a n a a f i s
koos	k o s i r
lakkaawwamu	l a k k a w a m u
maali	m a l i
maddii	d i
mataan	m a t a
mootummoota	o t u m o t a
nyaatu	5 a a t u
oduun	o b a d u n
paatentii	p a a t e n t i
qabaa	q a b a
qabatte	q a b a t t e
raawwachuu	r a u w a C u
rakkina	r a k i n a
riikardii	r i k a r d i
sadaffaa	s a d a f a
seenan	s e n a n
seeran	s e r i
tarminaalii	t a r m i n a l i
tilmaaman	t i l m o a m a n
tokkollee	t o k q u L i
tokkootti	t o k k o t t i
utuu	u t u
uumamuu	u m a m u
waadaa	w a a d a
waantonni	w a n t o n i
wajjiin	w a h 3 nd~ a n
wave	w a b e
Aabbaa	a b " b a
Amajjii	m a i
Ammoo	m m o
Badhaasa	a d a S o
Barnoota	a X n a q o t a
Barumsa	a r u m s a
Bitootessa	i t o 7 o t 3 s a
Dhibeen	h i b e n
Ebla	b l a
Harargee	a r a r  e
Hojiin	o h 3 nd~ a n
Ijiipti	T i p t i
Kanaafis	a n a a f i s
Kompitarri	i m p i t a r i
Miira	i r a
Nuti	u t i
Oromo	r o m o
Qofa	o f a
Shawaa	h a w a
Ummatni	m m a t n i
Warra	a r a
World	u r l
aanu	a n u
agarsiise	a g a r S i s e
alla	a ly~ a
ammallee	a m m a l l e
anii	a n i
argamani	a r g a m a n i
argamuu	a r g a m u
argan	a r g a n
argatee	a r g a t e n
asoosama	a s o s u k a m a
baasuu	b a s u
barreeffamaa	b a r h r e f a m a
baruu	b a r u
beekamaa	b e k a m a
beekuu	b e k u
biyyattii	b 3 ty~ a t t i
dararaa	d a r a r a
darbaa	d a r b a
density	d e ns~ i t
dhaabbata	dh~ a mp~  a t a
dheerina	dh~ e r i n a
dhufanii	T u f a n i
dide	d i d e
duraaf	d u r a a f
duuba	d u u b a
eegalee	e x a l e
elektiroonikii	e l e k t r o " w i i
faana	f a a n a
fincaanii	f i n k a n i
fufuun	f u f u n
gargaaru	g a r t u l u
gargara	g a r g a r a
gas	x a s
godheen	g o d e n
gubbaa	g u b b a
guddatee	g u d t i 3 n
hallu	h a L u
hawwii	h a u w o i 7 i
hidhame	i d a m e
hiriyoota	h i r i y o t a
hojjachuuf	h o h gy~ z u r u v a
ibsutti	i b o c u t t i
isaaniis	i s a n i s
ittan	i t t u a n a
jedhamanii	h e d a m a n i
jedhanitti	h e d a n i t t i
jedhutti	h e d u t t i
jiddu	h i d d u l
jiraate	h i r a a t e
kaase	k a s e
keenyatti	k e n y a t t i
keessati	k e e s s a t i
keessattuu	k e 3 s a a t t u
koof	k o f
koree	k o r e
kufe	k u f e
manneen	n n e n
maraa	r a
mijataa	m i j a t a
moggaafame	m o m a a f a m e
mosee	m o s E r e
murteessaa	m u r t i 3 s a a
muuziqaa	m u z q a l u k a
namichi	n a m i C
nyaachuu	5 a C u
oola	o l a
otuu	o t u
parsentiin	p i e n t i n
qabduu	q a b t u
qofaan	q o f a r a n
qonnaa	q o m i y a n a
qonnaan	q o a n
quba	q u b a
raawwatu	r a u w a t u
ragaa	r a g a
rakkisa	r a k i s a
seenu	s e n u
sekendii	s e k e n d i
shakkii	S a k i
tilmaama	t i l m o a m a
turetti	t u r e t i
tuubii	t u b i
walaloo	w a l a l o
yeroof	y e r o
Akkam	k k a m
Akkuman	k k u m a n
Alamuun	l a m u n
Ana	n a
Ayyaana	y a a n a
Bakki	a k k i
Daawud	a u d
Dambii	a m b i
Dargiin	a r o i dy~ i g i
Dhuguma	h u g u m a
Dhukkubni	h u k kh~ 3 7 b n i
Haati	a t i
Habashaa	a b a S a
Hayilasillaasee	a y i l a s i l l a s E r e
Inumaayyuu	n u m a y y u
Kibbaa	d i b i k a
Kunimmoo	u n i m m o
Magarsaa	a k o l a i t s a
Manni	a n i
Marsiin	a r S i i n
Onesmoos	n e s m o s o
Oromoota	r o m o t a
Qabsoo	a b " s o
Qorannoo	o r a n n o
Qorannoon	o r a n o n
Sadarkaa	a d a r k a
Seelii	e l i
Tiraanzisteriin	i r a  z i S t E r i i n
Walitti	a l i t t i
Wallagga	o l  m a
afaanota	a f a n o t a
amalli	a m a l l i
anaan	a n a
argaa	a r g a
argachuun	a r g a C u n
atumti	a t u m t i
baadiyyaa	b a y a  a
baasuuf	b a s u f
baatii	b a t i
baatiriin	b a t i r i i n
badhaasa	b a d a S o
badu	b a d u
bahanii	b a h a n i
ballini	b a l l i n i
bayee	b a y e
chaarjii	C a r j i
daandii	d a nd~ i
dandeenya	d a nd ~ e n y a
dhaqee	dh~ a q o e
dhibaa	T i b a
dhibbantaa	T i b b a nt~ a
dhibbeentaa	T i b b e n t a
dhiyaatan	T i y a a t a n
dhiyoo	T i y o
dogoggora	d u g u 7 m o r a
duratti	d u r a t t i
fagaatee	f a g a t i 3 n
fakkaatee	f a k a t e n
fakki	f a k k i
fedhiin	f e d i g a n
fiildii	f i l d i
fiixee	f i " e a
funyaan	f u 5 a
fuuldura	f u l d u r a
gaaffiin	g a f a i n
gadda	g a d a 7
gaddi	g a d i
galuuf	g a l u f n a
gargari	g a r N a r i
geessu	g e 3 s a u
godhaa	g o d a
godhuu	g o d u
guddisuu	g u d i s u
haalota	h a l o t a
haaraan	h a r a
hariiroo	h a r i r o
hidda	h i d a 7
hidhaatti	i d a E t
hiika	h i i k a
himaa	h i m a
himee	h i * e
hoogganaa	h o m a n a
ibse	i b s e
ibsuu	i b s u
intala	i n t a l a
irrattis	i r a t t i s
ishiin	i S i i n
isin	i s i n
ittisuuf	i t i s u f
jedhamani	h e d a m a n i
jedhetti	h e d h e t i
jijjirama	j i j j i r a m a
jirran	h i r
jirtuu	h i r t u
kaabaa	k a b a
kaleessaa	k a l e 3 s a a
kanarra	k a n a r a
karantiin	k a r a n t i n
karoora	k a r o r a
keemikaalaa	k e e m i k a l a
keenyaan	k e t T a n
keessummaa	k e 3 s a l u m m a
kennuuf	k e n u f
kuniis	k u n i s
kutta	k u t t a
loltuu	l o l t u
makame	m a k a m e
mee	m e
michuu	m i C u* u
mitteenii	m i t % t e n i
moggaa	m o m a
mucayyoo	m u k a y o
namootaa	n a m o t a
niitii	n i i t i
odeessuu	o d e 7 u
qabachuuf	q a b a z u r f n a
qabaniif	q a b a n i f
qabattee	q a b a t t i 3 n
qabeenyaa	q a b e n y a
qabnee	q a b S i
qabneef	q a b S i f
raawwatamu	r a u w a t a m u
saxaxa	s a s a s a
seenaan	s e n a n
shoora	S o o r a
sirumaa	s i r u m a
tilmaamuu	t i l m o a m u
tilmamaan	t i l m o m o
toluu	t o l u
turuu	t u n u
umuriin	u m u r i i n
uumu	u m u
waanuma	w a n u m a
yaadni	y a y n i
Achiin	C i
Amaara	m a d a
Ballina	a ly~ i n a
Baqqalaa	a k " o a l a
Biiroo	i r o
Biyya	i  a
Dhimma	h i m a
Dilbata	i l b a t a
Dorgommii	u r g o m m i
Finfinneetti	i n f e f i n S i t t i
Ganda	a n d a
Hayileen	a y i l e n
Indiyaa	n d i y a
Kanarraan	a n a r r a
Kanarratti	a n a r a t t i
Kitaabni	i t a b
Kurii	u r i 7 i
Lafa	a f a
Oromoof	r o m o
Oromoonni	r o m o  n i
Oromootti	r o m o t t i
Rakkoo	a k nk ~ o b a
Seenaa	e n a
Tokko	o k k o
Tokkummaa	o k k u m m a
Tsahaay	s a h a a y
Wallaggaa	o l  m a
Westiingihaawus	e s t i i N i h a w u s
addunyaan	a d n y a
ajjeesee	a x i e s E r e
akkasitti	a k a s i t t i
argine	a r g i n e
arguuf	a r a f n a
baakteeriyaa	b a k e r i y a
baayyina	b a y i n a
bahaatti	b a h a E t
barachuuf	b a r 3 z u r f n a
barbaachisa	b a r b a C i s a
bareedaa	b a d e n d a
barreessee	b a r h r e s s E r e
battalumatti	b a t t a l u m a t t i
bayyinan	b a y i n a n
beektaa	b e a
beekuun	b e d u n
bekkama	b e kw~ k a m a
biqiltuu	b i 7 i l t u
bitaa	b i t a
booddee	d a
busaa	s a
carraan	k a g i r a
cina	T i n a
cinaa	i n a
dabalata	d a b a l a t a
dabarsee	d a b a r s E r e
dadhabe	d a d a b e
dandii	d a n d i
deemuuf	d e  f n a
dhaabe	dh~ a b e
dhabee	dh~ a b e
dhokannaa	d o k a a
dhufeera	T u f e r a
dursaa	d u r s a
eessaa	e 7 a
elektrikii	e l e k t r i k i
fakkaate	f a k a t e
falmaa	f a l m o a
fesashi	f e S n a N t a N
fide	f i d e
fudhanne	f u d a n e
fufee	f u f e
fufuu	f u f u
funaantuu	f u n a n t u
gaafachuu	g a f a C u
gaariin	g a r i i n
gabatee	g a b a t e n
galaanaa	g a l a n a
galche	g a l C e
gammoojjii	g a m c j i
gamoo	g a m o
garaagaraa	g a r a a g a r a
garagaraa	g a r a g a r a
godheera	g o d e r a
guutame	g u t a m e
guutuun	g u t u 7 u n
haasofne	h a s o a n e
hafee	a f i
hagas	h a x a s
hojjetu	h o x e t u
hulaa	h u l a
ilaala	i l a l a
ilaallama	i l a l l a m a
isaaniitti	i s a n i t t i
ispoorii	a  o r i
jalqabde	y a q a b d e
jalqabne	y a q a b n e
jedhurraa	h e d u r a
jettiin	h e t
jirus	h i r u s
kaa	k a
kaayyoo	k a y o
kaleessa	k a l e 3 s a
kanaatti	k a n a E t
kennan	k e n n a n
kiilomeetira	k i l o m a  r a
kootiin	k o a
laabiraatorii	l a b i r a a t o r i
lamaanuu	l a m a n u
maalii	m a l i
male	m a l e
mataasaa	m a t a a s a
miseensota	m i s e n s o t a
moo	m o
mucaan	m u k a
murteessuu	m u r t i 3 s a u
nyaatan	5 a a t a n
obboleettii	o b b o l e e t i
oolle	o l l e
oromoo	o r o m o
plate	p l a y i t e
qabachu	q a b a C u
qabamanii	q a b a m a n i
qabamuu	q a b a m u
qabatanii	q a b a t a n i
qabeeyyii	q a b e n ty~ i
qabiyyee	q a b i  i
qabsoon	q a j o n
qoratu	q o r a t u
raadaarii	r a a r i
rakkisu	r a k i s u
saalaa	s a a l a
sabdaneessaa	s a b d a S i  s a
saffisaan	s a f a  a n
sagal	s a g a l
sammuun	s a m u n
seenuu	s e n u
semiikondaakterii	s e m i k o n d a k t E r i
tarkaanfii	t a a n f i
tiin	t i i n
tiyoorii	i y u r i
tiyyaa	i y y a
tokkon	t o k u N 7 o n
ulfaata	u l y a t a
uumaa	u m a
uumame	u m a m e
uummame	u m m a m e
uummamu	u m m a m u
vacuum	v a  u m
walakkaan	w a l a k a n
waliinii	w a r i i n i
walqunnamtii	w a q u m t i
xiqqo	S i k G u
xiyyeeffannoo	S i  e 7y~ f a* n o
yaa	y a
yaadaan	y a a d a
yaalan	y a i c
yaale	y a l e
yihuudotaa	y i h u d o t a
